"year","keyword","LL","total.word","o1","o2","e1","e2"
"2010","oh oh",1010.36627508097,3050,1196,1854,469.586308134292,2580.41369186571
"2010","oh oh oh",905.328967397727,1867,836,1031,287.448405667778,1579.55159433222
"2000","wit",775.353562815036,765,576,189,205.850550717534,559.149449282466
"2010","oh oh oh oh",753.529692731544,1291,619,672,198.765876656187,1092.23412334381
"2010","imma",688.662386049409,302,252,50,46.4967426414938,255.503257358506
"1970","boogie",679.484073694997,313,247,66,42.8333901468896,270.16660985311
"2000","club",524.489064021643,612,437,175,164.680440574027,447.319559425973
"1960","can dig",437.496048218769,106,92,14,6.33066697964464,99.6693330203554
"2000","like",382.322059869254,10949,3880,7069,2946.21918928925,8002.78081071075
"1970","love",366.041445099586,15283,2946,12337,2091.44633103807,13191.5536689619
"1960","dig",363.23629438365,207,113,94,12.3627175923249,194.637282407675
"2000","bum",348.58352733754,160,153,7,43.053709953994,116.946290046006
"2000","girl",332.345312302727,4804,1875,2929,1292.68764136867,3511.31235863133
"2000","shit",316.337127935634,896,494,402,241.100775742366,654.899224257634
"2000","go head",312.849265005101,149,141,8,40.0937673946569,108.906232605343
"2000","shorty",311.79669625907,202,174,28,54.3553088169174,147.644691183083
"2000","ima",310.672155115671,371,263,108,99.8307899558235,271.169210044177
"1990","pump",309.664690295259,208,163,45,44.1260967533426,163.873903246657
"2010","like",309.112104325974,10949,2383,8566,1685.73786484012,9263.26213515988
"2000","ass",303.617117301655,629,378,251,169.254897256639,459.745102743361
"2000","pop",292.279672073253,394,269,125,106.01976076171,287.98023923829
"2010","bitch",288.527012717887,590,265,325,90.8380071472892,499.161992852711
"2000","gon",279.439883759508,705,401,304,189.705409484786,515.294590515214
"2010","rack",278.227616525237,84,81,3,12.9328688141903,71.0671311858097
"2000","lil",273.03703499224,226,180,46,60.8133653100165,165.186634689984
"2000","dem",272.892411982219,241,188,53,64.8496506182034,176.150349381797
"2010","fuck",258.290974056998,631,266,365,97.1504788304059,533.849521169594
"2000","aint",244.138508944181,3592,1398,2194,966.555788467164,2625.44421153284
"2000","wee",240.727190292507,152,132,20,40.9010244562943,111.098975543706
"1990","cuerpo",240.033485016842,97,91,6,20.5780355051646,76.4219644948354
"1970","woman",238.135431255985,796,282,514,108.930921907106,687.069078092894
"2000","bay",235.990248246662,169,141,28,45.4754811389061,123.524518861094
"1970","doo",234.363838950797,285,148,137,39.0016491752829,245.998350824717
"2000","nigga",231.510011927216,790,415,375,212.577692897845,577.422307102155
"1970","ron",227.832758815524,71,66,5,9.71620032085995,61.2837996791401
"2010","wiggle",224.722791754123,115,90,25,17.7057132575225,97.2942867424775
"2010","go low",218.557626098991,65,63,2,10.0075770585997,54.9924229414003
"2000","thong",213.111635801334,90,88,2,24.2177118491216,65.7822881508784
"2010","oh whoa oh",211.963948769597,82,72,10,12.6249433662334,69.3750566337666
"1980","love",209.175743799596,15283,3262,12021,2571.1466255768,12711.8533744232
"1990","will",198.246866932868,3611,1129,2482,766.054497001539,2844.94550299846
"1970","get get get get",197.433846939828,161,99,62,22.0325105867388,138.967489413261
"2000","get",195.168373477584,8265,2801,5464,2223.993204811,6041.006795189
"2010","hands",194.119104301907,1018,336,682,156.734053010069,861.265946989931
"1970","float",193.957968510976,86,69,17,11.7689186985064,74.2310813014936
"2000","boy",193.59599071985,1613,694,919,434.035213473702,1178.9647865263
"2010","put hands",191.842112519523,193,114,79,29.7148057278421,163.285194272158
"1980","night",191.436829911508,3598,935,2663,605.312148061593,2992.68785193841
"1970","band",191.280997523547,195,109,86,26.6853389094041,168.314661090596
"1970","yes can",189.322952173648,81,66,15,11.0846792392909,69.9153207607091
"1970","willy",188.308049635795,56,53,3,7.66348194321348,48.3365180567865
"2000","damn",186.472160359097,486,274,212,130.775643985257,355.224356014743
"2000","drop",183.129906539878,417,244,173,112.208731567597,304.791268432403
"1960","oh happy",182.812498076268,41,37,4,2.44865420910783,38.5513457908922
"2010","whoa oh",182.571738443252,160,100,60,24.634035836553,135.365964163447
"1970","get get get",182.41536852098,265,128,137,36.264691338421,228.735308661579
"1970","funk",181.185861240142,206,110,96,28.1906657196782,177.809334280322
"2010","la la",179.799879163207,1558,449,1109,239.873923958435,1318.12607604157
"1970","lord",179.404108099144,359,153,206,49.1283931716722,309.871606828328
"1970","dance dance",178.06342617121,177,100,77,24.2220768562283,152.777923143772
"2000","big boy",175.240266663103,88,82,6,23.6795404746967,64.3204595253033
"2010","money",174.200147050306,1142,354,788,175.825430783397,966.174569216603
"2000","hips",174.058156714666,152,119,33,40.9010244562943,111.098975543706
"2010","bass",173.879934084876,174,103,71,26.7895139722514,147.210486027749
"2010","oh whoa",172.989504501394,111,79,32,17.0898623616086,93.9101376383913
"2010","bitches",169.84339023444,276,135,141,42.4937118180539,233.506288181946
"1990","ever needed",163.27285206222,60,58,2,12.7286817557719,47.2713182442281
"1990","jam",163.093236642062,164,111,53,34.7917301324432,129.208269867557
"1970","disco",162.679683008983,109,73,36,14.9164202108977,94.0835797891023
"1960","miles miles",162.371174662739,39,34,5,2.32920766232208,36.6707923376779
"1980","heart",161.608571436378,2871,754,2117,483.004774064712,2387.99522593529
"1970","get get",157.353010759645,546,191,355,74.7189489463315,471.281051053669
"2000","thug",157.316310335896,118,97,21,31.7521110910705,86.2478889089295
"2000","ooh wee",156.950334931511,94,83,11,25.2940545979715,68.7059454020285
"1990","dip",155.577573106086,166,110,56,35.2160195243022,130.783980475698
"1990","pump pump",154.364300623952,60,57,3,12.7286817557719,47.2713182442281
"2010","em dont",152.754136838247,52,48,4,8.00606164687973,43.9939383531203
"1970","dance dance dance",152.569443342421,101,68,33,13.8216370761529,87.1783629238471
"2010","solo",151.443094573622,92,67,25,14.164570606018,77.835429393982
"1970","wonder wonder",151.285230892647,53,47,6,7.25293826768419,45.7470617323158
"2000","make rain",151.015400179312,81,74,7,21.7959406642094,59.2040593357906
"2000","yall",149.972625314011,621,311,310,167.102211758939,453.897788241061
"2010","just wanna see",148.170948687283,53,48,5,8.16002437085818,44.8399756291418
"1990","let go let go",147.160571700767,104,80,24,22.0630483766713,81.9369516233287
"1990","hmm",146.957518906162,96,76,20,20.365890809235,75.634109190765
"2010","oh whoa oh oh",146.953180133333,48,45,3,7.3902107509659,40.6097892490341
"1970","sweet",144.583490219385,1136,310,826,155.459205133759,980.540794866241
"2010","oh oh whoa",143.952732718973,54,48,6,8.31398709483664,45.6860129051634
"2010","niggas",143.529812528488,392,159,233,60.3533877995549,331.646612200445
"2010","like diamond",143.341576809312,47,44,3,7.23624802698745,39.7637519730126
"2000","baby boy",142.949758828377,83,74,9,22.3341120386344,60.6658879613656
"2010","break break",141.984115804724,82,61,21,12.6249433662334,69.3750566337666
"2000","flip",140.391273217527,136,103,33,36.5956534608949,99.4043465391051
"1970","louie",140.22869921809,56,47,9,7.66348194321348,48.3365180567865
"1990","go let go",140.067760036425,107,80,27,22.6994824644599,84.3005175355401
"2000","lean",138.171606960679,270,165,105,72.6531355473648,197.346864452635
"2000","pussy",137.9094670957,147,108,39,39.555596020232,107.444403979768
"2010","aah",137.836793478661,190,99,91,29.2529175559067,160.747082444093
"2010","oh oh whoa oh",137.55764946543,50,45,5,7.69813619892281,42.3018638010772
"1980","shes",137.10078433404,1432,420,1012,240.913561985604,1191.0864380144
"2000","hoes",136.533473712597,269,164,105,72.3840498601524,196.615950139848
"2000","act",136.530168559832,304,179,125,81.8020489125885,222.197951087411
"2010","burn",136.51686145985,335,141,194,51.5775125327829,283.422487467217
"1980","tonight",135.866745668772,1587,454,1133,266.990099770358,1320.00990022964
"1980","mickey",135.641968709505,47,44,3,7.90707919924816,39.0929208007518
"1980","ive",135.457394258062,2652,684,1968,446.161149710769,2205.83885028923
"1990","da da",134.343475453325,550,238,312,116.679582761242,433.320417238758
"2000","suga",133.963550902282,74,67,7,19.9123408537222,54.0876591462778
"1990","let go let",133.433245473274,121,85,36,25.6695082074733,95.3304917925267
"1970","dancing",130.948060138064,362,137,225,49.5389368472014,312.461063152799
"1970","can can",130.777258051688,105,65,40,14.3690286435253,90.6309713564747
"2000","make lose",130.028403575547,110,87,23,29.5994255933708,80.4005744066291
"1970","dit",128.597730405761,186,90,96,25.4537078828162,160.546292117184
"1990","dont hurt",128.470880766295,66,57,9,14.0015499313491,51.9984500686509
"1980","seeds",128.469805864367,54,47,7,9.08472929275321,44.9152707072468
"1970","like makin",128.117799436256,38,36,2,5.20021989003772,32.7997801099623
"2000","cause",128.078407659684,4691,1615,3076,1262.28095871366,3428.71904128634
"2010","money money",128.075377529411,81,58,23,12.470980642255,68.529019357745
"2010","low can",127.766845302602,45,41,4,6.92832257903053,38.0716774209695
"1960","miles",127.425118224839,169,59,110,10.0932332033957,158.906766796604
"1960","coal",126.860898957637,34,28,6,2.03059129535771,31.9694087046423
"2010","animals",126.123971684807,55,46,9,8.4679498188151,46.5320501811849
"2000","need girl",126.0640691207,106,84,22,28.523082844521,77.476917155479
"2000","walk now",125.771656880179,56,54,2,15.0687984838979,40.9312015161021
"2000","tha",125.627354598434,97,79,18,26.1013116596088,70.8986883403912
"1990","ill",125.588936075364,4216,1203,3013,894.402038038905,3321.59796196109
"2010","whoa",125.573078665702,687,224,463,105.772391373199,581.2276086268
"1970","morning",125.271675619089,509,169,340,69.6555769481368,439.344423051863
"2010","yo hands",124.213138940573,44,40,4,6.77435985505208,37.2256401449479
"1990","uhh",123.674652279024,106,76,30,22.4873377685304,83.5126622314696
"1980","monkey",123.00237202933,79,58,21,13.2906224838427,65.7093775161573
"2000","like rock",122.95299809457,89,74,15,23.9486261619091,65.0513738380909
"1990","go let",122.661105734929,141,91,50,29.912402126064,111.087597873936
"1960","writer",122.203173521539,28,25,3,1.67225165500047,26.3277483449995
"2000","yea",121.73000141044,272,160,112,73.1913069217897,198.80869307821
"1980","time",120.716233638105,5176,1179,3997,870.788126283159,4305.21187371684
"1980","love just",120.683667187205,290,129,161,48.7883610166376,241.211638983362
"1980","gloria",120.31718016826,40,38,2,6.72942910574312,33.2705708942569
"1980","much",119.530551670777,1552,434,1118,261.101849302833,1290.89815069717
"1990","ever",119.090421151536,2130,668,1462,451.868202329902,1678.1317976701
"1980","tumble",118.516824524499,42,39,3,7.06590056103027,34.9340994389697
"1990","hip",117.943306228829,132,86,46,28.0030998626982,103.996900137302
"2010","la la la",117.930472998489,1245,342,903,191.683591353178,1053.31640864682
"1970","jazz",117.870225050053,44,38,6,6.02130724109631,37.9786927589037
"2000","spendin",117.655054376638,59,55,4,15.8760555455353,43.1239444544647
"2000","hit",117.546101331796,765,346,419,205.850550717534,559.149449282466
"1980","hearts",117.326154398499,322,137,185,54.1719043012321,267.828095698768
"1980","kick em",117.256804457699,44,40,4,7.40237201631743,36.5976279836826
"2000","fine fine",117.050754422451,67,60,7,18.028741043235,48.971258956765
"2000","hot",116.340043863722,949,410,539,255.362317164627,693.637682835373
"1970","bell",115.921033313307,83,54,29,11.3583750229771,71.6416249770229
"1960","help",115.89930328487,765,131,634,45.6883041455486,719.311695854452
"2000","say im just",115.571919741679,52,50,2,13.992455735048,38.007544264952
"1970","ole",114.315245908215,45,38,7,6.15815513293941,38.8418448670606
"2010","whoa oh oh",114.017013562063,96,61,35,14.7804215019318,81.2195784980682
"2000","name love",113.965455113989,85,70,15,22.8722834130593,62.1277165869407
"1990","whoop",112.83657871098,75,59,16,15.9108521947149,59.0891478052851
"2010","shine bright",112.607091376337,45,39,6,6.92832257903053,38.0716774209695
"2000","crunk",112.606357361146,54,51,3,14.530627109473,39.469372890527
"2010","im ridin",112.463490515583,47,40,7,7.23624802698745,39.7637519730126
"2010","put yo",112.463490515583,47,40,7,7.23624802698745,39.7637519730126
"2010","boom",112.43812273645,305,124,181,46.9586308134292,258.041369186571
"2000","uh oh",112.369469109694,108,82,26,29.0612542189459,78.9387457810541
"2010","like im",112.260509994866,283,118,165,43.5714508859031,239.428549114097
"1980","material",112.108175630271,49,42,7,8.24355065453532,40.7564493454647
"1980","stand",111.777415574875,804,258,546,135.261525025437,668.738474974563
"1970","mighty",111.599431105533,94,57,37,12.8637018332512,81.1362981667488
"2000","halo",111.539390138812,77,65,12,20.7195979153596,56.2804020846404
"1970","ring bell",111.497221710061,36,33,3,4.92652410635153,31.0734758936485
"2000","move",111.13302328457,1129,468,661,303.79774086287,825.20225913713
"1990","kick",111.040346481847,329,156,173,69.7956049608159,259.204395039184
"2010","whoa oh oh oh",110.599025623476,65,48,17,10.0075770585997,54.9924229414003
"1990","dah",110.588755191584,66,54,12,14.0015499313491,51.9984500686509
"1980","america",110.503182669762,64,49,15,10.767086569189,53.232913430811
"1960","im black",110.418676951013,40,28,12,2.38893093571496,37.611069064285
"1990","power",109.804337370354,246,127,119,52.1875951986648,193.812404801335
"2000","clean",109.777858883682,176,114,62,47.3590809493934,128.640919050607
"1980","heat",109.382579222712,210,101,109,35.3295028051514,174.670497194849
"2000","know",109.085952972248,11166,3502,7664,3004.61078341435,8161.38921658565
"2000","go get",108.628859619161,136,95,41,36.5956534608949,99.4043465391051
"1990","di da",108.312842580837,52,46,6,11.0315241883356,40.9684758116644
"1990","jumps",107.889073907446,47,43,4,9.97080070868799,37.029199291312
"1980","night night",107.765776299678,94,61,33,15.8141583984963,78.1858416015037
"2010","eh eh",107.721594250145,117,67,50,18.0136387054794,98.9863612945206
"2000","move move just",107.588560693459,52,49,3,13.992455735048,38.007544264952
"2010","break break break",106.712981663947,53,42,11,8.16002437085818,44.8399756291418
"1970","gimme",106.330136525496,386,133,253,52.8232862514358,333.176713748564
"2000","lemme",106.301930534624,86,69,17,23.1413691002718,62.8586308997282
"2010","demons",106.287904121236,51,41,10,7.85209892290127,43.1479010770987
"2000","like hot",105.933809284876,117,85,32,31.4830254038581,85.5169745961419
"2010","ooh",105.683808107985,2077,500,1577,319.780577703254,1757.21942229675
"2000","like daddy",105.396874078932,48,46,2,12.9161129861982,35.0838870138018
"1960","monday",105.241472113486,83,38,45,4.95703169160854,78.0429683083915
"1990","slide",105.023898136472,143,87,56,30.336691517923,112.663308482077
"1970","fever",104.463211153853,73,48,25,9.98989610454615,63.0101038954538
"2010","lights",104.199323029589,465,161,304,71.5926666499822,393.407333350018
"1960","mine",104.177849892412,1033,153,880,61.6941414148388,971.305858585161
"2000","im hot",103.97714123884,108,80,28,29.0612542189459,78.9387457810541
"1980","cherish",103.008751135723,84,56,28,14.1318011220605,69.8681988779394
"2000","fuck",102.866445460688,631,289,342,169.793068631064,461.206931368936
"2000","tryin catch",102.580190587897,50,47,3,13.4542843606231,36.5457156393769
"1980","medicine",102.284554611668,48,40,8,8.07531492689174,39.9246850731083
"1980","whos",102.13782171936,457,167,290,76.8837275331151,380.116272466885
"2010","put",102.065289662911,1646,412,1234,253.422643668539,1392.57735633146
"2000","wanna",101.877649230747,4767,1599,3168,1282.73147094181,3484.26852905819
"1960","lovin",101.803883737647,625,110,515,37.3270458705462,587.672954129454
"2000","pimpin",101.755371677241,68,58,10,18.2978267304474,49.7021732695526
"1980","new love",101.483962777162,37,34,3,6.22472192281238,30.7752780771876
"2000","front",101.374257929156,339,179,160,91.2200479650247,247.779952034975
"1970","dont stop dont stop",101.112541988935,31,29,2,4.24228464713604,26.757715352864
"2000","get low",100.972803419708,90,70,20,24.2177118491216,65.7822881508784
"2010","shake shake shake shake",100.866918721992,180,85,95,27.7132903161221,152.286709683878
"2010","bout",100.805172527245,884,254,630,136.103047996955,747.896952003045
"1970","dance dance dance dance",100.476467398063,52,39,13,7.11609037584109,44.8839096241589
"2010","g like",100.274422869235,35,32,3,5.38869533924597,29.611304660754
"2010","put yo hands",100.274422869235,35,32,3,5.38869533924597,29.611304660754
"1960","im proud",100.236713874146,45,28,17,2.68754730267933,42.3124526973207
"2000","bout",99.9439983524957,884,376,508,237.871747495817,646.128252504183
"1970","best love",99.8268460645857,41,34,7,5.61076356556702,35.389236434433
"1960","baby",99.649102667308,9098,783,8315,543.362341328367,8554.63765867163
"2010","whoaoh",99.618931709188,58,43,15,8.92983799075047,49.0701620092495
"1970","mash",99.4538507542738,37,32,5,5.06337199819462,31.9366280018054
"1970","robin",99.4538507542738,37,32,5,5.06337199819462,31.9366280018054
"2000","aye aye",99.4212112866156,85,67,18,22.8722834130593,62.1277165869407
"1980","got look",99.3531002064435,43,37,6,7.23413628867385,35.7658637113261
"2010","im worth",99.0320485296753,39,34,5,6.0045462351598,32.9954537648402
"2010","moves like",98.8488043027604,43,36,7,6.62039713107362,36.3796028689264
"1970","dance",98.8001893071717,1542,356,1186,211.019449222057,1330.98055077794
"2000","shady",98.437077648269,78,63,15,20.9886836025721,57.0113163974279
"1960","sweet",98.4212738701784,1136,160,976,67.8456385743048,1068.1543614257
"1970","sail away",97.973081809279,46,36,10,6.29500302478251,39.7049969752175
"1990","takes two",97.8965985705781,46,41,5,9.75865601275846,36.2413439872415
"1970","home",97.681518778813,1475,343,1132,201.850640468569,1273.14935953143
"1990","shake body",97.5722991534645,57,47,10,12.0922476679833,44.9077523320167
"2010","post",97.5149544405513,52,40,12,8.00606164687973,43.9939383531203
"2000","bitch",97.4797742071051,590,271,319,158.760555455353,431.239444544647
"2000","dude",97.2799367636646,73,60,13,19.6432551665097,53.3567448334902
"1970","never can say",97.2704297009062,30,28,2,4.10543675529294,25.8945632447071
"1990","want",96.740981725006,6214,1644,4570,1318.26714050611,4895.73285949389
"1990","cuz",96.6536435726712,293,138,155,62.1583959073528,230.841604092647
"1960","good lovin",96.3700463477732,55,30,25,3.28478003660807,51.7152199633919
"2010","red red",95.9874657543621,72,48,24,11.0853161264489,60.9146838735512
"1990","da da da",95.9015025501758,303,141,162,64.2798428666481,238.720157133352
"1960","inspiration",95.563321372141,44,27,17,2.62782402928645,41.3721759707135
"2010","wanna see",95.2169908923131,262,106,156,40.3382336823556,221.661766317644
"1990","diggin",94.9948717186045,85,60,25,18.0322991540102,66.9677008459898
"2000","baby girl",94.8046720861483,201,120,81,54.0862231297049,146.913776870295
"1960","green",94.4018454140014,170,51,119,10.1529564767886,159.847043523211
"2000","diva",93.6096859716629,52,47,5,13.992455735048,38.007544264952
"1960","make mine",93.1068430943222,66,32,34,3.94173604392968,62.0582639560703
"2000","slow",92.9525818619537,567,260,307,152.571584649466,414.428415350534
"2000","ladies",92.8649607124914,303,161,142,81.5329632253761,221.467036774624
"1970","youre satisfied",92.548479628972,31,28,3,4.24228464713604,26.757715352864
"2010","im bout",92.4639252251484,82,51,31,12.6249433662334,69.3750566337666
"1970","floor let",92.1566731702392,33,29,4,4.51598043082223,28.4840195691778
"2000","girl give",91.1184831793975,61,52,9,16.4142269199602,44.5857730800398
"1970","lovin",90.9868134666768,625,177,448,85.5299324019362,539.470067598064
"2000","move just",90.837258780532,56,49,7,15.0687984838979,40.9312015161021
"2000","act like",90.7959936080501,117,81,36,31.4830254038581,85.5169745961419
"2000","one wish",90.6078258892257,70,57,13,18.8359981048724,51.1640018951276
"1960","wait wait wait",90.4922447452315,27,21,6,1.6125283816076,25.3874716183924
"2000","low low low",90.4912540934292,48,44,4,12.9161129861982,35.0838870138018
"2010","hopeless",90.4618574736265,48,37,11,7.3902107509659,40.6097892490341
"2000","holla",90.3439647592106,130,87,43,34.9811393376201,95.0188606623799
"2010","cup",90.0896092961228,151,73,78,23.2483713207469,127.751628679253
"1980","night night night",89.8870754834005,38,33,5,6.39295765045596,31.607042349544
"1990","coming back",89.5183114450692,119,73,46,25.2452188156143,93.7547811843857
"2000","mami",89.3304575371121,76,60,16,20.4505122281471,55.5494877718529
"1980","know youll",89.3198170581468,95,57,38,15.9823941261399,79.0176058738601
"1990","wild wild west",89.3091155124391,43,38,5,9.12222192496986,33.8777780750301
"1970","sing",89.1951562109809,620,175,445,84.8456929427207,535.154307057279
"1970","dont stop dont",89.0645869083897,38,31,7,5.20021989003772,32.7997801099623
"2010","bitch better",88.96990246298,34,30,4,5.23473261526751,28.7652673847325
"1970","rainin",88.7778111047694,30,27,3,4.10543675529294,25.8945632447071
"2000","bouncin",88.7715800387798,50,45,5,13.4542843606231,36.5457156393769
"2010","rumor",88.6048300861492,38,32,6,5.85058351118134,32.1494164888187
"1990","wild west",88.4585512268959,45,39,6,9.54651131682892,35.4534886831711
"2000","dance floor",88.4578637190013,110,77,33,29.5994255933708,80.4005744066291
"1970","lime",88.4320094851564,34,29,5,4.65282832266533,29.3471716773347
"1970","lucy",88.4320094851564,34,29,5,4.65282832266533,29.3471716773347
"1980","ohhh",88.2932152591914,72,48,24,12.1129723903376,59.8870276096624
"2010","coco",87.7939991567983,74,47,27,11.3932415744058,62.6067584255942
"1960","proud",87.5725874159397,143,45,98,8.54042809518097,134.459571904819
"2000","girl go",87.4240442803769,57,49,8,15.3378841711103,41.6621158288897
"2010","hey hey",87.3771654206484,597,183,414,91.9157462151384,505.084253784862
"2000","take ya",87.3390216642936,52,46,6,13.992455735048,38.007544264952
"2000","party like",87.1813283238506,75,59,16,20.1814265409347,54.8185734590653
"1960","light fire",86.9735183264709,38,24,14,2.26948438892921,35.7305156110708
"2010","tell em",86.972459877551,161,75,86,24.7879985605315,136.212001439469
"2000","head",86.9183726707415,1158,458,700,311.601225792031,846.398774207969
"1980","sara",86.6085185246773,37,32,5,6.22472192281238,30.7752780771876
"2000","sprung",86.3591042516711,49,44,5,13.1851986734107,35.8148013265894
"2000","handle",86.0635791005793,171,104,67,46.0136525133311,124.986347486669
"1970","luck",85.8881887882682,117,58,59,16.0112033456425,100.988796654358
"1970","marie",85.7741090190763,27,25,2,3.69489307976364,23.3051069202364
"2010","dont wake",85.4821448036659,33,29,4,5.08076989128906,27.9192301087109
"1960","gonna make mine",85.3696970991751,26,20,6,1.55280510821472,24.4471948917853
"1960","wait wait",85.366388817674,59,29,30,3.52367313017956,55.4763268698204
"2000","ha ha ha ha",85.0394315820297,74,58,16,19.9123408537222,54.0876591462778
"1970","im easy",85.0145545811918,29,26,3,3.96858886344984,25.0314111365502
"2010","la la la la",84.5523382077677,1002,268,734,154.270649426413,847.729350573587
"2000","ha ha",84.4776548234374,237,131,106,63.7733078693536,173.226692130646
"2000","hood",84.4336927881391,184,109,75,49.5117664470931,134.488233552907
"1980","annie",84.2756575277612,48,37,11,8.07531492689174,39.9246850731083
"1990","ya ya ya",84.0574969405928,103,65,38,21.8509036807418,81.1490963192582
"2000","lookin",84.0527925254764,471,220,251,126.73935867707,344.26064132293
"2000","make nigga",83.9512677636342,48,43,5,12.9161129861982,35.0838870138018
"2000","ha ha ha",83.950038602988,132,86,46,35.519310712045,96.480689287955
"1980","control",83.8121530818192,371,136,235,62.4154549557674,308.584545044233
"1980","love just cant",83.0483950815508,60,42,18,10.0941436586147,49.9058563413853
"2010","fuckin",83.0151853803058,183,80,103,28.1751784880575,154.824821511943
"1970","love love",82.9542821849607,1001,245,756,136.984739734941,864.015260265059
"2010","drunk",82.9427191998982,145,69,76,22.3245949768762,122.675405023124
"2000","gal",82.8293376384028,62,51,11,16.6833126071727,45.3166873928273
"1960","mia",82.8140077132597,30,21,9,1.79169820178622,28.2083017982138
"2000","cold im",82.6585704677943,42,39,3,11.3015988629234,30.6984011370766
"1960","valley",82.3803432304739,57,28,29,3.40422658339381,53.5957734166062
"2010","nigga",82.3004595821455,790,222,568,121.63055194298,668.36944805702
"2000","goes around",82.1460011794137,81,61,20,21.7959406642094,59.2040593357906
"1980","isnt",82.0427981331867,240,100,140,40.3765746344587,199.623425365541
"2010","hundreds",82.0027509959555,32,28,4,4.9268071673106,27.0731928326894
"2010","ive ive",82.0027509959555,32,28,4,4.9268071673106,27.0731928326894
"1960","judge",81.8182859522244,62,29,33,3.70284295035818,58.2971570496418
"1980","gonna",81.6425691741807,4550,1002,3548,765.47256077828,3784.52743922172
"2000","breath",81.6053703303385,260,139,121,69.9622786752402,190.03772132476
"1970","heaven",81.5737987082632,432,132,300,59.1182892762183,372.881710723782
"1970","yes",81.5600267676179,1017,247,770,139.174306004431,877.825693995569
"1970","coconut",81.45559662182,34,28,6,4.65282832266533,29.3471716773347
"2000","em bring",81.4467329926472,52,45,7,13.992455735048,38.007544264952
"2000","em bring em",81.4467329926472,52,45,7,13.992455735048,38.007544264952
"1970","native",81.2592609199142,28,25,3,3.83174097160674,24.1682590283933
"2010","chick",81.0834287248272,189,81,108,29.0989548319282,159.901045168072
"1960","paperback",81.0797245188142,22,18,4,1.31391201464323,20.6860879853568
"1970","train",80.9198349982,221,84,137,30.2433840973246,190.756615902675
"1980","watching",80.8977616480633,256,104,152,43.0683462767559,212.931653723244
"1980","hold hold hold",80.7778061435913,45,35,10,7.57060774396101,37.429392256039
"1990","never ever",80.7533656785264,144,80,64,30.5488362138526,113.451163786147
"2000","already",80.630304663743,241,131,110,64.8496506182034,176.150349381797
"2000","rain make",80.0994698731263,38,36,2,10.2252561140736,27.7747438859264
"2000","fresh",80.0861536423527,195,112,83,52.4717090064301,142.52829099357
"2010","boom boom",80.0058657077543,138,66,72,21.246855909027,116.753144090973
"2010","ball",79.9456536113932,169,75,94,26.0197003523591,142.980299647641
"1980","red wine",79.9438234438714,39,32,7,6.56119337809954,32.4388066219005
"1980","can fall",79.918996054919,37,31,6,6.22472192281238,30.7752780771876
"1970","high",79.8870679581067,790,203,587,108.109834556047,681.890165443953
"1970","beach",79.820962818857,130,60,70,17.7902259396027,112.209774060397
"1960","bully",79.274261676101,20,17,3,1.19446546785748,18.8055345321425
"1970","let good",79.0762712558591,37,29,8,5.06337199819462,31.9366280018054
"1990","body body",78.9736094465383,87,57,30,18.4565885458693,68.5434114541307
"2000","got",78.9671160931127,8289,2595,5694,2230.4512613041,6058.5487386959
"2000","drama",78.9232010959909,69,54,15,18.5669124176599,50.4330875823401
"1960","grass",78.8213566130302,96,35,61,5.7334342457159,90.2665657542841
"1980","dont talk",78.7542369475052,75,47,28,12.6176795732683,62.3823204267317
"2000","uh huh",78.7227660772763,276,144,132,74.2676496706396,201.73235032936
"2010","shake shake shake",78.6479610758768,272,102,170,41.8778609221401,230.12213907786
"2010","drink",78.5573713081907,292,107,185,44.9571154017092,247.042884598291
"1990","ya ya",78.4172460904877,157,84,73,33.3067172609365,123.693282739064
"2010","play play",78.1593259927448,61,40,21,9.39172616268583,51.6082738373142
"1990","mmm",78.1108365898789,194,97,97,41.1560710103291,152.843928989671
"2010","hey hey hey",77.9880166683667,297,108,189,45.7269290216015,251.273070978398
"1970","gonna walk",77.872580936379,33,27,6,4.51598043082223,28.4840195691778
"1980","chaka",77.849272510885,30,27,3,5.04707182930734,24.9529281706927
"2000","im cold",77.7116775709223,40,37,3,10.7634274884985,29.2365725115015
"1970","welcome back",77.5125448418085,27,24,3,3.69489307976364,23.3051069202364
"2010","side side",77.4737896959569,75,45,30,11.5472042983842,63.4527957016158
"1970","em back",77.2895903062022,40,30,10,5.47391567372392,34.5260843262761
"1960","go home",77.0346364611897,110,37,73,6.56956007321613,103.430439926784
"2000","boo",76.9424169158616,128,82,46,34.4429679631952,93.5570320368048
"2000","superman",76.7864634114984,50,43,7,13.4542843606231,36.5457156393769
"2000","london",76.5488160126531,70,54,16,18.8359981048724,51.1640018951276
"2000","girlfriend",76.5380482425978,135,85,50,36.3265677736824,98.6734322263176
"2010","hey",76.5347108622525,2216,498,1718,341.181396336259,1874.81860366374
"1970","get floor",76.5183331621782,92,48,44,12.590006049565,79.409993950435
"2010","make bed",76.3770684191236,26,24,2,4.00303082343986,21.9969691765601
"1970","easy",76.0809477526352,503,144,359,68.8344895970783,434.165510402922
"1970","old",76.045460370531,730,189,541,99.8989610454615,630.101038954538
"1990","anniversary",76.0227651274351,36,32,4,7.63720905346314,28.3627909465369
"2000","now walk",75.8574586358215,42,38,4,11.3015988629234,30.6984011370766
"1970","mama",75.8380318699581,460,135,325,62.950030247825,397.049969752175
"1980","electric",75.725283592271,54,38,16,9.08472929275321,44.9152707072468
"1990","jump",75.4786133840008,404,163,241,85.7064571555308,318.293542844469
"2010","tell everybody",75.3938186425614,36,29,7,5.54265806322443,30.4573419367756
"1970","brother",75.2323768470026,201,77,124,27.5064262604627,173.493573739537
"2010","bad bitches",75.0713942508911,30,26,4,4.61888171935369,25.3811182806463
"2010","body girl",75.0713942508911,30,26,4,4.61888171935369,25.3811182806463
"2010","hard hard",74.9708076275589,32,27,5,4.9268071673106,27.0731928326894
"2010","rock body",74.6825208803345,63,40,23,9.69965161064275,53.3003483893573
"2010","dont tell",74.5819381293941,117,58,59,18.0136387054794,98.9863612945206
"2000","youre youre",74.5613534653419,95,66,29,25.5631402851839,69.4368597148161
"1970","satisfied",74.4297278110427,125,57,68,17.1059864803872,107.894013519613
"1960","love",74.3770177869084,15283,1176,14107,912.750787263293,14370.2492127367
"1970","woman woman",74.3314811400405,24,22,2,3.28434940423435,20.7156505957656
"2000","see",74.2165357727251,5264,1699,3565,1416.4670574864,3847.5329425136
"1970","ho ho",73.8822333756219,30,25,5,4.10543675529294,25.8945632447071
"2000","floor",73.7939191394671,648,276,372,174.367525313676,473.632474686324
"1960","evrything",73.7519033393881,31,20,11,1.85142147517909,29.1485785248209
"1990","put em",73.7306874724732,54,41,13,11.4558135801947,42.5441864198053
"1970","hot stuff",73.677292889828,28,24,4,3.83174097160674,24.1682590283933
"2000","woh woh",73.4963656488298,60,48,12,16.1451412327477,43.8548587672523
"2000","smack",73.4261463878151,102,69,33,27.4467400956712,74.5532599043289
"2000","niggas",73.2883998413315,392,185,207,105.481589387285,286.518410612715
"2000","cause im",73.2503663519023,475,215,260,127.81570142592,347.18429857408
"1990","raise roof",73.1608998725988,35,31,4,7.42506435753361,27.5749356424664
"2000","dont give",73.142841588734,275,141,134,73.9985639834271,201.001436016573
"2010","like last",73.0286953773009,64,40,24,9.8536143346212,54.1463856653788
"2010","girl let",72.9863545538498,87,48,39,13.3947569861257,73.6052430138743
"1960","lovin good",72.846714290966,22,17,5,1.31391201464323,20.6860879853568
"2000","two step",72.781022888298,38,35,3,10.2252561140736,27.7747438859264
"2010","classic",72.5619629735425,37,29,8,5.69662078720288,31.3033792127971
"2000","spot",72.4927363080003,178,102,76,47.8972523238183,130.102747676182
"2010","found love",72.3985318192812,59,38,21,9.08380071472892,49.9161992852711
"1970","sweet sweet",72.3545214309633,89,46,43,12.1794623740357,76.8205376259643
"1970","people",72.3067229720781,972,232,740,133.016150871491,838.983849128509
"1970","love things",72.1263241183417,35,27,8,4.78967621450843,30.2103237854916
"1980","dream",72.1097976709439,789,229,560,132.737989110783,656.262010889217
"1980","living",72.0414933874272,517,166,351,86.9778711917298,430.02212880827
"2000","grind",72.0009102578349,82,59,23,22.0650263514219,59.9349736485781
"2010","even",71.8433418835499,1219,302,917,187.680560529738,1031.31943947026
"2000","thang",71.7781818304798,125,79,46,33.6357109015578,91.3642890984422
"2000","independent",71.7476966871704,57,46,11,15.3378841711103,41.6621158288897
"1990","never gonna get",71.7062170569045,39,33,6,8.27364314125173,30.7263568587483
"2010","hands air",71.704497617452,85,47,38,13.0868315381688,71.9131684618312
"2010","back road",71.6207607617864,29,25,4,4.46491899537523,24.5350810046248
"1990","anything",71.5527054171741,636,228,408,134.924026611182,501.075973388818
"1970","makin love",71.4811670833351,80,43,37,10.9478313474478,69.0521686525522
"1980","tonight tonight",71.4417211819327,69,43,26,11.6082652074069,57.3917347925931
"2010","burn burn",71.4269760653255,65,40,25,10.0075770585997,54.9924229414003
"1970","gimme gimme",71.3320844358427,100,49,51,13.6847891843098,86.3152108156902
"1970","papa",71.3077873499994,56,35,21,7.66348194321348,48.3365180567865
"1970","shine",71.162324378986,395,119,276,54.0549172780237,340.945082721976
"1960","miscellaneous",71.1120527123274,89,32,57,5.31537133196578,83.6846286680342
"2000","hustler",71.0172640310239,40,36,4,10.7634274884985,29.2365725115015
"2000","wanna jump",71.0172640310239,40,36,4,10.7634274884985,29.2365725115015
"2010","tonight",70.9952959314182,1587,373,1214,244.33884295381,1342.66115704619
"1980","uh uh uh uh",70.9859124564289,83,48,35,13.963565394417,69.036434605583
"1980","ive got",70.924050636716,579,180,399,97.4084863056316,481.591513694368
"1970","song",70.917154343282,816,202,614,111.667879743968,704.332120256032
"2000","big",70.9019606922543,964,380,584,259.398602472814,704.601397527186
"1990","biggie",70.8505859176465,47,37,10,9.97080070868799,37.029199291312
"2000","uh oh uh",70.8133884946282,45,39,6,12.1088559245608,32.8911440754392
"1980","rainy night",70.7770072437271,38,30,8,6.39295765045596,31.607042349544
"1970","coo",70.7479328003145,31,25,6,4.24228464713604,26.757715352864
"1970","things love",70.7479328003145,31,25,6,4.24228464713604,26.757715352864
"2010","champion",70.6197110849508,40,30,10,6.15850895913825,33.8414910408617
"1970","saturday",70.3514325903189,115,53,62,15.7375075619563,99.2624924380437
"2000","bitch get",70.3223460409106,37,34,3,9.9561704268611,27.0438295731389
"1970","mother",70.2468331470577,172,68,104,23.5378373970128,148.462162602987
"1970","burn baby",70.0476874597474,25,22,3,3.42119729607745,21.5788027039226
"1970","little lovin",70.0476874597474,25,22,3,3.42119729607745,21.5788027039226
"2000","ya love",70.0391296258304,54,44,10,14.530627109473,39.469372890527
"2010","gotta gotta gotta",69.9267018128952,38,29,9,5.85058351118134,32.1494164888187
"1990","mac",69.9199613972855,60,43,17,12.7286817557719,47.2713182442281
"1970","doo doo",69.833390457657,98,48,50,13.4110934006236,84.5889065993764
"1970","away come",69.6395200900634,46,31,15,6.29500302478251,39.7049969752175
"2000","aye",69.6302215319039,152,90,62,40.9010244562943,111.098975543706
"2000","dont think im",69.6143275376544,42,37,5,11.3015988629234,30.6984011370766
"1970","til youre",69.5606312755819,36,27,9,4.92652410635153,31.0734758936485
"2010","stuck",69.5061153124745,175,73,102,26.9434766962299,148.05652330377
"1980","poison",69.4607322208485,87,49,38,14.6365083049913,72.3634916950087
"2010","youre gonna hear",69.2266095987806,24,22,2,3.69510537548295,20.3048946245171
"2000","grill",69.1551336808163,58,46,12,15.6069698583228,42.3930301416772
"2000","poppin",69.0711450415928,118,75,43,31.7521110910705,86.2478889089295
"2000","know ya",69.0444132891051,49,41,8,13.1851986734107,35.8148013265894
"1990","body",69.0276913009416,1089,349,740,231.02557386726,857.97442613274
"1960","back get",69.010590392954,30,19,11,1.79169820178622,28.2083017982138
"1970","good",68.9985506393795,2885,556,2329,394.806167967338,2490.19383203266
"1980","eyes",68.9837943780814,1714,424,1290,288.356037181093,1425.64396281891
"1990","heart",68.8681457552509,2871,797,2074,609.067422013685,2261.93257798631
"1980","true",68.8493154782706,1022,278,744,171.936913651737,850.063086348263
"1980","tough",68.8279792810077,150,69,81,25.2353591465367,124.764640853463
"2000","tryna",68.7999251568839,167,96,71,44.9373097644812,122.062690235519
"1980","beat got",68.7882567777391,25,23,2,4.20589319108945,20.7941068089106
"2010","stupid",68.6375715723314,113,55,58,17.3977878095656,95.6022121904344
"2000","shit dont",68.4776137096827,44,38,6,11.8397702373483,32.1602297626517
"2010","good feeling",68.4745977067312,26,23,3,4.00303082343986,21.9969691765601
"2010","right now",68.4401212397924,502,151,351,77.2892874371851,424.710712562815
"2000","around goes",68.3792730683936,51,42,9,13.7233700478356,37.2766299521644
"2000","can handle",68.353722143474,64,49,15,17.2214839815976,46.7785160184024
"1970","sail",68.334730507258,96,47,49,13.1373976169374,82.8626023830626
"2010","watch",68.2890988302392,697,193,504,107.312018612984,589.687981387016
"2000","slow motion",68.1939441837077,66,50,16,17.7596553560225,48.2403446439775
"2010","break break break break",68.1811694285702,28,24,4,4.31095627139678,23.6890437286032
"2010","hate hate",68.1811694285702,28,24,4,4.31095627139678,23.6890437286032
"2010","like im one",68.1811694285702,28,24,4,4.31095627139678,23.6890437286032
"1990","want back",68.1022036594577,131,71,60,27.7909551667686,103.209044833231
"1970","makin",68.0892637570666,318,101,217,43.5176296061051,274.482370393895
"1970","sing song",68.0872364306019,58,35,23,7.93717772689968,50.0628222731003
"1980","johnny",68.0867036408594,53,36,17,8.91649356510963,44.0835064348904
"2010","honestly",67.9911215760065,51,34,17,7.85209892290127,43.1479010770987
"2000","just wanna know",67.8684405700719,36,33,3,9.68708473964864,26.3129152603514
"2000","yall yall",67.8684405700719,36,33,3,9.68708473964864,26.3129152603514
"2010","editor",67.8019945918957,104,52,52,16.0121232937595,87.9878767062406
"2000","duh",67.5509883593318,173,98,75,46.551823887756,126.448176112244
"2000","get started",67.5465506435419,46,39,7,12.3779416117733,33.6220583882267
"1990","tenderness",67.4919550509054,59,42,17,12.5165370598424,46.4834629401576
"1970","oh love",67.3778744577027,111,51,60,15.1901159945839,95.8098840054161
"2000","wanna try",67.3716685114274,55,44,11,14.7997127966854,40.2002872033146
"1970","evil",67.264661528367,77,41,36,10.5372876719185,66.4627123280815
"2000","nigga wanna",67.2456532163113,41,36,5,11.032513175711,29.9674868242891
"1990","dit",67.2110778583795,186,90,96,39.4589134428929,146.541086557107
"1970","know can make",67.2083186949809,30,24,6,4.10543675529294,25.8945632447071
"1960","day oh",67.1824523220215,31,19,12,1.85142147517909,29.1485785248209
"1990","youre never",67.1378704149543,100,59,41,21.2144695929532,78.7855304070468
"1990","funky",67.1205890731311,195,93,102,41.3682157062587,153.631784293741
"1960","carousel",67.0946169412183,16,14,2,0.955572374285983,15.044427625714
"1980","lover",67.0756663243746,500,159,341,84.117863821789,415.882136178211
"1990","mmm mmm",66.9934592113224,66,45,21,14.0015499313491,51.9984500686509
"1960","help help",66.9348366707647,52,24,28,3.10561021642945,48.8943897835706
"1970","dont bring",66.9008474955198,53,33,20,7.25293826768419,45.7470617323158
"1990","dat",66.8471281653571,350,142,208,74.2506435753361,275.749356424664
"1970","good good",66.8254978019715,181,69,112,24.7694684236007,156.230531576399
"2010","fucking",66.8231720759258,89,47,42,13.7026824340826,75.2973175659174
"1960","flowers",66.8028014245904,89,31,58,5.31537133196578,83.6846286680342
"1970","angie",66.7400790494204,22,20,2,3.01065362054815,18.9893463794518
"2010","like diamonds",66.7335293311122,37,28,9,5.69662078720288,31.3033792127971
"1970","enough keep",66.6840254009213,28,23,5,3.83174097160674,24.1682590283933
"1960","working",66.5982606374686,140,39,101,8.36125827500235,131.638741724998
"1960","sunshine",66.4690955770488,183,45,138,10.9293590308959,172.070640969104
"1970","lady",66.3728810357599,530,144,386,72.5293826768419,457.470617323158
"1970","hands together",66.3311987860992,24,21,3,3.28434940423435,20.7156505957656
"2010","whistle",66.1665026854807,52,34,18,8.00606164687973,43.9939383531203
"1970","alive",66.1117243553987,417,121,296,57.0655708985718,359.934429101428
"2000","get way",66.0646669294899,109,70,39,29.3303399061584,79.6696600938416
"2010","night get",66.0206446487155,42,30,12,6.46643440709516,35.5335655929048
"2000","benz",65.9604106715837,73,53,20,19.6432551665097,53.3567448334902
"1990","youre mind",65.8613524775458,39,32,7,8.27364314125173,30.7263568587483
"1980","away",65.8147936698007,2580,595,1985,434.048177320431,2145.95182267957
"1990","back want back",65.6748303424496,41,33,8,8.6979325331108,32.3020674668892
"1990","want back want back",65.6748303424496,41,33,8,8.6979325331108,32.3020674668892
"1990","wont know",65.6748303424496,41,33,8,8.6979325331108,32.3020674668892
"1990","ever need",65.6293283310218,45,35,10,9.54651131682892,35.4534886831711
"2000","everything everything",65.6247184321793,52,42,10,13.992455735048,38.007544264952
"2010","look body",65.5292764447805,33,26,7,5.08076989128906,27.9192301087109
"2000","woh woh woh",65.4195877364876,35,32,3,9.41799905243618,25.5820009475638
"1980","beat beat",65.3045221956841,52,35,17,8.74825783746605,43.251742162534
"2010","bad",65.3038589644175,1258,304,954,193.685106764898,1064.3148932351
"2000","ballin",65.1971132023368,54,43,11,14.530627109473,39.469372890527
"1960","im gonna make mine",65.1341293342439,22,16,6,1.31391201464323,20.6860879853568
"1980","got beat",65.0909343333373,38,29,9,6.39295765045596,31.607042349544
"2000","got looking",65.0546946406778,32,30,2,8.61074199079879,23.3892580092012
"2000","uh know",65.0546946406778,32,30,2,8.61074199079879,23.3892580092012
"1960","jerk",64.9793586121549,69,27,42,4.1209058641083,64.8790941358917
"2010","hate",64.898508810939,369,119,250,56.8122451480504,312.18775485195
"2010","without ya",64.7534917942758,27,23,4,4.15699354741832,22.8430064525817
"2010","boom boom boom",64.7104192770179,61,37,24,9.39172616268583,51.6082738373142
"1990","gonna break heart",64.6214920344661,32,28,4,6.78863026974501,25.211369730255
"2000","turn light",64.5721402522201,58,45,13,15.6069698583228,42.3930301416772
"2000","bring",64.5460382422997,896,352,544,241.100775742366,654.899224257634
"2010","tryna",64.5241710402162,167,69,98,25.7117749044022,141.288225095598
"1980","dont stand",64.4101144744885,50,34,16,8.4117863821789,41.5882136178211
"1990","let go",64.3980544707687,804,269,535,170.564335527343,633.435664472657
"1990","get lets get",64.2802256243163,54,39,15,11.4558135801947,42.5441864198053
"2000","see ya",64.1906767727044,62,47,15,16.6833126071727,45.3166873928273
"2010","bottles",64.1522160775917,101,50,51,15.5502351218241,85.4497648781759
"2010","good girl",64.1217993457951,82,44,38,12.6249433662334,69.3750566337666
"1980","stand dont",64.0618146458689,28,24,4,4.71060037402018,23.2893996259798
"2000","low low",64.0334248177998,74,53,21,19.9123408537222,54.0876591462778
"1980","around cant",64.0097456871932,32,26,6,5.38354328459449,26.6164567154055
"1980","ya ill",63.9278466322926,30,25,5,5.04707182930734,24.9529281706927
"1990","playin games",63.9176590233721,34,29,5,7.21291966160408,26.7870803383959
"2010","lie lie",63.9001084551383,56,35,21,8.62191254279355,47.3780874572064
"2000","throw",63.8446086647891,441,197,244,118.666788060696,322.333211939304
"2000","love game",63.8279673472012,42,36,6,11.3015988629234,30.6984011370766
"2000","game",63.4511849237318,644,267,377,173.291182564826,470.708817435174
"1960","im soul",63.4304494788183,17,14,3,1.01529564767886,15.9847043523211
"1970","stop dont stop",63.3062512494402,44,29,15,6.02130724109631,37.9786927589037
"1970","bout thing",63.1076507245493,27,22,5,3.69489307976364,23.3051069202364
"1970","slidin",63.1076507245493,27,22,5,3.69489307976364,23.3051069202364
"2000","fly",63.0285237399223,764,307,457,205.581465030321,558.418534969679
"2000","wide open",62.9720868321716,44,37,7,11.8397702373483,32.1602297626517
"1970","dont throw away",62.9576243819929,21,19,2,2.87380572870506,18.1261942712949
"1970","stayin alive",62.9576243819929,21,19,2,2.87380572870506,18.1261942712949
"1990","nah",62.8107758145418,156,78,78,33.0945725650069,122.905427434993
"1970","heaven heaven",62.7945386557498,34,25,9,4.65282832266533,29.3471716773347
"1960","real real real",62.7720539193761,23,16,7,1.3736352880361,21.6263647119639
"1970","jive",62.7270012529877,25,21,4,3.42119729607745,21.5788027039226
"2000","sexy",62.6418982267702,401,182,219,107.903360572197,293.096639427803
"2000","like hell",62.459297827384,57,44,13,15.3378841711103,41.6621158288897
"2000","already know",62.265951120501,59,45,14,15.8760555455353,43.1239444544647
"2010","know love let",62.1065694702867,22,20,2,3.38717992752604,18.612820072474
"2000","oh uh",62.0286161621133,63,47,16,16.9523982943851,46.0476017056149
"2000","shoulder",62.0232823697412,135,80,55,36.3265677736824,98.6734322263176
"2010","shake shake",62.0221327985102,402,125,277,61.8930150393394,340.106984960661
"1980","somebodys",62.0183343265251,115,56,59,19.3471086790115,95.6528913209885
"1980","modern",62.0069659707496,23,21,2,3.86942173580229,19.1305782641977
"2010","ever look",61.7923052758515,30,24,6,4.61888171935369,25.3811182806463
"2010","wish never met",61.7923052758515,30,24,6,4.61888171935369,25.3811182806463
"1980","uh uh uh",61.7425478308031,125,59,66,21.0294659554472,103.970534044553
"1960","lovin feelin",61.7349610936487,15,13,2,0.895849100893109,14.1041508991069
"2000","know see",61.7073985597465,48,39,9,12.9161129861982,35.0838870138018
"2000","like aint",61.7073985597465,48,39,9,12.9161129861982,35.0838870138018
"2010","counting",61.4959563152959,69,39,30,10.6234279545135,58.3765720454865
"2010","got us",61.4636379417908,28,23,5,4.31095627139678,23.6890437286032
"2000","get fly",61.406187719401,36,32,4,9.68708473964864,26.3129152603514
"2000","yes sir",61.406187719401,36,32,4,9.68708473964864,26.3129152603514
"1960","baby baby",61.2190275855621,786,107,679,46.9424928867989,739.057507113201
"1980","personally",61.1841099274825,25,22,3,4.20589319108945,20.7941068089106
"1980","time hands",61.1841099274825,25,22,3,4.20589319108945,20.7941068089106
"1970","little love",61.1797721834078,118,51,67,16.1480512374856,101.851948762514
"1990","lets get lets get",61.1381622940909,49,36,13,10.3950901005471,38.604909899453
"1990","things make",61.1381622940909,49,36,13,10.3950901005471,38.604909899453
"2010","gonna die",61.0710857056385,47,31,16,7.23624802698745,39.7637519730126
"1980","celebrate",61.0649928545331,88,47,41,14.8047440326349,73.1952559673651
"1980","hold",61.0095071758317,1726,418,1308,290.374865912815,1435.62513408718
"2010","stereo",60.8951777890888,42,29,13,6.46643440709516,35.5335655929048
"1990","doo",60.8706967678891,285,119,166,60.4612383399165,224.538761660084
"1990","da da da da",60.7318418117396,191,89,102,40.5196369225405,150.480363077459
"1990","never going",60.7194265599304,35,29,6,7.42506435753361,27.5749356424664
"1990","wanna sex",60.7194265599304,35,29,6,7.42506435753361,27.5749356424664
"2000","stress",60.6975518799394,43,36,7,11.5706845501359,31.4293154498641
"1970","day",60.6828855477307,2215,436,1779,303.118080432462,1911.88191956754
"1960","loud im",60.6096886895881,24,16,8,1.43335856142897,22.566641438571
"1980","second",60.6089710183253,244,92,152,41.049517545033,202.950482454967
"2000","motherfucker",60.5603086629241,104,66,38,27.9849114700961,76.0150885299039
"1960","little",60.5572040182867,2553,254,2299,152.473516972007,2400.52648302799
"2000","dont shit",60.5382964633854,33,30,3,8.87982767801125,24.1201723219887
"2010","now got",60.5201512331953,108,51,57,16.6279741896733,91.3720258103267
"1990","bad boys",60.4740336239047,37,30,7,7.84935374939267,29.1506462506073
"1990","november",60.4740336239047,37,30,7,7.84935374939267,29.1506462506073
"1990","dale",60.4589303766053,43,33,10,9.12222192496986,33.8777780750301
"1990","kickin",60.4589303766053,43,33,10,9.12222192496986,33.8777780750301
"1980","feel",60.3589656581024,3697,805,2892,621.967485098308,3075.03251490169
"2000","hah",60.2492215471092,74,52,22,19.9123408537222,54.0876591462778
"1970","rolling stone",60.180452122014,28,22,6,3.83174097160674,24.1682590283933
"1970","never can",60.1742530182221,43,28,15,5.88445934925321,37.1155406507468
"1960","come let show",60.1526548280704,21,15,6,1.25418874125035,19.7458112587496
"2010","night like",59.9219668936624,40,28,12,6.15850895913825,33.8414910408617
"1990","que se",59.8869928450212,28,25,3,5.94005148602689,22.0599485139731
"1980","tonight know",59.6965223567117,38,28,10,6.39295765045596,31.607042349544
"2000","three",59.6840587201262,367,168,199,98.7544472069737,268.245552793026
"2010","long love",59.6726644929757,33,25,8,5.08076989128906,27.9192301087109
"1970","wo wo",59.5562087139252,38,26,12,5.20021989003772,32.7997801099623
"1970","midnight train",59.5481254513092,26,21,5,3.55804518792055,22.4419548120795
"2000","booty",59.4289566035569,256,127,129,68.8859359263903,187.11406407361
"1990","lay back",59.409326221722,52,37,15,11.0315241883356,40.9684758116644
"1960","san",59.3133661683606,32,18,14,1.91114474857197,30.088855251428
"2010","want body",59.2904615231756,48,31,17,7.3902107509659,40.6097892490341
"2000","around goes around",59.210109417828,40,34,6,10.7634274884985,29.2365725115015
"1970","flash light",59.1852074031796,20,18,2,2.73695783686196,17.263042163138
"1970","let let let",59.1852074031796,20,18,2,2.73695783686196,17.263042163138
"1970","psychedelic",59.1852074031796,20,18,2,2.73695783686196,17.263042163138
"1980","youve",59.1330470654623,1117,290,827,187.919307777877,929.080692222123
"1980","long night",59.0300261084101,43,30,13,7.23413628867385,35.7658637113261
"1970","line",59.0166972270937,461,126,335,63.0868781396681,397.913121860332
"1990","lets get lets",59.0160545618677,50,36,14,10.6072347964766,39.3927652035234
"1990","right kind",58.9723674845973,30,26,4,6.36434087788595,23.6356591221141
"1990","scrub",58.9723674845973,30,26,4,6.36434087788595,23.6356591221141
"2000","woh",58.8499124274092,103,65,38,27.7158257828836,75.2841742171164
"2000","cha",58.7077751998232,92,60,32,24.7558832235465,67.2441167764535
"1960","soul",58.6451481938015,642,92,550,38.3423415182251,603.657658481775
"1980","hard money",58.6284022288497,22,20,2,3.70118600815871,18.2988139918413
"1980","hot hot hot",58.531103647818,34,26,8,5.72001473988165,28.2799852601184
"1970","child",58.5306749199361,288,90,198,39.4121928508122,248.587807149188
"2000","plus",58.5154376697483,101,64,37,27.1776544084587,73.8223455915413
"2010","wanna",58.5123318369853,4767,931,3836,733.940305205301,4033.0596947947
"1960","doggone",58.4940680712284,41,20,21,2.44865420910783,38.5513457908922
"1970","fallin love",58.4809083838803,78,39,39,10.6741355637616,67.3258644362384
"2000","bring em",58.4320906989767,117,71,46,31.4830254038581,85.5169745961419
"1990","que",58.3489187770985,167,80,87,35.4281642202318,131.571835779768
"2000","bounce",58.2776913788558,170,93,77,45.7445668261186,124.255433173881
"2000","say name",58.2095213167594,71,50,21,19.1050837920848,51.8949162079152
"1960","got ticket",58.1958751388804,16,13,3,0.955572374285983,15.044427625714
"2000","can run",58.1202091974345,57,43,14,15.3378841711103,41.6621158288897
"2000","thighs",58.1202091974345,57,43,14,15.3378841711103,41.6621158288897
"1990","rhyme",58.0552376474772,89,52,37,18.8808779377283,70.1191220622717
"2000","waiting waiting",58.0243828998021,59,44,15,15.8760555455353,43.1239444544647
"1990","oh ah",58.0005962025724,34,28,6,7.21291966160408,26.7870803383959
"2000","better make",57.9718281357655,61,45,16,16.4142269199602,44.5857730800398
"2010","beautiful like",57.9379207349192,25,21,4,3.84906809946141,21.1509319005386
"2010","love runs",57.9379207349192,25,21,4,3.84906809946141,21.1509319005386
"1980","miracle",57.9021827889407,59,36,23,9.9259079309711,49.0740920690289
"1980","oh comes",57.8806134661582,24,21,3,4.03765746344587,19.9623425365541
"1960","hair",57.8320273105756,369,64,305,22.0378878819705,346.96211211803
"2010","clap",57.8105619821154,154,63,91,23.7102594926823,130.289740507318
"1990","love anything",57.7989374119098,36,29,7,7.63720905346314,28.3627909465369
"1970","enjoy",57.7231666649906,130,53,77,17.7902259396027,112.209774060397
"1960","western",57.6200515888762,19,14,5,1.13474219446461,17.8652578055354
"2000","tipsy",57.5856296834689,29,27,2,7.80348492916141,21.1965150708386
"1980","victory",57.5556230822398,28,23,5,4.71060037402018,23.2893996259798
"1980","solid",57.4656686490882,39,28,11,6.56119337809954,32.4388066219005
"2000","think im",57.3776938885484,235,118,117,63.2351364949286,171.764863505071
"1970","born",57.3307091632242,300,92,208,41.0543675529294,258.945632447071
"1960","gas",57.1733855085677,91,29,62,5.43481787875153,85.5651821212485
"1990","everybody everybody",57.1545023634844,72,45,27,15.2744181069263,56.7255818930737
"2000","pimp",56.9700028696425,78,53,25,20.9886836025721,57.0113163974279
"2000","dont start",56.9141899111591,39,33,6,10.494341801286,28.505658198714
"2010","lights lights",56.9041635031757,39,27,12,6.0045462351598,32.9954537648402
"1970","doo doo doo",56.8404273876732,63,34,29,8.62141718611517,54.3785828138848
"2000","see us",56.7739397078273,76,52,24,20.4505122281471,55.5494877718529
"1960","union",56.7622139903149,26,16,10,1.55280510821472,24.4471948917853
"2000","poker",56.6408790937685,34,30,4,9.14891336522372,24.8510866347763
"1990","someone",56.6151005676201,862,278,584,182.868727891256,679.131272108744
"2010","girl look",56.5839630732689,58,34,24,8.92983799075047,49.0701620092495
"1960","evry",56.4035063842288,34,18,16,2.03059129535771,31.9694087046423
"1990","wild wild",56.324651030673,93,53,40,19.7294567214464,73.2705432785536
"2010","im one",56.2544262091295,239,84,155,36.7970910308511,202.202908969149
"2000","every girl",56.1847345548471,54,41,13,14.530627109473,39.469372890527
"2000","damn dont",56.1761028237713,41,34,7,11.032513175711,29.9674868242891
"1970","music",56.1238201836788,700,170,530,95.7935242901686,604.206475709831
"2000","jeans",56.0387651607585,155,86,69,41.7082815179316,113.291718482068
"1970","like yoyo",56.0069322458174,25,20,5,3.42119729607745,21.5788027039226
"1970","yoyo",56.0069322458174,25,20,5,3.42119729607745,21.5788027039226
"2010","gon",55.9688908336697,705,186,519,108.543720404812,596.456279595188
"2010","just wanna",55.9562397915875,377,116,261,58.043946939878,318.956053060122
"1970","away",55.9241266748652,2580,490,2090,353.067560955193,2226.93243904481
"1970","good good good",55.8931367718585,67,35,32,9.16880875348756,57.8311912465124
"1990","body baby",55.8623373029993,45,33,12,9.54651131682892,35.4534886831711
"2010","let love",55.8581501106119,248,86,162,38.1827555466572,209.817244453343
"2010","learn love",55.8123780097279,30,23,7,4.61888171935369,25.3811182806463
"2000","head get",55.6812968710559,31,28,3,8.34165630358633,22.6583436964137
"2010","swear",55.652841790758,299,98,201,46.0348544695584,252.965145530442
"1970","back town",55.5012563936485,23,19,4,3.14750151239125,19.8524984876087
"1970","satisfied im",55.5012563936485,23,19,4,3.14750151239125,19.8524984876087
"1970","swearin",55.5012563936485,23,19,4,3.14750151239125,19.8524984876087
"1970","toke",55.5012563936485,23,19,4,3.14750151239125,19.8524984876087
"1970","can ring",55.4239170536892,19,17,2,2.60010994501886,16.3998900549811
"1980","cant shake",55.3655967210338,40,28,12,6.72942910574312,33.2705708942569
"1980","heartache",55.3641397102976,75,41,34,12.6176795732683,62.3823204267317
"1970","eyes got",55.257969667371,21,18,3,2.87380572870506,18.1261942712949
"2010","always good",55.2358006650107,28,22,6,4.31095627139678,23.6890437286032
"2010","gonna hear",55.2358006650107,28,22,6,4.31095627139678,23.6890437286032
"2010","hard love",55.2358006650107,28,22,6,4.31095627139678,23.6890437286032
"2010","shit",55.2293307089549,896,224,672,137.950600684697,758.049399315303
"1960","puppet",55.2093384755065,20,14,6,1.19446546785748,18.8055345321425
"1970","devil",55.1915880161815,99,44,55,13.5479412924667,85.4520587075333
"1990","flow",55.1651386756895,177,82,95,37.5496111795271,139.450388820473
"1990","id die",55.1095796857027,37,29,8,7.84935374939267,29.1506462506073
"2000","jelly",55.1057136451962,28,26,2,7.53439924194894,20.4656007580511
"1970","wo wo wo",55.0706702215301,30,22,8,4.10543675529294,25.8945632447071
"1960","stoned",55.0331994589509,27,16,11,1.6125283816076,25.3874716183924
"1960","never never",55.0279431099707,121,33,88,7.22651608053775,113.773483919462
"1970","whod",54.9759782117324,49,29,20,6.7055467003118,42.2944532996882
"1990","back want",54.9132774840896,59,39,20,12.5165370598424,46.4834629401576
"1990","get lets",54.9132774840896,59,39,20,12.5165370598424,46.4834629401576
"1990","bomb",54.7380331403522,97,54,43,20.5780355051646,76.4219644948354
"1980","bites",54.6310644288317,29,23,6,4.87883610166376,24.1211638983362
"2000","best best",54.6275980719009,38,32,6,10.2252561140736,27.7747438859264
"2000","can get right",54.6275980719009,38,32,6,10.2252561140736,27.7747438859264
"2000","make better",54.5962859741465,86,56,30,23.1413691002718,62.8586308997282
"1980","straight now",54.5890336632439,23,20,3,3.86942173580229,19.1305782641977
"2010","come show",54.5773389480199,22,19,3,3.38717992752604,18.612820072474
"1970","gypsy",54.446461878978,38,25,13,5.20021989003772,32.7997801099623
"2000","boss",54.4282847694521,95,60,35,25.5631402851839,69.4368597148161
"1960","nothing like",54.3199444870829,40,19,21,2.38893093571496,37.611069064285
"2010","like ooh",54.1760108644177,43,28,15,6.62039713107362,36.3796028689264
"1990","lyrical",54.1564212904187,26,23,3,5.51576209416782,20.4842379058322
"2000","know got",54.1366441272995,213,108,105,57.3152513762545,155.684748623746
"2010","better run",54.1059949968151,54,32,22,8.31398709483664,45.6860129051634
"1970","ill good",54.1027132143415,28,21,7,3.83174097160674,24.1682590283933
"2000","chicks",54.0398238928912,82,54,28,22.0650263514219,59.9349736485781
"2000","like mine",53.9301885267383,40,33,7,10.7634274884985,29.2365725115015
"1990","slam",53.7745448113822,55,37,18,11.6679582761242,43.3320417238758
"1970","stop dont",53.6807113815336,56,31,25,7.66348194321348,48.3365180567865
"2010","never met",53.6025225226497,46,29,17,7.08228530300899,38.917714696991
"1980","gonna take",53.5689284498007,170,69,101,28.6000736994082,141.399926300592
"2010","wake",53.4620046059793,330,104,226,50.8076989128906,279.192301087109
"1960","say loud",53.4121633607906,28,16,12,1.67225165500047,26.3277483449995
"1960","suzie",53.4121633607906,28,16,12,1.67225165500047,26.3277483449995
"1960","vibrations",53.4121633607906,28,16,12,1.67225165500047,26.3277483449995
"1980","physical",53.3823796890837,41,28,13,6.8976648333867,34.1023351666133
"2010","another round",53.339720529192,31,23,8,4.77284444333215,26.2271555566679
"2010","need need need",53.339720529192,31,23,8,4.77284444333215,26.2271555566679
"2000","can roll",53.2629480232679,30,27,3,8.07257061637387,21.9274293836261
"1980","dont remember",53.2035084073117,54,33,21,9.08472929275321,44.9152707072468
"2010","naturally",53.1781110070654,49,30,19,7.54417347494436,41.4558265250556
"1970","beware",53.1694161699255,36,24,12,4.92652410635153,31.0734758936485
"2000","woo",53.0600251680204,217,109,108,58.3915941251043,158.608405874896
"1960","catch us",53.0334776033896,21,14,7,1.25418874125035,19.7458112587496
"1960","happy together",52.9902175274502,15,12,3,0.895849100893109,14.1041508991069
"1960","light light",52.9902175274502,15,12,3,0.895849100893109,14.1041508991069
"1970","time love",52.9004868653424,87,40,47,11.9057665903495,75.0942334096505
"2010","diamond",52.878962367562,146,59,87,22.4785577008546,123.521442299145
"1990","yeah",52.8350511977285,6260,1568,4692,1328.02579651887,4931.97420348113
"1970","im satisfied",52.8086128650015,31,22,9,4.24228464713604,26.757715352864
"1980","got hold",52.7933521724344,57,34,23,9.58943647568394,47.4105635243161
"2000","got got",52.6811790451473,166,89,77,44.6682240772687,121.331775922731
"2010","shots",52.6800654787352,70,37,33,10.7773906784919,59.2226093215081
"2000","cars",52.6706860575925,156,85,71,41.9773672051441,114.022632794856
"1970","let let",52.6190622916377,60,32,28,8.21087351058588,51.7891264894141
"2010","ayo",52.6121072693552,29,22,7,4.46491899537523,24.5350810046248
"2010","says youre",52.6121072693552,29,22,7,4.46491899537523,24.5350810046248
"1990","cradle",52.6016346679669,32,26,6,6.78863026974501,25.211369730255
"1990","die without",52.6016346679669,32,26,6,6.78863026974501,25.211369730255
"2000","im gon",52.5573021741783,134,76,58,36.0574820864699,97.9425179135301
"1970","baby loves",52.4857594017165,24,19,5,3.28434940423435,20.7156505957656
"2000","mr dj",52.3508787537701,37,31,6,9.9561704268611,27.0438295731389
"2010","trouble",52.3431207924893,162,63,99,24.9419612845099,137.05803871549
"1990","hurt dont",52.2219536226339,49,34,15,10.3950901005471,38.604909899453
"1970","throw away",52.205153356249,54,30,24,7.38978615952729,46.6102138404727
"2010","drank",52.0372277675502,90,43,47,13.8566451580611,76.1433548419389
"1990","will love",52.0338230957809,94,52,42,19.941601417376,74.058398582624
"1960","need love",51.9911439469302,180,40,140,10.7501892107173,169.249810789283
"2000","want now",51.9885706194198,54,40,14,14.530627109473,39.469372890527
"2010","got night",51.9860473912947,27,21,6,4.15699354741832,22.8430064525817
"1980","breakdown",51.9724205339559,30,23,7,5.04707182930734,24.9529281706927
"1980","theyre",51.9623793287423,472,143,329,79.4072634477688,392.592736552231
"2000","naughty",51.9622811416062,56,41,15,15.0687984838979,40.9312015161021
"1970","im fallin",51.7302870610392,64,33,31,8.75826507795827,55.2417349220417
"1980","rumors",51.7035623495321,37,26,11,6.22472192281238,30.7752780771876
"1970","round oh",51.675029894539,18,16,2,2.46326205317576,15.5367379468242
"2010","boy boy",51.6491931306379,50,30,20,7.69813619892281,42.3018638010772
"1970","sky",51.6170771283683,562,141,421,76.908515215821,485.091484784179
"1980","wall",51.6135358783955,184,72,112,30.9553738864183,153.044626113582
"2010","aint fuckin",51.4974504177448,19,17,2,2.92529175559067,16.0747082444093
"1990","ever wanted",51.4842264296083,66,41,25,14.0015499313491,51.9984500686509
"2010","cake",51.4426938465109,94,44,50,14.4724960539749,79.5275039460251
"2000","chain",51.4003780357151,86,55,31,23.1413691002718,62.8586308997282
"2010","tie",51.3829149836347,68,36,32,10.469465230535,57.530534769465
"1960","gimme",51.3455103745472,386,63,323,23.0531835296493,362.946816470351
"1980","heart needs",51.3105116297331,22,19,3,3.70118600815871,18.2988139918413
"1960","bop",51.247213903537,284,52,232,16.9614096435762,267.038590356424
"1980","theres",51.2330933649847,1942,450,1492,326.713783083828,1615.28621691617
"1980","batman",51.1422773058341,24,20,4,4.03765746344587,19.9623425365541
"1980","thriller",51.1422773058341,24,20,4,4.03765746344587,19.9623425365541
"2010","fin",51.1358770714277,21,18,3,3.23321720354758,17.7667827964524
"2010","pumped",51.1358770714277,21,18,3,3.23321720354758,17.7667827964524
"2010","give fuck",51.082344445054,91,43,48,14.0106078820395,76.9893921179605
"1960","anne",51.0806625583814,13,11,2,0.776402554107361,12.2235974458926
"1960","baby friends",51.0806625583814,13,11,2,0.776402554107361,12.2235974458926
"1960","darling now",51.0806625583814,13,11,2,0.776402554107361,12.2235974458926
"1960","grapevine",51.0806625583814,13,11,2,0.776402554107361,12.2235974458926
"1960","im proud say",51.0806625583814,13,11,2,0.776402554107361,12.2235974458926
"1960","jumping jack",51.0806625583814,13,11,2,0.776402554107361,12.2235974458926
"1960","proud say",51.0806625583814,13,11,2,0.776402554107361,12.2235974458926
"2000","stick",51.0717989404002,133,75,58,35.7883963992575,97.2116036007425
"1990","want ride",50.9345122173453,43,31,12,9.12222192496986,33.8777780750301
"1970","stop til",50.9341338214281,40,25,15,5.47391567372392,34.5260843262761
"1970","can know",50.9003160929741,55,30,25,7.52663405137039,47.4733659486296
"1970","slippin",50.9003160929741,55,30,25,7.52663405137039,47.4733659486296
"1990","needed",50.8941891905627,227,96,131,48.1568459760037,178.843154023996
"2000","freak",50.8087377226845,186,96,90,50.049937821518,135.950062178482
"1990","puff",50.8040021008751,64,40,24,13.57726053949,50.42273946051
"1970","surely",50.7724330773036,93,41,52,12.7268539414081,80.2731460585919
"1970","stayin",50.7126844897167,43,26,17,5.88445934925321,37.1155406507468
"1970","sweet sweet sweet",50.7125530807204,27,20,7,3.69489307976364,23.3051069202364
"1980","needs",50.7041258198362,235,85,150,39.5353959962408,195.464604003759
"2000","low",50.6532489734325,660,262,398,177.596553560225,482.403446439775
"1970","get ready",50.6334822842244,49,28,21,6.7055467003118,42.2944532996882
"1980","get around",50.5918927394937,40,27,13,6.72942910574312,33.2705708942569
"1990","ding dong",50.5778133207751,27,23,4,5.72790679009735,21.2720932099026
"1990","dong",50.5778133207751,27,23,4,5.72790679009735,21.2720932099026
"2000","shit make",50.4864017098542,45,35,10,12.1088559245608,32.8911440754392
"1960","darling",50.4825620388268,260,49,211,15.5280510821472,244.471948917853
"1960","without babe",50.469970176512,26,15,11,1.55280510821472,24.4471948917853
"2010","rude",50.4304288983239,48,29,19,7.3902107509659,40.6097892490341
"1980","well",50.3873354895917,2420,543,1877,407.130460897459,2012.86953910254
"1990","im baby",50.3762570337901,50,34,16,10.6072347964766,39.3927652035234
"1960","come come let",50.3089592831651,19,13,6,1.13474219446461,17.8652578055354
"2010","hella",50.2061288066552,30,22,8,4.61888171935369,25.3811182806463
"2000","slim",50.1688927186396,61,43,18,16.4142269199602,44.5857730800398
"1960","cry like",50.1307277198635,16,12,4,0.955572374285983,15.044427625714
"2000","stop just",50.1119933629944,49,37,12,13.1851986734107,35.8148013265894
"2000","flirt",50.0846261216929,36,30,6,9.68708473964864,26.3129152603514
"2000","good girls",50.0846261216929,36,30,6,9.68708473964864,26.3129152603514
"1990","nothing wrong",50.064760083682,37,28,9,7.84935374939267,29.1506462506073
"2000","even",50.0635544005311,1219,441,778,328.015452711991,890.984547288008
"1960","honey",50.044182411766,421,66,355,25.1434980983999,395.8565019016
"2010","na na",50.0279231653656,1366,310,1056,210.313080954571,1155.68691904543
"1970","fallin",49.9387551065901,188,64,124,25.7274036665024,162.272596333498
"1970","nights",49.9337361492963,387,106,281,52.9601341432789,334.039865856721
"1990","want back want",49.8610557548927,48,33,15,10.1829454046175,37.8170545953825
"1980","much time",49.7992663448866,62,35,27,10.4306151139018,51.5693848860982
"1990","mic",49.7911890108211,55,36,19,11.6679582761242,43.3320417238758
"2000","tryin",49.6275669680302,516,213,303,138.848214601631,377.151785398369
"2010","let burn",49.621376339246,43,27,16,6.62039713107362,36.3796028689264
"1980","cruel",49.5536270792245,140,59,81,23.5530018701009,116.446998129899
"1980","baby true",49.5337917453094,31,23,8,5.21530755695092,25.7846924430491
"1980","wild",49.5329557607103,479,143,336,80.5849135412738,398.415086458726
"1970","knock knock",49.5302805829945,30,21,9,4.10543675529294,25.8945632447071
"2010","now watch",49.4337977594655,28,21,7,4.31095627139678,23.6890437286032
"2010","feel like",49.4093419712685,506,140,366,77.9051383330989,428.094861666901
"2010","sink",49.2192407413954,46,28,18,7.08228530300899,38.917714696991
"1990","kind girl",49.1947442823878,53,35,18,11.2436688842652,41.7563311157348
"2010","make feel",49.1659719131019,404,118,286,62.2009404872963,341.799059512704
"2000","im like",49.1482068842437,130,73,57,34.9811393376201,95.0188606623799
"2010","sexy lady",49.0751526262347,38,25,13,5.85058351118134,32.1494164888187
"1990","somethings",49.0034447939098,78,45,33,16.5472862825035,61.4527137174965
"1970","misty",48.9865409046395,23,18,5,3.14750151239125,19.8524984876087
"2010","young",48.9566668298996,589,157,432,90.6840444233108,498.315955576689
"1990","turn upside",48.9168397417953,44,31,13,9.33436662089939,34.6656333791006
"1970","rock roll",48.8814587240883,99,42,57,13.5479412924667,85.4520587075333
"2010","less",48.8342129560011,152,59,93,23.4023340447254,128.597665955275
"2010","world like",48.7574772202757,26,20,6,4.00303082343986,21.9969691765601
"1970","sad",48.7015749743427,326,93,233,44.6124127408499,281.38758725915
"2010","got bad",48.6980383184399,61,33,28,9.39172616268583,51.6082738373142
"1970","groove",48.651344631024,297,87,210,40.6438238774001,256.3561761226
"2000","everything",48.6449970959827,1269,455,814,341.469737072615,927.530262927385
"2000","like move",48.6374334064157,42,33,9,11.3015988629234,30.6984011370766
"1970","water",48.612817703964,245,76,169,33.527733501559,211.472266498441
"1960","now",48.5871747620318,6525,530,5995,389.694358888502,6135.3056411115
"2000","battlefield",48.5755460657675,33,28,5,8.87982767801125,24.1201723219887
"1980","going gets",48.5512168700902,19,17,2,3.19647882522798,15.803521174772
"2010","studio",48.4596997197933,41,26,15,6.31247168311671,34.6875283168833
"1980","shy",48.4566786889654,124,54,70,20.8612302278037,103.138769772196
"1970","wheres",48.4191788495242,57,30,27,7.80032983505658,49.1996701649434
"1970","love baby love love",48.3490794376428,21,17,4,2.87380572870506,18.1261942712949
"1960","yellow",48.3386576378724,158,36,122,9.43627719607408,148.563722803926
"1960","california",48.3017711187062,80,25,55,4.77786187142992,75.2221381285701
"1960","need love need love",48.2331401194375,20,13,7,1.19446546785748,18.8055345321425
"1990","west",48.2214653454356,212,90,122,44.9746755370607,167.025324462939
"1980","talk",48.2198581475081,975,250,725,164.029834452488,810.970165547512
"1980","fooling around",48.0463609844017,21,18,3,3.53295028051514,17.4670497194849
"1980","know night",48.0463609844017,21,18,3,3.53295028051514,17.4670497194849
"1980","operator",48.0463609844017,21,18,3,3.53295028051514,17.4670497194849
"1980","karma",48.0445729703049,34,24,10,5.72001473988165,28.2799852601184
"1980","feel heat",48.0259944205039,44,28,16,7.40237201631743,36.5976279836826
"1980","give good",48.0259944205039,44,28,16,7.40237201631743,36.5976279836826
"2010","worst",48.0058380259273,71,36,35,10.9313534024704,60.0686465975296
"2000","shake ass",47.985923824653,50,37,13,13.4542843606231,36.5457156393769
"2010","stay one",47.9842442396577,18,16,2,2.77132903161221,15.2286709683878
"2010","turn baby",47.9842442396577,18,16,2,2.77132903161221,15.2286709683878
"1980","eyes dream",47.9507392113089,23,19,4,3.86942173580229,19.1305782641977
"1980","im forever",47.9507392113089,23,19,4,3.86942173580229,19.1305782641977
"1970","arizona",47.9400559053082,17,15,2,2.32641416133266,14.6735858386673
"1970","gotta treat",47.9400559053082,17,15,2,2.32641416133266,14.6735858386673
"1970","lonely girl",47.9400559053082,17,15,2,2.32641416133266,14.6735858386673
"1980","hold hold",47.9086566847552,101,47,54,16.9918084920014,84.0081915079986
"2010","air",47.8437058057949,417,120,297,64.2024558990163,352.797544100984
"2010","im edge",47.8330163827068,22,18,4,3.38717992752604,18.612820072474
"1960","put little love",47.8179877469925,14,11,3,0.836125827500235,13.1638741724998
"1960","thing wanna",47.8179877469925,14,11,3,0.836125827500235,13.1638741724998
"1990","hold one",47.7946786085009,38,28,10,8.0614984453222,29.9385015546778
"1960","enough aint",47.6514994830765,17,12,5,1.01529564767886,15.9847043523211
"2000","baby hey",47.6021386169593,71,47,24,19.1050837920848,51.8949162079152
"1970","dancin",47.4957369263809,162,57,105,22.1693584785819,139.830641521418
"1990","ding",47.493971297205,74,43,31,15.6987074987853,58.3012925012147
"1960","believer",47.4688491043924,28,15,13,1.67225165500047,26.3277483449995
"1960","jumping",47.4688491043924,28,15,13,1.67225165500047,26.3277483449995
"1980","listen heart",47.4526604904098,47,29,18,7.90707919924816,39.0929208007518
"1990","cuz love",47.430457411102,28,23,5,5.94005148602689,22.0599485139731
"1990","flavor",47.430457411102,28,23,5,5.94005148602689,22.0599485139731
"1960","thank",47.4158388583598,244,46,198,14.5724787078612,229.427521292139
"1990","baby",47.4129306833638,9098,2203,6895,1930.09244356688,7167.90755643312
"1970","mountain",47.3956513023808,141,52,89,19.2955527498768,121.704447250123
"1990","near far",47.2605065903767,30,24,6,6.36434087788595,23.6356591221141
"1990","barbie",47.2419426325064,32,25,7,6.78863026974501,25.211369730255
"1990","rub",47.22456979879,64,39,25,13.57726053949,50.42273946051
"1970","stone",47.1748974604483,154,55,99,21.0745753438371,132.925424656163
"2010","better find",47.0967984878753,29,21,8,4.46491899537523,24.5350810046248
"2010","style",47.0907779414183,207,72,135,31.8702838635405,175.12971613646
"2010","im man",47.0246510079341,99,44,55,15.2423096738672,83.7576903261328
"2010","louder",46.9398424097739,72,36,36,11.0853161264489,60.9146838735512
"2010","low",46.9354090359121,660,170,490,101.615397825781,558.384602174219
"1990","shook",46.9335183377704,52,34,18,11.0315241883356,40.9684758116644
"1970","come come come come",46.9077546420665,65,32,33,8.89511296980137,56.1048870301986
"2010","edge",46.7875510753724,110,47,63,16.9358996376302,93.0641003623698
"1970","faces",46.785783789202,94,40,54,12.8637018332512,81.1362981667488
"1990","dangerous",46.7435030820805,72,42,30,15.2744181069263,56.7255818930737
"1960","hey",46.6577882587413,2216,215,2001,132.346773838609,2083.65322616139
"1980","wants dance",46.5775112540334,30,22,8,5.04707182930734,24.9529281706927
"1970","sixteen",46.5277368097662,37,23,14,5.06337199819462,31.9366280018054
"2000","bend",46.5066958988428,61,42,19,16.4142269199602,44.5857730800398
"2000","boy make",46.5009197743,41,32,9,11.032513175711,29.9674868242891
"1970","fooled",46.4577042417008,49,27,22,6.7055467003118,42.2944532996882
"1970","call call call",46.3737541837213,24,18,6,3.28434940423435,20.7156505957656
"1970","im falling love",46.3737541837213,24,18,6,3.28434940423435,20.7156505957656
"1970","troubled",46.3737541837213,24,18,6,3.28434940423435,20.7156505957656
"1970","tryin ta",46.3737541837213,24,18,6,3.28434940423435,20.7156505957656
"2010","bigger",46.3268319875903,63,33,30,9.69965161064275,53.3003483893573
"2000","make",46.325405121529,5520,1713,3807,1485.35299341279,4034.64700658721
"2000","ricky",46.2842347172349,32,27,5,8.61074199079879,23.3892580092012
"1970","baby right",46.2805434043095,29,20,9,3.96858886344984,25.0314111365502
"2000","got got got got",46.2670489509451,43,33,10,11.5706845501359,31.4293154498641
"2010","aint gon",46.2636272645539,48,28,20,7.3902107509659,40.6097892490341
"2010","backseat",46.2636272645539,48,28,20,7.3902107509659,40.6097892490341
"2010","letting",46.1914668414404,100,44,56,15.3962723978456,84.6037276021544
"2000","bleeding",46.1080144911612,45,34,11,12.1088559245608,32.8911440754392
"2000","hatin",46.1080144911612,45,34,11,12.1088559245608,32.8911440754392
"2000","wanna come",46.0972685847607,55,39,16,14.7997127966854,40.2002872033146
"2000","girls",46.0835856747492,942,349,593,253.478717354139,688.521282645861
"1960","washed",46.0622232668438,43,18,25,2.56810075589358,40.4318992441064
"2000","way move",46.0572023202263,90,55,35,24.2177118491216,65.7822881508784
"2010","lie",46.0516112292868,517,140,377,79.5987282968619,437.401271703138
"1990","just another",46.0133378008901,111,56,55,23.548061248178,87.451938751822
"1960","theyll",45.8512740497954,141,33,108,8.42098154839523,132.579018451605
"1970","golden",45.8502231479565,99,41,58,13.5479412924667,85.4520587075333
"1990","mack",45.8114333587081,78,44,34,16.5472862825035,61.4527137174965
"1960","baby im gonna make",45.7935251248372,12,10,2,0.716679280714487,11.2833207192855
"1960","dock",45.7935251248372,12,10,2,0.716679280714487,11.2833207192855
"1960","youre born",45.7935251248372,12,10,2,0.716679280714487,11.2833207192855
"1960","real real",45.7203812844585,54,20,34,3.22505676321519,50.7749432367848
"2010","blow",45.6986491098232,318,97,221,48.9601462251491,269.039853774851
"1960","law",45.6266458645937,78,24,54,4.65841532464417,73.3415846753558
"2000","gucci",45.5861820455957,34,28,6,9.14891336522372,24.8510866347763
"2000","turn music",45.5437131158343,68,45,23,18.2978267304474,49.7021732695526
"1960","happy made",45.4572665171911,18,12,6,1.07501892107173,16.9249810789283
"1970","love love baby",45.4320923081537,53,28,25,7.25293826768419,45.7470617323158
"1980","get yeah yeah",45.4154247463966,26,20,6,4.37412891873303,21.625871081267
"1980","much true",45.4154247463966,26,20,6,4.37412891873303,21.625871081267
"1960","well know",45.3422711433273,49,19,30,2.92644039625082,46.0735596037492
"1990","ill give love",45.3140659881421,37,27,10,7.84935374939267,29.1506462506073
"2010","one last",45.2659143401669,43,26,17,6.62039713107362,36.3796028689264
"1980","now ive",45.2634769084404,78,39,39,13.1223867561991,64.8776132438009
"2000","life changed",45.2456270467146,24,22,2,6.45805649309909,17.5419435069009
"2000","nigga dont know",45.2456270467146,24,22,2,6.45805649309909,17.5419435069009
"1980","beat one",45.2153219232639,18,16,2,3.0282430975844,14.9717569024156
"1990","cant touch",45.1971051097171,46,31,15,9.75865601275846,36.2413439872415
"1980","yah",45.1889613788049,33,23,10,5.55177901223807,27.4482209877619
"1960","send",45.1762912071385,191,39,152,11.4071452180389,179.592854781961
"2010","break",45.153591261323,977,231,746,150.421581326952,826.578418673048
"1980","hush",45.1340906163718,75,38,37,12.6176795732683,62.3823204267317
"1960","think think",45.1171362794597,44,18,26,2.62782402928645,41.3721759707135
"1960","come",45.0595932057908,4867,408,4459,290.673171603118,4576.32682839688
"2000","dey",45.0590370872006,36,29,7,9.68708473964864,26.3129152603514
"2000","messing",45.0590370872006,36,29,7,9.68708473964864,26.3129152603514
"2000","got got got",45.0557828494992,64,43,21,17.2214839815976,46.7785160184024
"1960","la la",45.0440058678932,1558,162,1396,93.0488599460976,1464.9511400539
"1990","hip hop",45.0139418857736,35,26,9,7.42506435753361,27.5749356424664
"1960","comes",44.9447981982259,702,90,612,41.9257379217975,660.074262078203
"2010","im hard",44.9445583508245,23,18,5,3.5411426515045,19.4588573484955
"2010","lessons",44.9414751702468,30,21,9,4.61888171935369,25.3811182806463
"2010","turn turn turn",44.9414751702468,30,21,9,4.61888171935369,25.3811182806463
"1970","love hear",44.9185829718018,74,34,40,10.1267439963892,63.8732560036107
"2000","diddy",44.8749308693321,29,25,4,7.80348492916141,21.1965150708386
"1970","high school",44.860292327581,44,25,19,6.02130724109631,37.9786927589037
"1970","believe believe",44.8428113708744,67,32,35,9.16880875348756,57.8311912465124
"1970","oak tree",44.8055457966539,20,16,4,2.73695783686196,17.263042163138
"1960","fought",44.7996057416798,30,15,15,1.79169820178622,28.2083017982138
"1980","cant hold back",44.7981045556245,20,17,3,3.36471455287156,16.6352854471284
"1980","enough enough",44.7981045556245,20,17,3,3.36471455287156,16.6352854471284
"1980","lonely heart",44.7775289875703,22,18,4,3.70118600815871,18.2988139918413
"2000","vip",44.6652287685561,38,30,8,10.2252561140736,27.7747438859264
"1990","love give love",44.6436529285873,31,24,7,6.57648557381548,24.4235144261845
"1990","make jump",44.6436529285873,31,24,7,6.57648557381548,24.4235144261845
"1960","comes comes",44.6101876472477,22,13,9,1.31391201464323,20.6860879853568
"1960","happy",44.5988532820366,520,73,447,31.0561021642945,488.943897835706
"1960","please",44.5832307082469,1038,119,919,61.9927577818031,976.007242218197
"2010","oh youre gonna",44.5027228438268,21,17,4,3.23321720354758,17.7667827964524
"2010","wide awake",44.5027228438268,21,17,4,3.23321720354758,17.7667827964524
"2010","hey hey hey hey",44.4935724823239,159,59,100,24.4800731125746,134.519926887425
"2010","go making",44.48495123149,17,15,2,2.61736630763376,14.3826336923662
"2010","light like",44.48495123149,17,15,2,2.61736630763376,14.3826336923662
"2010","meenie",44.48495123149,17,15,2,2.61736630763376,14.3826336923662
"2010","now whole",44.48495123149,17,15,2,2.61736630763376,14.3826336923662
"2010","ridin round",44.48495123149,17,15,2,2.61736630763376,14.3826336923662
"2010","shot shot",44.48495123149,17,15,2,2.61736630763376,14.3826336923662
"1980","whos gonna",44.4808783134122,49,29,20,8.24355065453532,40.7564493454647
"2010","got moves",44.4751613765525,38,24,14,5.85058351118134,32.1494164888187
"2000","fire burning",44.3781309932748,40,31,9,10.7634274884985,29.2365725115015
"2000","see dreams",44.3781309932748,40,31,9,10.7634274884985,29.2365725115015
"2000","dollar",44.3364409075662,145,77,68,39.017424645807,105.982575354193
"1970","love train",44.3293400253731,18,15,3,2.46326205317576,15.5367379468242
"1970","will see will",44.3293400253731,18,15,3,2.46326205317576,15.5367379468242
"2010","bright",44.3261558884584,277,87,190,42.6476745420324,234.352325457968
"2010","loyal",44.3024150430746,19,16,3,2.92529175559067,16.0747082444093
"2000","get like",44.297862274778,56,39,17,15.0687984838979,40.9312015161021
"1960","la la la",44.2485339774037,1245,136,1109,74.3554753741281,1170.64452462587
"1970","bear",44.2443155460907,54,28,26,7.38978615952729,46.6102138404727
"2010","heart attack",44.0137630991436,28,20,8,4.31095627139678,23.6890437286032
"2010","map",44.0137630991436,28,20,8,4.31095627139678,23.6890437286032
"2000","runaway love",44.0045042106615,31,26,5,8.34165630358633,22.6583436964137
"1980","good love",43.9738539745369,73,37,36,12.2812081179812,60.7187918820188
"2000","block",43.9305081580714,148,78,70,39.8246817074444,108.175318292556
"1990","days",43.7176038777065,682,219,463,144.682682623941,537.317317376059
"2010","rock rock",43.6755645565905,82,38,44,12.6249433662334,69.3750566337666
"2000","im thug",43.6695108321468,26,23,3,6.99622786752402,19.003772132476
"2000","like somebody",43.6695108321468,26,23,3,6.99622786752402,19.003772132476
"1980","patience",43.6454921665143,29,21,8,4.87883610166376,24.1211638983362
"2010","screaming",43.6101356523381,56,30,26,8.62191254279355,47.3780874572064
"1990","another",43.5905381601054,1121,332,789,237.814204137005,883.185795862995
"2000","im just",43.5208886608468,462,190,272,124.317587492158,337.682412507842
"2010","ass",43.4294015251845,629,161,468,96.842553382449,532.157446617551
"2010","go go",43.4089759897067,266,84,182,40.9540845782694,225.045915421731
"1970","georgia",43.4001276721923,42,24,18,5.74761145741011,36.2523885425899
"1970","loves loves",43.3957452230654,39,23,16,5.33706778188082,33.6629322181192
"1970","youre doin",43.3957452230654,39,23,16,5.33706778188082,33.6629322181192
"2000","cock",43.3554860365693,33,27,6,8.87982767801125,24.1201723219887
"2000","cum",43.3554860365693,33,27,6,8.87982767801125,24.1201723219887
"2000","range",43.3554860365693,33,27,6,8.87982767801125,24.1201723219887
"2000","drive",43.3050307452337,340,148,192,91.4891336522372,248.510866347763
"1960","laughing",43.2650269275534,82,24,58,4.89730841821566,77.1026915817843
"1970","affair",43.2361566529852,87,37,50,11.9057665903495,75.0942334096505
"1970","lay",43.2123740485387,465,117,348,63.6342697070405,401.365730292959
"1960","mrs",43.113143115182,27,14,13,1.6125283816076,25.3874716183924
"1970","gimme gimme gimme",43.061868742904,28,19,9,3.83174097160674,24.1682590283933
"2010","fly like",43.0281888756261,66,33,33,10.1615397825781,55.8384602174219
"1970","runner",42.9857040243565,23,17,6,3.14750151239125,19.8524984876087
"1980","second chance",42.9712948249179,27,20,7,4.5423646463766,22.4576353536234
"2010","hard",42.9642358364377,1241,279,962,191.067740457264,1049.93225954274
"1990","will make",42.9176735138502,86,46,40,18.2444438499397,67.7555561500603
"2000","throwin",42.8728799618174,35,28,7,9.41799905243618,25.5820009475638
"1970","good times",42.859035904142,111,43,68,15.1901159945839,95.8098840054161
"1990","constantly",42.8534837495442,36,26,10,7.63720905346314,28.3627909465369
"1990","well good time",42.8236269220984,22,19,3,4.6671833104497,17.3328166895503
"2000","hot im",42.7981005867329,23,21,2,6.18897080588663,16.8110291941134
"2010","ghost",42.7920886901341,63,32,31,9.69965161064275,53.3003483893573
"2010","verse",42.7496827344855,90,40,50,13.8566451580611,76.1433548419389
"2010","yellow",42.7449596784342,158,58,100,24.3261103885961,133.673889611404
"1960","red roses",42.6848485495876,13,10,3,0.776402554107361,12.2235974458926
"1980","passion",42.6313417496811,132,54,78,22.2071160489523,109.792883951048
"2010","summertime",42.6035483657153,73,35,38,11.2392788504273,61.7607211495727
"2000","got friends",42.5519782314675,28,24,4,7.53439924194894,20.4656007580511
"2000","im ready go",42.5519782314675,28,24,4,7.53439924194894,20.4656007580511
"1970","long long time",42.4688058682514,31,20,11,4.24228464713604,26.757715352864
"2000","bought",42.4164581891557,132,71,61,35.519310712045,96.480689287955
"2000","gotta",42.4070910475337,1926,648,1278,518.259033571202,1407.7409664288
"1960","dont know much",42.3984227552107,32,15,17,1.91114474857197,30.088855251428
"1980","dance lets dance",42.3872654616179,25,19,6,4.20589319108945,20.7941068089106
"2010","like gonna",42.3718266509705,24,18,6,3.69510537548295,20.3048946245171
"1960","babe",42.3158930277932,675,86,589,40.3132095401899,634.68679045981
"1970","well",42.3069338775935,2420,446,1974,331.171898260297,2088.8281017397
"1990","aint worth",42.3000569827847,24,20,4,5.09147270230876,18.9085272976912
"1990","got goin",42.3000569827847,24,20,4,5.09147270230876,18.9085272976912
"1990","things come",42.3000569827847,24,20,4,5.09147270230876,18.9085272976912
"1990","remember way",42.2489660681095,32,24,8,6.78863026974501,25.211369730255
"1960","please please",42.2009887033877,42,17,25,2.50837748250071,39.4916225174993
"2010","made made",42.1896858313634,34,22,12,5.23473261526751,28.7652673847325
"1980","every little",42.1591029903248,91,42,49,15.3094512155656,75.6905487844344
"1970","new orleans",42.1255634973594,34,21,13,4.65282832266533,29.3471716773347
"2000","top",42.07710446321,421,175,246,113.285074316447,307.714925683553
"1970","didnt didnt",42.0632472864583,21,16,5,2.87380572870506,18.1261942712949
"1970","evenin",42.0632472864583,21,16,5,2.87380572870506,18.1261942712949
"1990","talk minute",42.0481516188115,26,21,5,5.51576209416782,20.4842379058322
"2000","like cause",42.008109085007,43,32,11,11.5706845501359,31.4293154498641
"2000","clothes",42.0074153857679,211,101,110,56.7770800018295,154.22291999817
"1990","real love",41.9878980388988,101,51,50,21.4266142888827,79.5733857111173
"1960","jean",41.9623432270861,59,20,39,3.52367313017956,55.4763268698204
"2010","body rock",41.927418972625,29,20,9,4.46491899537523,24.5350810046248
"1980","house middle",41.893340146357,17,15,2,2.86000736994083,14.1399926300592
"1970","day die",41.8579264927396,26,18,8,3.55804518792055,22.4419548120795
"1970","keep dancing",41.8579264927396,26,18,8,3.55804518792055,22.4419548120795
"2010","ooh ooh",41.7974625966117,426,118,308,65.5881204148224,360.411879585178
"1970","birds",41.7828832071017,85,36,49,11.6320708066633,73.3679291933367
"2000","everybody know",41.7371884347441,30,25,5,8.07257061637387,21.9274293836261
"1970","hurry",41.7232793013055,142,50,92,19.4324006417199,122.56759935828
"2010","say hi",41.7052052335373,22,17,5,3.38717992752604,18.612820072474
"1980","still standing",41.6245466799511,21,17,4,3.53295028051514,17.4670497194849
"1980","true well",41.6245466799511,21,17,4,3.53295028051514,17.4670497194849
"1980","aint missing",41.5675214185703,19,16,3,3.19647882522798,15.803521174772
"1980","lies tell",41.5675214185703,19,16,3,3.19647882522798,15.803521174772
"1980","fooling",41.5241975407754,30,21,9,5.04707182930734,24.9529281706927
"2000","lock",41.5206786842957,118,65,53,31.7521110910705,86.2478889089295
"1970","loves",41.4528218901977,514,125,389,70.3398164073523,443.660183592648
"2010","uptown",41.3031397659985,71,34,37,10.9313534024704,60.0686465975296
"1960","love need love",41.3024175373208,43,17,26,2.56810075589358,40.4318992441064
"2000","hos",41.2944227603187,25,22,3,6.72714218031156,18.2728578196884
"2000","man",41.2733927416922,2466,808,1658,663.565304665932,1802.43469533407
"2010","safe sound",41.194870183901,20,16,4,3.07925447956913,16.9207455204309
"2010","shake girl",41.194870183901,20,16,4,3.07925447956913,16.9207455204309
"2010","wanna make feel",41.194870183901,20,16,4,3.07925447956913,16.9207455204309
"1970","town",41.1640767190005,467,116,351,63.9079654907267,403.092034509273
"1970","donna",41.1581513379755,29,19,10,3.96858886344984,25.0314111365502
"2000","damn right",41.1382657064976,32,26,6,8.61074199079879,23.3892580092012
"2000","yo ass",41.1382657064976,32,26,6,8.61074199079879,23.3892580092012
"1980","chance",41.1019049983694,510,144,366,85.8002210982247,424.199778901775
"1990","thinkin",41.0577778318104,362,130,232,76.7963799264904,285.20362007351
"2010","body want",41.0013754979777,16,14,2,2.4634035836553,13.5365964163447
"2010","city never",41.0013754979777,16,14,2,2.4634035836553,13.5365964163447
"2010","eenie meenie",41.0013754979777,16,14,2,2.4634035836553,13.5365964163447
"2010","hard play",41.0013754979777,16,14,2,2.4634035836553,13.5365964163447
"2010","lalalalala",41.0013754979777,16,14,2,2.4634035836553,13.5365964163447
"2010","now started",41.0013754979777,16,14,2,2.4634035836553,13.5365964163447
"1970","family",40.9806411001668,152,52,100,20.8008795601509,131.199120439849
"2010","party",40.9796779716936,694,172,522,106.850130441049,587.149869558951
"2010","cause",40.9658258961357,4691,885,3806,722.239138182939,3968.76086181706
"2010","done dont",40.9593256549748,27,19,8,4.15699354741832,22.8430064525817
"2010","fuck im",40.9142903726191,18,15,3,2.77132903161221,15.2286709683878
"2010","get try",40.9142903726191,18,15,3,2.77132903161221,15.2286709683878
"2000","sick",40.907772634323,149,77,72,40.0937673946569,108.906232605343
"1990","east west",40.8834726442069,19,17,2,4.0307492226611,14.9692507773389
"1990","know takes",40.8834726442069,19,17,2,4.0307492226611,14.9692507773389
"1990","turned away",40.8834726442069,19,17,2,4.0307492226611,14.9692507773389
"1990","vogue",40.8834726442069,19,17,2,4.0307492226611,14.9692507773389
"1980","cant go",40.8516275126451,231,79,152,38.8624530856665,192.137546914333
"1990","way work",40.8377975849174,37,26,11,7.84935374939267,29.1506462506073
"1980","private",40.7774880994863,73,36,37,12.2812081179812,60.7187918820188
"1990","youll always",40.7673667933386,69,39,30,14.6379840191377,54.3620159808623
"1980","wind",40.7432337656138,348,107,241,58.5460332199651,289.453966780035
"1970","starry",40.72779831091,17,14,3,2.32641416133266,14.6735858386673
"1970","ta get",40.72779831091,17,14,3,2.32641416133266,14.6735858386673
"1980","ooo",40.6975873423424,180,66,114,30.282430975844,149.717569024156
"1960","need lovin",40.6612655192448,17,11,6,1.01529564767886,15.9847043523211
"1990","takes",40.6463900863583,363,130,233,77.00852462242,285.99147537758
"1960","ticket",40.6145033361244,55,19,36,3.28478003660807,51.7152199633919
"1960","hold darling",40.5398622594071,11,9,2,0.656956007321613,10.3430439926784
"1960","nowhere hide",40.5398622594071,11,9,2,0.656956007321613,10.3430439926784
"1960","te da",40.5398622594071,11,9,2,0.656956007321613,10.3430439926784
"1970","feels like first time",40.5194398371375,15,13,2,2.05271837764647,12.9472816223535
"1970","loan",40.5194398371375,15,13,2,2.05271837764647,12.9472816223535
"1970","em now",40.4923690000229,38,22,16,5.20021989003772,32.7997801099623
"1990","duh",40.479789771599,173,74,99,36.701032395809,136.298967604191
"2000","chick",40.475186588425,189,92,97,50.8571948831554,138.142805116845
"1990","cry im",40.4142808621043,35,25,10,7.42506435753361,27.5749356424664
"1990","romantic",40.4142808621043,35,25,10,7.42506435753361,27.5749356424664
"1990","promise",40.4122223188538,385,136,249,81.6757079328697,303.32429206713
"2000","fix",40.3861666746191,102,58,44,27.4467400956712,74.5532599043289
"1970","find",40.3822181540864,1686,325,1361,230.725545647463,1455.27445435254
"2000","delicious",40.3588643089236,22,20,2,5.91988511867417,16.0801148813258
"2000","show boy",40.3588643089236,22,20,2,5.91988511867417,16.0801148813258
"2000","watch turn",40.3588643089236,22,20,2,5.91988511867417,16.0801148813258
"2000","world change",40.3588643089236,22,20,2,5.91988511867417,16.0801148813258
"1990","bounce",40.3581202478378,170,73,97,36.0645983080204,133.93540169198
"2000","us us",40.2409392925245,27,23,4,7.26531355473648,19.7346864452635
"1960","indian",40.2187565990465,34,15,19,2.03059129535771,31.9694087046423
"1970","shake shake",40.1865906989822,402,103,299,55.0128525209254,346.987147479075
"2000","dont know like",40.1769890032006,38,29,9,10.2252561140736,27.7747438859264
"1960","hello",40.1509269484088,156,33,123,9.31683064928833,146.683169350712
"1960","little bit",40.1445220820555,419,61,358,25.0240515516142,393.975948448386
"1970","little",40.1298497053785,2553,464,2089,349.372667875429,2203.62733212457
"1960","fire light",40.1294678966721,25,13,12,1.49308183482185,23.5069181651781
"1960","ive lonely",40.1017698853802,14,10,4,0.836125827500235,13.1638741724998
"1960","aquarius",40.059122520593,21,12,9,1.25418874125035,19.7458112587496
"1960","bees",40.059122520593,21,12,9,1.25418874125035,19.7458112587496
"2010","gonna shake",40.0506314380104,25,18,7,3.84906809946141,21.1509319005386
"2000","drop like hot",40.0458939527379,40,30,10,10.7634274884985,29.2365725115015
"2000","goes around comes",40.0458939527379,40,30,10,10.7634274884985,29.2365725115015
"1970","sweet love",40.044688046869,103,40,63,14.0953328598391,88.9046671401609
"1990","give give give give",40.0424241762015,33,24,9,7.00077496567454,25.9992250343255
"1980","avenue",40.0200775935489,26,19,7,4.37412891873303,21.625871081267
"1980","hot hot",40.0055398154108,77,37,40,12.9541510285555,64.0458489714445
"1980","love shack",40.0055398154108,77,37,40,12.9541510285555,64.0458489714445
"2000","drop like",39.9817291771868,42,31,11,11.3015988629234,30.6984011370766
"2000","hit floor",39.9817291771868,42,31,11,11.3015988629234,30.6984011370766
"1970","find somebody",39.8713410608466,58,28,30,7.93717772689968,50.0628222731003
"2010","wish never",39.8575996678212,41,24,17,6.31247168311671,34.6875283168833
"1990","baby baby baby",39.8504393656953,267,102,165,56.6426338131849,210.357366186815
"2010","amazing",39.834400364991,53,28,25,8.16002437085818,44.8399756291418
"2000","ridin",39.8274281036057,198,95,103,53.2789660680675,144.721033931932
"1970","doo doo doo doo",39.7550505762333,48,25,23,6.5686988084687,41.4313011915313
"1970","til get",39.7550505762333,48,25,23,6.5686988084687,41.4313011915313
"1990","give love give",39.7340338269386,31,23,8,6.57648557381548,24.4235144261845
"1990","wants know",39.7340338269386,31,23,8,6.57648557381548,24.4235144261845
"1970","love love baby love",39.6283849261185,22,16,6,3.01065362054815,18.9893463794518
"1960","day",39.6270488960713,2215,208,2007,132.287050565216,2082.71294943478
"1990","let rhythm",39.5723237545965,23,19,4,4.87932800637923,18.1206719936208
"1980","night long night",39.5589056398549,31,21,10,5.21530755695092,25.7846924430491
"1980","small town",39.5589056398549,31,21,10,5.21530755695092,25.7846924430491
"1980","gonna run",39.5078690232248,47,27,20,7.90707919924816,39.0929208007518
"1970","said",39.5062668975205,2163,401,1762,296.001990056621,1866.99800994338
"2000","fellas",39.5058172329183,98,56,42,26.3703973468213,71.6296026531787
"1990","another love",39.5050387218877,29,22,7,6.15219618195642,22.8478038180436
"1990","hay",39.5050387218877,29,22,7,6.15219618195642,22.8478038180436
"1990","love baby dont",39.5050387218877,29,22,7,6.15219618195642,22.8478038180436
"2000","balls",39.4832149879892,29,24,5,7.80348492916141,21.1965150708386
"2000","dont really want",39.4832149879892,29,24,5,7.80348492916141,21.1965150708386
"2000","ya take",39.4832149879892,29,24,5,7.80348492916141,21.1965150708386
"1990","belongs",39.4823551192717,81,43,38,17.1837203702921,63.8162796297079
"1970","saturday night",39.4642967187283,45,24,21,6.15815513293941,38.8418448670606
"1970","dont throw",39.3857894157916,30,19,11,4.10543675529294,25.8945632447071
"1980","baby youve got",39.384396639613,24,18,6,4.03765746344587,19.9623425365541
"1980","let end",39.384396639613,24,18,6,4.03765746344587,19.9623425365541
"1990","gonna whatcha",39.3837554919806,25,20,5,5.30361739823829,19.6963826017617
"1990","give love give love",39.3775969986131,27,21,6,5.72790679009735,21.2720932099026
"1980","youve got",39.3554098043061,391,116,275,65.780169508639,325.219830491361
"1960","bit",39.3482681270867,540,72,468,32.2505676321519,507.749432367848
"1970","ooh ooh ooh ooh",39.3376737284276,129,46,83,17.6533780477596,111.34662195224
"1980","see light",39.3153099771978,91,41,50,15.3094512155656,75.6905487844344
"2010","rolling",39.2797663855659,148,54,94,22.7864831488115,125.213516851188
"1990","tell want",39.2488085080379,73,40,33,15.4865628028558,57.5134371971442
"1980","time will",39.2395543301542,62,32,30,10.4306151139018,51.5693848860982
"2010","perfect",39.2391037653398,219,71,148,33.7178365512819,185.282163448718
"2010","can meet",39.2194574726688,23,17,6,3.5411426515045,19.4588573484955
"2000","grown",39.2003890379031,128,68,60,34.4429679631952,93.5570320368048
"1990","give",39.1918541128713,3148,815,2333,667.831502786166,2480.16849721383
"1970","american",39.1914193971669,125,45,80,17.1059864803872,107.894013519613
"1970","land",39.1609060277657,151,51,100,20.6640316683078,130.335968331692
"1970","little baby",39.0461957347781,36,21,15,4.92652410635153,31.0734758936485
"1970","orleans",39.0461957347781,36,21,15,4.92652410635153,31.0734758936485
"1970","young man",39.0461957347781,36,21,15,4.92652410635153,31.0734758936485
"1970","one love",38.9405979229517,117,43,74,16.0112033456425,100.988796654358
"2000","keep baby",38.9354772533339,31,25,6,8.34165630358633,22.6583436964137
"2000","move like",38.9354772533339,31,25,6,8.34165630358633,22.6583436964137
"2000","feelings start",38.9302537630851,24,21,3,6.45805649309909,17.5419435069009
"1960","uptight",38.8019265030014,18,11,7,1.07501892107173,16.9249810789283
"1960","windy",38.8019265030014,18,11,7,1.07501892107173,16.9249810789283
"2000","thick",38.7809536584728,106,59,47,28.523082844521,77.476917155479
"1980","got let",38.6971830462996,34,22,12,5.72001473988165,28.2799852601184
"1980","lets hear",38.6971830462996,34,22,12,5.72001473988165,28.2799852601184
"1980","youre lonely",38.6874525744143,29,20,9,4.87883610166376,24.1211638983362
"2000","thanks",38.665511509637,53,36,17,14.2615414222605,38.7384585777395
"1970","feels like first",38.6447951531011,20,15,5,2.73695783686196,17.263042163138
"1970","line love",38.6447951531011,20,15,5,2.73695783686196,17.263042163138
"1970","ribbon",38.6447951531011,20,15,5,2.73695783686196,17.263042163138
"1970","sheriff",38.6447951531011,20,15,5,2.73695783686196,17.263042163138
"2000","dough",38.6322822232985,94,54,40,25.2940545979715,68.7059454020285
"2010","dance like",38.6159629956408,39,23,16,6.0045462351598,32.9954537648402
"1980","know theres something",38.5870756441055,16,14,2,2.69177164229725,13.3082283577028
"1980","mind set",38.5870756441055,16,14,2,2.69177164229725,13.3082283577028
"1980","o d",38.5870756441055,16,14,2,2.69177164229725,13.3082283577028
"1980","sunglasses",38.5870756441055,16,14,2,2.69177164229725,13.3082283577028
"2010","aint even",38.5661568240362,88,38,50,13.5487197101042,74.4512802898958
"1960","dont mess",38.553269941136,52,18,34,3.10561021642945,48.8943897835706
"1980","love got",38.5344639537297,142,55,87,23.8894733253881,118.110526674612
"2000","trippin",38.4949917019098,73,45,28,19.6432551665097,53.3567448334902
"1980","back wall",38.4940052512861,20,16,4,3.36471455287156,16.6352854471284
"1980","one bites",38.4940052512861,20,16,4,3.36471455287156,16.6352854471284
"2010","come turn",38.4926266947695,21,16,5,3.23321720354758,17.7667827964524
"1990","love someone",38.4625400883921,71,39,32,15.0622734109967,55.9377265890033
"1990","love goes",38.4541573997292,36,25,11,7.63720905346314,28.3627909465369
"2010","know want know",38.4423600810643,48,26,22,7.3902107509659,40.6097892490341
"2000","catch",38.4076185801623,347,147,200,93.3727334627244,253.627266537276
"1990","roam",38.3622292738583,43,28,15,9.12222192496986,33.8777780750301
"1980","love lost",38.3567079793756,18,15,3,3.0282430975844,14.9717569024156
"1980","surfin",38.3567079793756,18,15,3,3.0282430975844,14.9717569024156
"1960","mind",38.2986724073927,1930,185,1745,115.265917648247,1814.73408235175
"1980","stroke",38.2755386099433,124,50,74,20.8612302278037,103.138769772196
"1970","play funky",38.2591665810891,46,24,22,6.29500302478251,39.7049969752175
"1970","come come come",38.2007488742468,144,49,95,19.7060964254061,124.293903574594
"1980","step step",38.1730187383625,63,32,31,10.5988508415454,52.4011491584546
"1980","n roll",38.1695305169773,79,37,42,13.2906224838427,65.7093775161573
"1980","rock n",38.1695305169773,79,37,42,13.2906224838427,65.7093775161573
"1980","rock n roll",38.1695305169773,79,37,42,13.2906224838427,65.7093775161573
"2000","camera",38.165960071368,47,33,14,12.6470272989857,34.3529727010143
"2000","fuck dont",38.165960071368,47,33,14,12.6470272989857,34.3529727010143
"2000","snap",38.1617913456601,62,40,22,16.6833126071727,45.3166873928273
"2000","yea yea",38.1299605585046,71,44,27,19.1050837920848,51.8949162079152
"2000","know act",38.1004552167692,37,28,9,9.9561704268611,27.0438295731389
"2000","yellin",38.1004552167692,37,28,9,9.9561704268611,27.0438295731389
"2000","say im",38.0723067907064,242,110,132,65.1187363054159,176.881263694584
"2000","runaway",38.0605184288482,45,32,13,12.1088559245608,32.8911440754392
"1970","baby love love",38.0447884863421,28,18,10,3.83174097160674,24.1682590283933
"1990","days young",38.0113825637176,18,16,2,3.81860452673157,14.1813954732684
"1990","just sittin",38.0113825637176,18,16,2,3.81860452673157,14.1813954732684
"1990","pain cause",38.0113825637176,18,16,2,3.81860452673157,14.1813954732684
"1990","tuesday wednesday",38.0113825637176,18,16,2,3.81860452673157,14.1813954732684
"2010","make wanna",38.0039617578957,96,40,56,14.7804215019318,81.2195784980682
"1990","youll never find",37.9979486874418,34,24,10,7.21291966160408,26.7870803383959
"2000","low get",37.9937488472352,43,31,12,11.5706845501359,31.4293154498641
"2000","air air",37.9427932741061,26,22,4,6.99622786752402,19.003772132476
"2000","baby hey baby",37.9427932741061,26,22,4,6.99622786752402,19.003772132476
"2000","mine need",37.9427932741061,26,22,4,6.99622786752402,19.003772132476
"2000","says cant",37.9427932741061,26,22,4,6.99622786752402,19.003772132476
"2000","try dont",37.9427932741061,26,22,4,6.99622786752402,19.003772132476
"2010","applause",37.9361090021171,26,18,8,4.00303082343986,21.9969691765601
"2010","following",37.9361090021171,26,18,8,4.00303082343986,21.9969691765601
"2010","magic magic magic",37.9361090021171,26,18,8,4.00303082343986,21.9969691765601
"2010","teenage",37.9361090021171,26,18,8,4.00303082343986,21.9969691765601
"2000","head right",37.9287293179107,21,19,2,5.65079943146171,15.3492005685383
"2010","back lets",37.9120573232176,19,15,4,2.92529175559067,16.0747082444093
"1960","nowhere",37.8937925249069,224,40,184,13.3780132400038,210.621986759996
"1960","byebye",37.8810554309925,15,10,5,0.895849100893109,14.1041508991069
"1960","dance music",37.8810554309925,15,10,5,0.895849100893109,14.1041508991069
"1960","days week",37.8810554309925,15,10,5,0.895849100893109,14.1041508991069
"1960","get back",37.8769672798852,215,39,176,12.8405037794679,202.159496220532
"2000","know get",37.8642652191107,60,39,21,16.1451412327477,43.8548587672523
"2000","wanna know",37.792172361618,212,99,113,57.046165689042,154.953834310958
"2000","throw hands",37.7717879305683,69,43,26,18.5669124176599,50.4330875823401
"1980","photograph",37.729421090035,32,21,11,5.38354328459449,26.6164567154055
"1980","romance",37.7176501469963,114,47,67,19.1788729513679,94.8211270486321
"1960","baby baby cant",37.5980457898976,12,9,3,0.716679280714487,11.2833207192855
"1990","na na na nana",37.5900021115323,32,23,9,6.78863026974501,25.211369730255
"2010","dont believe just",37.5356971254456,15,13,2,2.30944085967684,12.6905591403232
"2010","everybody go",37.5356971254456,15,13,2,2.30944085967684,12.6905591403232
"2010","getting back",37.5356971254456,15,13,2,2.30944085967684,12.6905591403232
"2010","party dont",37.5356971254456,15,13,2,2.30944085967684,12.6905591403232
"1980","found",37.499298905395,723,187,536,121.634431086307,601.365568913693
"1980","crime",37.4818537795657,70,34,36,11.7765009350505,58.2234990649496
"1990","gonna get",37.4787693989165,272,102,170,57.7033572928326,214.296642707167
"1990","ill give",37.3877225612181,178,74,104,37.7617558754566,140.238244124543
"2010","wanna feel",37.3856451475583,52,27,25,8.00606164687973,43.9939383531203
"2010","going home",37.3811735608765,37,22,15,5.69662078720288,31.3033792127971
"2000","know gonna",37.3103414627192,56,37,19,15.0687984838979,40.9312015161021
"1980","love yeah yeah",37.2848450671004,43,25,18,7.23413628867385,35.7658637113261
"1990","ray",37.2675110225452,64,36,28,13.57726053949,50.42273946051
"1960","love till",37.2617466608427,32,14,18,1.91114474857197,30.088855251428
"1990","puffin",37.2415582019995,30,22,8,6.36434087788595,23.6356591221141
"1990","chin",37.2388295806636,20,17,3,4.24289391859063,15.7571060814094
"1990","every day week",37.2388295806636,20,17,3,4.24289391859063,15.7571060814094
"1990","gettin kinda",37.2388295806636,20,17,3,4.24289391859063,15.7571060814094
"2000","get head",37.2270599753058,74,45,29,19.9123408537222,54.0876591462778
"1970","blue",37.2214512191085,471,114,357,64.4553570580991,406.544642941901
"2010","coming home",37.1963080354575,79,35,44,12.163055194298,66.8369448057019
"1990","unh",37.1766653359587,39,26,13,8.27364314125173,30.7263568587483
"1970","groove im",37.1515204649464,16,13,3,2.18956626948957,13.8104337305104
"1970","shake baby",37.1515204649464,16,13,3,2.18956626948957,13.8104337305104
"1970","ymca",37.1515204649464,16,13,3,2.18956626948957,13.8104337305104
"1970","youre good youre",37.1515204649464,16,13,3,2.18956626948957,13.8104337305104
"2010","go go go",37.1191368460555,120,46,74,18.4755268774148,101.524473122585
"1980","secret",37.1005430242789,179,64,115,30.1141952482004,148.8858047518
"1970","fall love",37.0998461607157,254,72,182,34.7593645281469,219.240635471853
"1980","know tonight",37.0677860352061,46,26,20,7.73884347160458,38.2611565283954
"2000","glamorous",37.0572249941147,54,36,18,14.530627109473,39.469372890527
"2010","kingdom",36.9816197224568,24,17,7,3.69510537548295,20.3048946245171
"1990","call big",36.8629183971948,22,18,4,4.6671833104497,17.3328166895503
"1990","day week",36.8629183971948,22,18,4,4.6671833104497,17.3328166895503
"1970","bring boys",36.838646444914,14,12,2,1.91587048580337,12.0841295141966
"1970","freight",36.838646444914,14,12,2,1.91587048580337,12.0841295141966
"1970","get feelin",36.838646444914,14,12,2,1.91587048580337,12.0841295141966
"1970","give just little time",36.838646444914,14,12,2,1.91587048580337,12.0841295141966
"2010","pocket",36.8309545405752,83,36,47,12.7789060902119,70.2210939097881
"2000","cop",36.8226575285523,52,35,17,13.992455735048,38.007544264952
"1990","good better",36.7901429251918,26,20,6,5.51576209416782,20.4842379058322
"1990","two steps",36.7393797265405,24,19,5,5.09147270230876,18.9085272976912
"1970","delight",36.7293328312356,26,17,9,3.55804518792055,22.4419548120795
"1970","love find",36.7293328312356,26,17,9,3.55804518792055,22.4419548120795
"1970","walk way",36.7293328312356,26,17,9,3.55804518792055,22.4419548120795
"1960","woman",36.7105880971428,796,93,703,47.5397256207277,748.460274379272
"1990","comin",36.6957451121349,355,125,230,75.3113670549837,279.688632945016
"1970","away love",36.5782257405084,84,34,50,11.4952229148202,72.5047770851798
"2000","dead gone",36.5780014242614,23,20,3,6.18897080588663,16.8110291941134
"2000","head think",36.5780014242614,23,20,3,6.18897080588663,16.8110291941134
"2000","start show",36.5780014242614,23,20,3,6.18897080588663,16.8110291941134
"1960","men",36.5675043554655,184,35,149,10.9890823042888,173.010917695711
"1980","startin",36.5337785175742,38,23,15,6.39295765045596,31.607042349544
"1970","got get",36.5257996574539,92,36,56,12.590006049565,79.409993950435
"1990","im wrong",36.4947657979968,62,35,27,13.152971147631,48.847028852369
"1970","pearl",36.4848358560666,41,22,19,5.61076356556702,35.389236434433
"2010","make em",36.4553501479872,66,31,35,10.1615397825781,55.8384602174219
"1970","come",36.4227136572662,4867,815,4052,666.038689600358,4200.96131039964
"1980","im gonna run",36.4093386925721,23,17,6,3.86942173580229,19.1305782641977
"1980","thats just way",36.4093386925721,23,17,6,3.86942173580229,19.1305782641977
"2000","got im",36.4041326988121,32,25,7,8.61074199079879,23.3892580092012
"1970","bring em",36.3797773450097,117,42,75,16.0112033456425,100.988796654358
"2010","deep love",36.3701271896585,80,35,45,12.3170179182765,67.6829820817235
"1960","la la la la",36.3316593352335,1002,110,892,59.8427199396597,942.15728006034
"1990","saw",36.3296797017509,425,144,281,90.1614957700509,334.838504229949
"1970","dont stop now",36.3052069139193,21,15,6,2.87380572870506,18.1261942712949
"1970","love isnt",36.3052069139193,21,15,6,2.87380572870506,18.1261942712949
"2010","baby tonight",36.2756614949196,53,27,26,8.16002437085818,44.8399756291418
"2000","mouth",36.2192751798724,179,86,93,48.1663380110307,130.833661988969
"1990","make love",36.2098260736337,254,96,158,53.884752766101,200.115247233899
"2000","na na na na",36.2013871196359,831,303,528,223.610206073556,607.389793926444
"2000","lifei",36.1766350290097,34,26,8,9.14891336522372,24.8510866347763
"2000","say girl",36.1766350290097,34,26,8,9.14891336522372,24.8510866347763
"2000","stacks",36.1766350290097,34,26,8,9.14891336522372,24.8510866347763
"1970","son",36.155716651518,208,62,146,28.4643615033644,179.535638496636
"1990","thats way love",36.1319560638103,42,27,15,8.91007722904033,33.0899227709597
"2000","around comes",36.1261128017064,44,31,13,11.8397702373483,32.1602297626517
"2000","give damn",36.1094832254207,59,38,21,15.8760555455353,43.1239444544647
"2010","roar",36.0978193554939,22,16,6,3.38717992752604,18.612820072474
"2000","want man",36.0318962621688,42,30,12,11.3015988629234,30.6984011370766
"1980","cruisin",36.019495815378,33,21,12,5.55177901223807,27.4482209877619
"1990","wanna",36.0120341919358,4767,1184,3583,1011.29376549608,3755.70623450392
"1970","youre gonna miss",35.9882513131571,48,24,24,6.5686988084687,41.4313011915313
"2000","just fine",35.9806706038911,40,29,11,10.7634274884985,29.2365725115015
"2000","hit hard",35.9804101716093,38,28,10,10.2252561140736,27.7747438859264
"2000","im tell",35.9804101716093,38,28,10,10.2252561140736,27.7747438859264
"1960","need baby",35.9684711453976,62,19,43,3.70284295035818,58.2971570496418
"2010","gonna fall",35.9482677536613,38,22,16,5.85058351118134,32.1494164888187
"1970","answer",35.9461057919974,171,54,117,23.4009895051697,147.59901049483
"1960","groovy",35.9432149458062,44,16,28,2.62782402928645,41.3721759707135
"1960","babe got",35.929618972851,16,10,6,0.955572374285983,15.044427625714
"1960","balloon",35.929618972851,16,10,6,0.955572374285983,15.044427625714
"1960","bonnie",35.929618972851,16,10,6,0.955572374285983,15.044427625714
"1980","will",35.9047107153896,3611,746,2865,607.49921252096,3003.50078747904
"1980","celebration",35.8817701253327,28,19,9,4.71060037402018,23.2893996259798
"1980","left hand",35.8817701253327,28,19,9,4.71060037402018,23.2893996259798
"2010","want know want",35.8650097501482,44,24,20,6.77435985505208,37.2256401449479
"2010","night yeah",35.8601735320105,41,23,18,6.31247168311671,34.6875283168833
"2010","dont care",35.8300451818539,355,99,256,54.656767012352,300.343232987648
"1980","aint much",35.8257904540442,21,16,5,3.53295028051514,17.4670497194849
"1980","mow",35.8257904540442,21,16,5,3.53295028051514,17.4670497194849
"1980","one million",35.8257904540442,21,16,5,3.53295028051514,17.4670497194849
"2000","just friend",35.809414116296,57,37,20,15.3378841711103,41.6621158288897
"2000","sir",35.809414116296,57,37,20,15.3378841711103,41.6621158288897
"1960","jimmy",35.799908232852,56,18,38,3.34450331000094,52.6554966899991
"2010","met",35.796778934078,313,90,223,48.1903326052568,264.809667394743
"1990","nobody can",35.7814322636148,68,37,31,14.4258393232082,53.5741606767919
"1980","promises",35.7791815698064,92,40,52,15.4776869432092,76.5223130567908
"1980","sings",35.7646648551931,56,29,27,9.42120074804036,46.5787992519596
"1970","smilin",35.7221639155916,66,29,37,9.03196086164446,56.9680391383555
"1980","will know",35.7204031869257,53,28,25,8.91649356510963,44.0835064348904
"1990","homies",35.6887977036668,82,42,40,17.3958650662216,64.6041349337784
"1990","true",35.6657755667468,1022,298,724,216.811879239981,805.188120760019
"2000","ever forever",35.6586456238709,25,21,4,6.72714218031156,18.2728578196884
"2000","tell one time",35.6586456238709,25,21,4,6.72714218031156,18.2728578196884
"2000","homie",35.6435976239866,80,47,33,21.526854976997,58.473145023003
"1970","funky",35.6388815266699,195,59,136,26.6853389094041,168.314661090596
"1960","wait",35.6057501369968,758,89,669,45.2702412317984,712.729758768202
"2000","cant help",35.5975173476613,199,93,106,53.54805175528,145.45194824472
"1960","never gonna give",35.5796433785203,20,11,9,1.19446546785748,18.8055345321425
"1980","dont want",35.5390756608387,818,205,613,137.616825212447,680.383174787553
"1980","together",35.5379578486263,954,233,721,160.496884171973,793.503115828027
"2000","buttons",35.5086320155119,20,18,2,5.38171374424925,14.6182862557508
"2000","cris",35.5086320155119,20,18,2,5.38171374424925,14.6182862557508
"2000","talkin bout got",35.5086320155119,20,18,2,5.38171374424925,14.6182862557508
"2000","thus",35.5086320155119,20,18,2,5.38171374424925,14.6182862557508
"2000","thus far",35.5086320155119,20,18,2,5.38171374424925,14.6182862557508
"1990","represent",35.5059210007061,40,26,14,8.48578783718126,31.5142121628187
"1980","read mind",35.4690056048744,36,22,14,6.05648619516881,29.9435138048312
"1970","oak",35.446277446617,24,16,8,3.28434940423435,20.7156505957656
"1970","shine light",35.446277446617,24,16,8,3.28434940423435,20.7156505957656
"1970","time left",35.446277446617,24,16,8,3.28434940423435,20.7156505957656
"1970","will surely",35.446277446617,24,16,8,3.28434940423435,20.7156505957656
"1980","rainy",35.4298087100012,89,39,50,14.9729797602784,74.0270202397216
"1990","really wanna",35.3977626399491,188,76,112,39.8832028347519,148.116797165248
"1980","eyes theyre",35.3885036218635,19,15,4,3.19647882522798,15.803521174772
"1980","mind always",35.3885036218635,19,15,4,3.19647882522798,15.803521174772
"1980","oh said",35.3885036218635,19,15,4,3.19647882522798,15.803521174772
"1980","holds",35.3766951302921,69,33,36,11.6082652074069,57.3917347925931
"1990","respect",35.345073337352,124,56,68,26.3059422952619,97.6940577047381
"2010","dont ever",35.333883633552,147,52,95,22.6325204248331,124.367479575167
"1960","game now",35.3268116849668,10,8,2,0.597232733928739,9.40276726607126
"1960","little love heart",35.3268116849668,10,8,2,0.597232733928739,9.40276726607126
"1960","nowhere man",35.3268116849668,10,8,2,0.597232733928739,9.40276726607126
"1960","oh little bit",35.3268116849668,10,8,2,0.597232733928739,9.40276726607126
"1960","pea",35.3268116849668,10,8,2,0.597232733928739,9.40276726607126
"1960","put little love heart",35.3268116849668,10,8,2,0.597232733928739,9.40276726607126
"1960","rain rain rain",35.3268116849668,10,8,2,0.597232733928739,9.40276726607126
"1960","take last",35.3268116849668,10,8,2,0.597232733928739,9.40276726607126
"1980","centerfold",35.2987085028341,15,13,2,2.52353591465367,12.4764640853463
"1980","close eyes dream",35.2987085028341,15,13,2,2.52353591465367,12.4764640853463
"1960","hello hello",35.2985606521629,34,14,20,2.03059129535771,31.9694087046423
"1960","mine im",35.2985606521629,34,14,20,2.03059129535771,31.9694087046423
"1960","little girl",35.2741960554031,98,24,74,5.85288079250165,92.1471192074984
"1990","can fly",35.2656690589422,50,30,20,10.6072347964766,39.3927652035234
"1990","make happen",35.2656690589422,50,30,20,10.6072347964766,39.3927652035234
"1970","show em",35.2597335861222,19,14,5,2.60010994501886,16.3998900549811
"2000","everybody get",35.2521091013904,53,35,18,14.2615414222605,38.7384585777395
"1990","lives",35.2272312568253,185,75,110,39.2467687469634,145.753231253037
"1970","get together",35.2124700288931,98,37,61,13.4110934006236,84.5889065993764
"1970","welcome",35.2124700288931,98,37,61,13.4110934006236,84.5889065993764
"1990","jump jump",35.1994711816054,115,53,62,24.3966400318961,90.6033599681039
"1960","get next",35.175146334758,45,16,29,2.68754730267933,42.3124526973207
"1960","hear heartbeat",35.1689653618296,13,9,4,0.776402554107361,12.2235974458926
"1960","persuasion",35.1689653618296,13,9,4,0.776402554107361,12.2235974458926
"1960","shes giving",35.1689653618296,13,9,4,0.776402554107361,12.2235974458926
"1980","somebodys baby",35.1681584772363,17,14,3,2.86000736994083,14.1399926300592
"1980","emotion",35.1641145408282,66,32,34,11.1035580244761,54.8964419755239
"1990","days go",35.1620538093469,31,22,9,6.57648557381548,24.4235144261845
"2000","call",35.1580659582915,1553,524,1029,417.890072240954,1135.10992775905
"1990","indo",35.1532056531476,17,15,2,3.60645983080204,13.393540169198
"2010","yeah",35.1359581950567,6260,1137,5123,963.806652105136,5296.19334789486
"2010","oooh",35.098553615399,78,34,44,12.0090924703196,65.9909075296804
"2000","cuz",35.0739495263752,293,126,167,78.8421063532514,214.157893646749
"1980","really love",35.0302076737191,100,42,58,16.8235727643578,83.1764272356422
"1980","dont want love",35.0167363745386,26,18,8,4.37412891873303,21.625871081267
"2000","say need",34.9984902722195,51,34,17,13.7233700478356,37.2766299521644
"1970","hoo hoo hoo",34.9711502085945,27,17,10,3.69489307976364,23.3051069202364
"1970","monster",34.9711502085945,27,17,10,3.69489307976364,23.3051069202364
"2010","make money",34.947118633562,25,17,8,3.84906809946141,21.1509319005386
"1980","look eyes",34.9297390489651,152,56,96,25.5718306018238,126.428169398176
"1970","love keep",34.9166952288285,49,24,25,6.7055467003118,42.2944532996882
"1970","love make",34.9166952288285,49,24,25,6.7055467003118,42.2944532996882
"1970","natural",34.9053673352508,56,26,30,7.66348194321348,48.3365180567865
"1970","shes gone",34.9053673352508,56,26,30,7.66348194321348,48.3365180567865
"2010","bottom",34.8597272225898,152,53,99,23.4023340447254,128.597665955275
"1980","dreams",34.8119484054258,640,167,473,107.67086569189,532.32913430811
"2010","lets make",34.7901988670061,93,38,55,14.3185333299964,78.6814666700036
"1960","never love",34.7788385787724,64,19,45,3.82228949714393,60.1777105028561
"1990","oh beautiful",34.7733439808174,29,21,8,6.15219618195642,22.8478038180436
"1990","quit playin",34.7733439808174,29,21,8,6.15219618195642,22.8478038180436
"2000","now aint",34.7645154808056,49,33,16,13.1851986734107,35.8148013265894
"1980","built",34.7591604921265,83,37,46,13.963565394417,69.036434605583
"1970","lonesome",34.7511132847486,30,18,12,4.10543675529294,25.8945632447071
"1980","burning",34.7413027739394,216,72,144,36.3389171710128,179.661082828987
"1990","go go go go",34.7045552947696,69,37,32,14.6379840191377,54.3620159808623
"2000","playa",34.7003977935695,60,38,22,16.1451412327477,43.8548587672523
"1960","wedding",34.6949986633328,40,15,25,2.38893093571496,37.611069064285
"2010","baby nothin",34.6573649275298,18,14,4,2.77132903161221,15.2286709683878
"2010","realest",34.6573649275298,18,14,4,2.77132903161221,15.2286709683878
"2010","liquor",34.6491086155613,45,24,21,6.92832257903053,38.0716774209695
"2010","heart beat",34.6390568583601,68,31,37,10.469465230535,57.530534769465
"2000","hotel",34.6058348571424,93,52,41,25.024968910759,67.975031089241
"2000","know like",34.485360068379,160,78,82,43.053709953994,116.946290046006
"1990","im kid",34.4720513099463,19,16,3,4.0307492226611,14.9692507773389
"1990","whatcha gonna",34.4616423317373,92,45,47,19.5173120255169,72.4826879744831
"1990","need man",34.4544822546355,27,20,7,5.72790679009735,21.2720932099026
"1970","doctor",34.441697886855,91,35,56,12.4531581577219,78.5468418422781
"1990","pain",34.4236081836646,524,169,355,111.163820667075,412.836179332925
"1980","automatic",34.4158153069549,34,21,13,5.72001473988165,28.2799852601184
"1960","bill",34.4099428346611,100,24,76,5.97232733928739,94.0276726607126
"1960","crowded",34.3805255780965,35,14,21,2.09031456875059,32.9096854312494
"1960","us can",34.3805255780965,35,14,21,2.09031456875059,32.9096854312494
"2000","wanna break",34.3670165329558,45,31,14,12.1088559245608,32.8911440754392
"1990","long long",34.3479213951305,104,49,55,22.0630483766713,81.9369516233287
"1970","crocodile",34.3381157323051,17,13,4,2.32641416133266,14.6735858386673
"1970","rain shine",34.3381157323051,17,13,4,2.32641416133266,14.6735858386673
"1970","shack thats",34.3381157323051,17,13,4,2.32641416133266,14.6735858386673
"1970","word word",34.3381157323051,17,13,4,2.32641416133266,14.6735858386673
"1990","juice",34.3169218485772,36,24,12,7.63720905346314,28.3627909465369
"1960","heart now",34.3087209136996,30,13,17,1.79169820178622,28.2083017982138
"1960","love keeps",34.3087209136996,30,13,17,1.79169820178622,28.2083017982138
"2000","dollar bill",34.2813655926468,31,24,7,8.34165630358633,22.6583436964137
"2000","west side",34.2813655926468,31,24,7,8.34165630358633,22.6583436964137
"1990","comfort",34.2536580295602,75,39,36,15.9108521947149,59.0891478052851
"1970","cant change",34.2531884631837,64,28,36,8.75826507795827,55.2417349220417
"2000","fantasize",34.2388068548414,22,19,3,5.91988511867417,16.0801148813258
"2000","find love like",34.2388068548414,22,19,3,5.91988511867417,16.0801148813258
"2000","lollipop",34.2388068548414,22,19,3,5.91988511867417,16.0801148813258
"1990","another night",34.2257885067501,25,19,6,5.30361739823829,19.6963826017617
"1990","talk shit",34.2257885067501,25,19,6,5.30361739823829,19.6963826017617
"1990","waiting come",34.2257885067501,25,19,6,5.30361739823829,19.6963826017617
"2000","cost",34.2107760379572,43,30,13,11.5706845501359,31.4293154498641
"2010","gonna reach",34.2078327743186,16,13,3,2.4634035836553,13.5365964163447
"1970","mama told",34.2052385032215,22,15,7,3.01065362054815,18.9893463794518
"2010","push push",34.2030810378479,28,18,10,4.31095627139678,23.6890437286032
"1990","faithful",34.1906015121332,56,32,24,11.8801029720538,44.1198970279462
"1960","aint nothing like",34.1879949567198,17,10,7,1.01529564767886,15.9847043523211
"1960","like real thing",34.1879949567198,17,10,7,1.01529564767886,15.9847043523211
"1960","nowhere run",34.1879949567198,17,10,7,1.01529564767886,15.9847043523211
"1990","tell whole",34.1737409559125,21,17,4,4.45503861452016,16.5449613854798
"1990","temple",34.1737409559125,21,17,4,4.45503861452016,16.5449613854798
"1990","vanilla",34.1737409559125,21,17,4,4.45503861452016,16.5449613854798
"1960","home let",34.1638135181946,21,11,10,1.25418874125035,19.7458112587496
"1960","yes baby",34.1638135181946,21,11,10,1.25418874125035,19.7458112587496
"1960","home",34.1621329924676,1475,146,1329,88.0918282544891,1386.90817174551
"1970","midnight",34.1507578702176,134,45,89,18.3376175069751,115.662382493025
"1990","can ya",34.1169583081243,23,18,5,4.87932800637923,18.1206719936208
"1990","night dream",34.1169583081243,23,18,5,4.87932800637923,18.1206719936208
"1990","well put",34.1169583081243,23,18,5,4.87932800637923,18.1206719936208
"2000","gon get",34.0969720918539,33,25,8,8.87982767801125,24.1201723219887
"2010","em light",34.0905847142851,14,12,2,2.15547813569839,11.8445218643016
"2010","love will love",34.0905847142851,14,12,2,2.15547813569839,11.8445218643016
"1980","just takes",34.0521364333579,29,19,10,4.87883610166376,24.1211638983362
"1980","like shes",34.0521364333579,29,19,10,4.87883610166376,24.1211638983362
"1980","forever",34.0145830498351,874,215,659,147.038025960487,726.961974039513
"2000","yea yea yea",34.0080621449294,39,28,11,10.494341801286,28.505658198714
"2000","hard make",34.0006822143682,35,26,9,9.41799905243618,25.5820009475638
"2000","thing got",34.0006822143682,35,26,9,9.41799905243618,25.5820009475638
"2000","aint seen",33.9753201490043,37,27,10,9.9561704268611,27.0438295731389
"1990","just go",33.9376793137057,81,41,40,17.1837203702921,63.8162796297079
"1960","dear",33.936715735975,141,29,112,8.42098154839523,132.579018451605
"2000","let see",33.9249739486803,177,84,93,47.6281666366058,129.371833363394
"2010","glass",33.9237314250447,98,39,59,15.0883469498887,82.9116530501113
"2010","tonight im",33.9237314250447,98,39,59,15.0883469498887,82.9116530501113
"1980","say say",33.9146561186187,150,55,95,25.2353591465367,124.764640853463
"1980","thunder",33.8945233451098,91,39,52,15.3094512155656,75.6905487844344
"1980","bop bop bop bop",33.8165713857969,61,30,31,10.2623793862583,50.7376206137417
"1990","dont really wanna",33.7620011473733,34,23,11,7.21291966160408,26.7870803383959
"1970","gold",33.7401181307196,304,80,224,41.6017591203018,262.398240879698
"2010","let give",33.7315395400074,31,19,12,4.77284444333215,26.2271555566679
"2000","breathe",33.7140464738289,191,89,102,51.3953662575803,139.60463374242
"1960","never never never",33.7112686203438,47,16,31,2.80699384946508,44.1930061505349
"2000","crib",33.7051816878244,89,50,39,23.9486261619091,65.0513738380909
"2000","right",33.7017059629877,3946,1226,2720,1061.81212174038,2884.18787825962
"1990","always",33.6878306213764,1781,481,1300,377.829703450496,1403.1702965495
"1980","go cant",33.6574571883275,58,29,29,9.75767220332752,48.2423277966725
"1970","dance night away",33.6223764817296,25,16,9,3.42119729607745,21.5788027039226
"1970","getaway",33.6223764817296,25,16,9,3.42119729607745,21.5788027039226
"2010","hoe",33.6174678380434,110,42,68,16.9358996376302,93.0641003623698
"1970","away gonna",33.6041593474905,15,12,3,2.05271837764647,12.9472816223535
"1970","hot just",33.6041593474905,15,12,3,2.05271837764647,12.9472816223535
"1970","reach touch",33.6041593474905,15,12,3,2.05271837764647,12.9472816223535
"1980","im bad",33.526569729404,43,24,19,7.23413628867385,35.7658637113261
"2000","work",33.518920643981,844,304,540,227.108320007318,616.891679992682
"2010","cause girl",33.4840334989863,46,24,22,7.08228530300899,38.917714696991
"1960","put little",33.4674183353824,26,12,14,1.55280510821472,24.4471948917853
"1960","real thing",33.4674183353824,26,12,14,1.55280510821472,24.4471948917853
"1980","finger trigger",33.465011806658,22,16,6,3.70118600815871,18.2988139918413
"1980","hands oh",33.465011806658,22,16,6,3.70118600815871,18.2988139918413
"1980","maybe youre",33.465011806658,22,16,6,3.70118600815871,18.2988139918413
"1980","running around",33.465011806658,22,16,6,3.70118600815871,18.2988139918413
"1980","try just",33.465011806658,22,16,6,3.70118600815871,18.2988139918413
"2010","will wait",33.4535428636708,34,20,14,5.23473261526751,28.7652673847325
"1990","one youre",33.4281177416279,54,31,23,11.4558135801947,42.5441864198053
"2000","bentley",33.3897507477953,24,20,4,6.45805649309909,17.5419435069009
"2000","bout got",33.3897507477953,24,20,4,6.45805649309909,17.5419435069009
"2000","make life complete",33.3897507477953,24,20,4,6.45805649309909,17.5419435069009
"2000","runnin runnin",33.3897507477953,24,20,4,6.45805649309909,17.5419435069009
"2000","south side",33.3897507477953,24,20,4,6.45805649309909,17.5419435069009
"2010","fly fly",33.3545481454367,43,23,20,6.62039713107362,36.3796028689264
"2000","keep",33.3407432161882,2547,817,1730,685.361245330141,1861.63875466986
"1970","farm",33.3392112413467,28,17,11,3.83174097160674,24.1682590283933
"1970","musics",33.3302414597107,34,19,15,4.65282832266533,29.3471716773347
"1970","take arms",33.3302414597107,34,19,15,4.65282832266533,29.3471716773347
"2010","believe just",33.3188752779003,37,21,16,5.69662078720288,31.3033792127971
"2010","scars",33.2937711717623,40,22,18,6.15850895913825,33.8414910408617
"1990","understanding",33.2802667796877,39,25,14,8.27364314125173,30.7263568587483
"1990","one gave",33.2407038365951,32,22,10,6.78863026974501,25.211369730255
"2010","different",33.1988629420622,198,63,135,30.4846193477343,167.515380652266
"2000","dont give damn",33.1939368296147,50,33,17,13.4542843606231,36.5457156393769
"1970","darling want",33.1817342898187,13,11,2,1.77902259396027,11.2209774060397
"1970","mama come",33.1817342898187,13,11,2,1.77902259396027,11.2209774060397
"2000","city put",33.0996613424361,19,17,2,5.11262805703678,13.8873719429632
"2000","pimps",33.0996613424361,19,17,2,5.11262805703678,13.8873719429632
"1960","say youll",33.0970392713454,54,17,37,3.22505676321519,50.7749432367848
"1960","baby cant hear",33.0912297760537,14,9,5,0.836125827500235,13.1638741724998
"2000","dont try",33.0910164126962,102,55,47,27.4467400956712,74.5532599043289
"1970","seasons",33.0572797469493,58,26,32,7.93717772689968,50.0628222731003
"1970","cant stand rain",33.0201870553297,20,14,6,2.73695783686196,17.263042163138
"1970","mice",33.0201870553297,20,14,6,2.73695783686196,17.263042163138
"2010","right now wanna",33.0103223243577,21,15,6,3.23321720354758,17.7667827964524
"2000","weed",32.9892154273329,80,46,34,21.526854976997,58.473145023003
"2000","suck",32.9397555503242,48,32,16,12.9161129861982,35.0838870138018
"2010","pour",32.8538942970441,92,37,55,14.164570606018,77.835429393982
"1980","bad come",32.8203305330108,20,15,5,3.36471455287156,16.6352854471284
"1980","heartbreaker",32.8203305330108,20,15,5,3.36471455287156,16.6352854471284
"1980","hot hot hot hot",32.8203305330108,20,15,5,3.36471455287156,16.6352854471284
"1980","touch im",32.8203305330108,20,15,5,3.36471455287156,16.6352854471284
"1980","love feel",32.7760965711103,89,38,51,14.9729797602784,74.0270202397216
"2000","get right",32.7357160890179,128,65,63,34.4429679631952,93.5570320368048
"2000","girls go",32.7064510296708,46,31,15,12.3779416117733,33.6220583882267
"2010","loud",32.6807583519167,208,65,143,32.0242465875189,175.975753412481
"1990","knocked",32.6689631959399,52,30,22,11.0315241883356,40.9684758116644
"2000","get girl",32.6569708616712,57,36,21,15.3378841711103,41.6621158288897
"1990","da la da da",32.6501652413551,37,24,13,7.84935374939267,29.1506462506073
"1990","horny",32.6501652413551,37,24,13,7.84935374939267,29.1506462506073
"1990","mold",32.6501652413551,37,24,13,7.84935374939267,29.1506462506073
"1990","see nothing",32.6501652413551,37,24,13,7.84935374939267,29.1506462506073
"1980","dont turn",32.5918797361554,38,22,16,6.39295765045596,31.607042349544
"1990","baby baby",32.5714218872753,786,235,551,166.745731000612,619.254268999388
"1960","birds bees",32.5670646671219,11,8,3,0.656956007321613,10.3430439926784
"1960","comes now",32.5670646671219,11,8,3,0.656956007321613,10.3430439926784
"1960","gee",32.5670646671219,11,8,3,0.656956007321613,10.3430439926784
"1960","get place",32.5670646671219,11,8,3,0.656956007321613,10.3430439926784
"1960","little piece heart",32.5670646671219,11,8,3,0.656956007321613,10.3430439926784
"1960","salad",32.5670646671219,11,8,3,0.656956007321613,10.3430439926784
"2010","aint",32.5236651966122,3592,680,2912,553.034104530615,3038.96589546939
"2000","can see eyes",32.4971382285678,44,30,14,11.8397702373483,32.1602297626517
"2000","habit",32.4971382285678,44,30,14,11.8397702373483,32.1602297626517
"1980","long way",32.4968552163162,56,28,28,9.42120074804036,46.5787992519596
"1990","hes gonna",32.4662664801082,47,28,19,9.97080070868799,37.029199291312
"1990","way things",32.4662664801082,47,28,19,9.97080070868799,37.029199291312
"1960","red",32.4655074662126,452,60,392,26.994919573579,425.005080426421
"1990","pumpin",32.4350265975091,42,26,16,8.91007722904033,33.0899227709597
"1990","relationship",32.4350265975091,42,26,16,8.91007722904033,33.0899227709597
"1980","cant hold",32.4124899444691,69,32,37,11.6082652074069,57.3917347925931
"1980","say will",32.3945316670228,41,23,18,6.8976648333867,34.1023351666133
"1980","way home",32.3945316670228,41,23,18,6.8976648333867,34.1023351666133
"1970","machine",32.3881669755772,48,23,25,6.5686988084687,41.4313011915313
"1960","long gone",32.3843104661742,27,12,15,1.6125283816076,25.3874716183924
"1980","hold tight",32.3680935444676,149,54,95,25.0671234188931,123.932876581107
"1970","saved",32.3624744520121,74,30,44,10.1267439963892,63.8732560036107
"1980","weve",32.3589484053539,427,119,308,71.8366557038078,355.163344296192
"1980","heart thats",32.3538582241276,30,19,11,5.04707182930734,24.9529281706927
"1980","time fall",32.3538582241276,30,19,11,5.04707182930734,24.9529281706927
"1960","sock",32.3353705730955,49,16,33,2.92644039625082,46.0735596037492
"1980","d o",32.3111224574365,18,14,4,3.0282430975844,14.9717569024156
"1980","look got",32.3111224574365,18,14,4,3.0282430975844,14.9717569024156
"1980","maniac",32.3111224574365,18,14,4,3.0282430975844,14.9717569024156
"1990","get kiss",32.3107460172331,16,14,2,3.39431513487251,12.6056848651275
"1990","though friends",32.3107460172331,16,14,2,3.39431513487251,12.6056848651275
"1960","darlin",32.3066103563359,181,33,148,10.8099124841102,170.19008751589
"1970","shes kind",32.3010237949961,23,15,8,3.14750151239125,19.8524984876087
"2010","lets",32.2809529615759,1662,343,1319,255.886047252194,1406.11395274781
"1970","loser",32.2794525663495,38,20,18,5.20021989003772,32.7997801099623
"2010","ooh baby baby",32.2169558557027,32,19,13,4.9268071673106,27.0731928326894
"2010","blowin",32.2071175917613,57,27,30,8.77587526677201,48.224124733228
"2000","diss",32.1774286264759,30,23,7,8.07257061637387,21.9274293836261
"1980","danger",32.1497061950343,66,31,35,11.1035580244761,54.8964419755239
"1990","can just",32.1185564041389,83,41,42,17.6080097621511,65.3919902378489
"1990","like like like",32.1185564041389,83,41,42,17.6080097621511,65.3919902378489
"2010","im coming home",32.0539787548607,35,20,15,5.38869533924597,29.611304660754
"2000","give away",32.0516336046536,62,38,24,16.6833126071727,45.3166873928273
"2000","east side",32.0367151621903,32,24,8,8.61074199079879,23.3892580092012
"2000","nigga dont",32.0367151621903,32,24,8,8.61074199079879,23.3892580092012
"1980","boys will boys",32.0309073229345,14,12,2,2.35530018701009,11.6446998129899
"1980","time much",32.0309073229345,14,12,2,2.35530018701009,11.6446998129899
"1980","mistake",32.0254828412504,108,43,65,18.1694585855064,89.8305414144936
"1970","board",32.024054604604,35,19,16,4.78967621450843,30.2103237854916
"1960","come come",32.0230217581272,369,52,317,22.0378878819705,346.96211211803
"2010","magic magic",32.0110509783167,38,21,17,5.85058351118134,32.1494164888187
"1980","commotion",32.0048728435966,16,13,3,2.69177164229725,13.3082283577028
"1980","feel think",32.0048728435966,16,13,3,2.69177164229725,13.3082283577028
"1980","honey just",32.0048728435966,16,13,3,2.69177164229725,13.3082283577028
"1980","somebody loves",32.0048728435966,16,13,3,2.69177164229725,13.3082283577028
"1980","time fall love",32.0048728435966,16,13,3,2.69177164229725,13.3082283577028
"1980","youre touch",32.0048728435966,16,13,3,2.69177164229725,13.3082283577028
"2010","keisha",31.9958219181207,24,16,8,3.69510537548295,20.3048946245171
"2000","cant breathe",31.9902605081601,36,26,10,9.68708473964864,26.3129152603514
"2000","girls want",31.9902605081601,36,26,10,9.68708473964864,26.3129152603514
"2000","nuttin",31.9902605081601,36,26,10,9.68708473964864,26.3129152603514
"2000","frontin",31.979851290461,34,25,9,9.14891336522372,24.8510866347763
"2000","succeed",31.979851290461,34,25,9,9.14891336522372,24.8510866347763
"1990","can think",31.9670698896035,26,19,7,5.51576209416782,20.4842379058322
"1970","wash",31.9570545473515,99,36,63,13.5479412924667,85.4520587075333
"2010","remind",31.9556848444736,162,54,108,24.9419612845099,137.05803871549
"1970","shop",31.9492153053362,63,27,36,8.62141718611517,54.3785828138848
"1970","one nights",31.9411359124982,26,16,10,3.55804518792055,22.4419548120795
"1970","song sing",31.9411359124982,26,16,10,3.55804518792055,22.4419548120795
"2000","broke niggas",31.9139836736006,21,18,3,5.65079943146171,15.3492005685383
"2000","special one",31.9139836736006,21,18,3,5.65079943146171,15.3492005685383
"2000","stay fly",31.9139836736006,21,18,3,5.65079943146171,15.3492005685383
"2000","wish wish",31.9139836736006,21,18,3,5.65079943146171,15.3492005685383
"1970","got get back",31.9123390779831,18,13,5,2.46326205317576,15.5367379468242
"1970","ready get",31.9123390779831,18,13,5,2.46326205317576,15.5367379468242
"2000","side",31.9091470012366,799,288,511,214.999464082757,584.000535917243
"2000","trust",31.8825223883584,239,105,134,64.3114792437785,174.688520756222
"1970","mountain high",31.860361432904,32,18,14,4.37913253897913,27.6208674610209
"1960","need love need",31.8444695576762,38,14,24,2.26948438892921,35.7305156110708
"1980","must",31.8410341970997,696,176,520,117.09206643993,578.90793356007
"1980","always something",31.8334021971913,33,20,13,5.55177901223807,27.4482209877619
"2000","back",31.8301925865147,3938,1219,2719,1059.65943624268,2878.34056375732
"1980","true love",31.8202768961106,112,44,68,18.8424014960807,93.1575985039193
"1980","time time",31.8087690359116,194,65,129,32.6377311628541,161.362268837146
"2000","dope",31.7886370583137,86,48,38,23.1413691002718,62.8586308997282
"1990","ill gone",31.739102153048,45,27,18,9.54651131682892,35.4534886831711
"2000","like way",31.7257278701841,211,95,116,56.7770800018295,154.22291999817
"1990","every beat",31.7250427370885,18,15,3,3.81860452673157,14.1813954732684
"1990","falling rain",31.7250427370885,18,15,3,3.81860452673157,14.1813954732684
"1990","im sending",31.7250427370885,18,15,3,3.81860452673157,14.1813954732684
"1990","love say love",31.7250427370885,18,15,3,3.81860452673157,14.1813954732684
"1990","one woman",31.7250427370885,18,15,3,3.81860452673157,14.1813954732684
"1990","opposites",31.7250427370885,18,15,3,3.81860452673157,14.1813954732684
"1990","whole new",31.7250427370885,18,15,3,3.81860452673157,14.1813954732684
"1960","please dont",31.6980926894618,249,40,209,14.8710950748256,234.128904925174
"1990","yeah whats",31.6867245510821,24,18,6,5.09147270230876,18.9085272976912
"1980","take heart",31.6596304446832,87,37,50,14.6365083049913,72.3634916950087
"1960","sight",31.6561037514918,211,36,175,12.6016106858964,198.398389314104
"2010","red",31.5982462601889,452,116,336,69.5911512382622,382.408848761738
"1990","shout",31.5978910406906,139,59,80,29.4881127342049,109.511887265795
"2010","shut",31.5493324616218,146,50,96,22.4785577008546,123.521442299145
"1990","come dance come",31.5187212884349,22,17,5,4.6671833104497,17.3328166895503
"1990","cant go wrong",31.5070043935845,20,16,4,4.24289391859063,15.7571060814094
"1990","fantastic",31.5070043935845,20,16,4,4.24289391859063,15.7571060814094
"2010","bed",31.4941613243356,350,95,255,53.8869533924597,296.11304660754
"1970","get tonight",31.4897198990125,42,21,21,5.74761145741011,36.2523885425899
"1980","things can",31.4846149702809,36,21,15,6.05648619516881,29.9435138048312
"1970","darling",31.4704203309112,260,70,190,35.5804518792055,224.419548120795
"1990","makes happy",31.4571783611958,33,22,11,7.00077496567454,25.9992250343255
"1990","one need",31.4571783611958,33,22,11,7.00077496567454,25.9992250343255
"2010","fairytale",31.4344830627415,17,13,4,2.61736630763376,14.3826336923662
"2010","live without baby",31.4344830627415,17,13,4,2.61736630763376,14.3826336923662
"2010","oh oh oh im",31.4344830627415,17,13,4,2.61736630763376,14.3826336923662
"2010","without cant live",31.4344830627415,17,13,4,2.61736630763376,14.3826336923662
"1970","oh sweet",31.396632238247,49,23,26,6.7055467003118,42.2944532996882
"2010","care love",31.3651237411634,27,17,10,4.15699354741832,22.8430064525817
"1960","na na nana na",31.3605438532727,28,12,16,1.67225165500047,26.3277483449995
"1960","na nana na na",31.3605438532727,28,12,16,1.67225165500047,26.3277483449995
"1960","nana na na",31.3605438532727,28,12,16,1.67225165500047,26.3277483449995
"1980","degree",31.348186687321,23,16,7,3.86942173580229,19.1305782641977
"1980","remember remember remember",31.348186687321,23,16,7,3.86942173580229,19.1305782641977
"1960","dandy",31.2732255926798,15,9,6,0.895849100893109,14.1041508991069
"1960","love dirty",31.2732255926798,15,9,6,0.895849100893109,14.1041508991069
"1960","million years",31.2732255926798,15,9,6,0.895849100893109,14.1041508991069
"1960","ooowee",31.2732255926798,15,9,6,0.895849100893109,14.1041508991069
"1960","wanna cant",31.2732255926798,15,9,6,0.895849100893109,14.1041508991069
"1990","ya know",31.2668699419398,64,34,30,13.57726053949,50.42273946051
"1990","pray",31.2521700421315,206,79,127,43.7018073614835,162.298192638516
"1970","guitar",31.2221408611377,96,35,61,13.1373976169374,82.8626023830626
"2000","ooh whoa",31.2009356447828,65,39,26,17.49056966881,47.50943033119
"1980","listen",31.1878376235756,491,132,359,82.6037422729968,408.396257727003
"2000","sent",31.185712276176,130,65,65,34.9811393376201,95.0188606623799
"1980","desire",31.1741336452058,102,41,61,17.1600442196449,84.8399557803551
"1990","pure",31.1623353880537,48,28,20,10.1829454046175,37.8170545953825
"1980","im walking",31.1469035346362,42,23,19,7.06590056103027,34.9340994389697
"2000","soak",31.1375401173608,23,19,4,6.18897080588663,16.8110291941134
"2000","wanna drive",31.1375401173608,23,19,4,6.18897080588663,16.8110291941134
"1970","la da",31.1360468241107,64,27,37,8.75826507795827,55.2417349220417
"2000","ready go",31.1358361150727,47,31,16,12.6470272989857,34.3529727010143
"1980","strangers",31.1341706660696,48,25,23,8.07531492689174,39.9246850731083
"1980","step",31.1063771440086,552,145,407,92.866121659255,459.133878340745
"1990","get youre",31.0833462335723,38,24,14,8.0614984453222,29.9385015546778
"1960","black",31.0692823737065,428,57,371,25.56156101215,402.43843898785
"1960","beat goes",31.0635787995473,39,14,25,2.32920766232208,36.6707923376779
"1960","broadway",31.0635787995473,39,14,25,2.32920766232208,36.6707923376779
"1980","church",31.0233669194116,74,33,41,12.4494438456248,61.5505561543752
"1990","never find another",31.0193608304266,43,26,17,9.12222192496986,33.8777780750301
"1990","sending",31.0193608304266,43,26,17,9.12222192496986,33.8777780750301
"1990","youve gotta",31.0193608304266,43,26,17,9.12222192496986,33.8777780750301
"1970","jackie",31.0154927657899,21,14,7,2.87380572870506,18.1261942712949
"1970","stand rain",31.0154927657899,21,14,7,2.87380572870506,18.1261942712949
"2010","team",31.0040659289134,76,32,44,11.7011670223627,64.2988329776373
"1970","hoo hoo",31.0008232895371,53,24,29,7.25293826768419,45.7470617323158
"2010","dont wanna know",30.9895158783828,30,18,12,4.61888171935369,25.3811182806463
"2010","let love let love",30.9895158783828,30,18,12,4.61888171935369,25.3811182806463
"2010","world dont",30.9895158783828,30,18,12,4.61888171935369,25.3811182806463
"2010","now im",30.9543054412204,555,136,419,85.4493118080432,469.550688191957
"1980","boys",30.9322678379236,581,151,430,97.7449577609188,483.255042239081
"1970","angel baby",30.9158361224809,16,12,4,2.18956626948957,13.8104337305104
"1970","believe believe believe im",30.9158361224809,16,12,4,2.18956626948957,13.8104337305104
"1970","believe believe im",30.9158361224809,16,12,4,2.18956626948957,13.8104337305104
"1970","fine now",30.9158361224809,16,12,4,2.18956626948957,13.8104337305104
"1970","mist",30.9158361224809,16,12,4,2.18956626948957,13.8104337305104
"1970","oh lonely",30.9158361224809,16,12,4,2.18956626948957,13.8104337305104
"1970","round circles",30.9158361224809,16,12,4,2.18956626948957,13.8104337305104
"1970","shine dont",30.9158361224809,16,12,4,2.18956626948957,13.8104337305104
"1990","want fly",30.9036959560026,31,21,10,6.57648557381548,24.4235144261845
"2010","ever take away",30.8961526379257,15,12,3,2.30944085967684,12.6905591403232
"2010","eyes yeah",30.8961526379257,15,12,3,2.30944085967684,12.6905591403232
"2010","just trying get",30.8961526379257,15,12,3,2.30944085967684,12.6905591403232
"2010","life life life",30.8961526379257,15,12,3,2.30944085967684,12.6905591403232
"2010","love way make",30.8961526379257,15,12,3,2.30944085967684,12.6905591403232
"2010","loving oh",30.8961526379257,15,12,3,2.30944085967684,12.6905591403232
"2010","play hard",30.8961526379257,15,12,3,2.30944085967684,12.6905591403232
"2010","story life",30.8961526379257,15,12,3,2.30944085967684,12.6905591403232
"2010","want know want know",30.8961526379257,15,12,3,2.30944085967684,12.6905591403232
"2010","yeahyour love",30.8961526379257,15,12,3,2.30944085967684,12.6905591403232
"1970","blinded",30.892282980433,46,22,24,6.29500302478251,39.7049969752175
"1970","smiles",30.892282980433,46,22,24,6.29500302478251,39.7049969752175
"2010","tonight yeah",30.8845546583936,42,22,20,6.46643440709516,35.5335655929048
"1990","believe",30.856233100063,1245,347,898,264.120146432267,980.879853567733
"1990","rush",30.8394856797584,137,58,79,29.0638233423458,107.936176657654
"2000","put",30.8227491081351,1646,545,1101,442.915041151713,1203.08495884829
"2010","home know",30.7938602310356,33,19,14,5.08076989128906,27.9192301087109
"1980","together forever",30.770970448726,31,19,12,5.21530755695092,25.7846924430491
"2010","iii",30.768304023471,39,21,18,6.0045462351598,32.9954537648402
"2010","rock rock rock",30.768304023471,39,21,18,6.0045462351598,32.9954537648402
"2000","like girl",30.7605511324442,92,50,42,24.7558832235465,67.2441167764535
"2000","go right now",30.7030938597005,18,16,2,4.84354236982432,13.1564576301757
"2000","peaches cream",30.7030938597005,18,16,2,4.84354236982432,13.1564576301757
"2010","downtown",30.682720546889,103,39,64,15.858160569781,87.141839430219
"1990","nation",30.6824372116994,51,29,22,10.8193794924061,40.1806205075939
"2000","escape",30.66342970317,115,59,56,30.9448540294332,84.0551459705668
"2010","places",30.6262980428443,119,43,76,18.3215641534363,100.678435846564
"2000","contagious",30.6234856870124,25,20,5,6.72714218031156,18.2728578196884
"2000","crazy right",30.6234856870124,25,20,5,6.72714218031156,18.2728578196884
"2000","keep ya",30.6234856870124,25,20,5,6.72714218031156,18.2728578196884
"2000","girl make",30.6152192970391,54,34,20,14.530627109473,39.469372890527
"2000","switch",30.6028548798724,75,43,32,20.1814265409347,54.8185734590653
"1980","come go",30.5672341956691,78,34,44,13.1223867561991,64.8776132438009
"1970","love feel like",30.5604802928569,24,15,9,3.28434940423435,20.7156505957656
"1970","travelin",30.5604802928569,24,15,9,3.28434940423435,20.7156505957656
"1980","eyes want",30.5548260067826,21,15,6,3.53295028051514,17.4670497194849
"1980","much baby",30.5548260067826,21,15,6,3.53295028051514,17.4670497194849
"1980","witcha",30.5548260067826,21,15,6,3.53295028051514,17.4670497194849
"1970","good ill",30.5401896557845,33,18,15,4.51598043082223,28.4840195691778
"1970","bird",30.4880183275595,93,34,59,12.7268539414081,80.2731460585919
"2000","wantin",30.4417845468122,41,28,13,11.032513175711,29.9674868242891
"1970","away oh",30.4412203940372,50,23,27,6.8423945921549,43.1576054078451
"1990","mehow",30.4299038659134,36,23,13,7.63720905346314,28.3627909465369
"1970","bobby",30.4210121451978,43,21,22,5.88445934925321,37.1155406507468
"2000","mall",30.4156124970081,61,37,24,16.4142269199602,44.5857730800398
"1970","deuce",30.3944655971579,30,17,13,4.10543675529294,25.8945632447071
"1970","tell get",30.3944655971579,30,17,13,4.10543675529294,25.8945632447071
"1960","na nana na",30.3904149841765,29,12,17,1.73197492839334,27.2680250716067
"1960","nana na",30.3904149841765,29,12,17,1.73197492839334,27.2680250716067
"1990","however",30.3875785059766,29,20,9,6.15219618195642,22.8478038180436
"1990","jealousy",30.3875785059766,29,20,9,6.15219618195642,22.8478038180436
"1970","cause ive got",30.3832879637114,27,16,11,3.69489307976364,23.3051069202364
"1990","wanna love",30.3654170178576,88,42,46,18.6687332417988,69.3312667582012
"1970","flash",30.3456877078952,65,27,38,8.89511296980137,56.1048870301986
"2000","crack",30.3387851035911,85,47,38,22.8722834130593,62.1277165869407
"1990","hurt",30.3256094435047,542,170,372,114.982425193806,427.017574806194
"1960","heaven must sent",30.304844344794,12,8,4,0.716679280714487,11.2833207192855
"1960","mine baby im",30.304844344794,12,8,4,0.716679280714487,11.2833207192855
"1960","softer",30.304844344794,12,8,4,0.716679280714487,11.2833207192855
"1960","sure enough",30.304844344794,12,8,4,0.716679280714487,11.2833207192855
"1980","youre just",30.3044855091627,122,46,76,20.5247587725165,101.475241227483
"2000","ride ride",30.3006807510835,95,51,44,25.5631402851839,69.4368597148161
"2000","forever ever ever",30.2918410259125,27,21,6,7.26531355473648,19.7346864452635
"2000","way live",30.2918410259125,27,21,6,7.26531355473648,19.7346864452635
"2010","shot",30.2691327179945,223,67,156,34.3336874471958,188.666312552804
"2000","holiday",30.2653312026834,39,27,12,10.494341801286,28.505658198714
"2000","wasnt",30.2557197601504,245,106,139,65.9259933670533,179.074006632947
"2010","super",30.254818699201,77,32,45,11.8551297463411,65.1448702536589
"2010","dont fuck",30.2119759742975,25,16,9,3.84906809946141,21.1509319005386
"2010","lower",30.2119759742975,25,16,9,3.84906809946141,21.1509319005386
"1970","jet",30.2105745810756,73,29,44,9.98989610454615,63.0101038954538
"1980","honey",30.2063280542127,421,116,305,70.8272413379463,350.172758662054
"1960","alligators",30.1640815817438,9,7,2,0.537509460535866,8.46249053946413
"1960","baby goodbye",30.1640815817438,9,7,2,0.537509460535866,8.46249053946413
"1960","dont just stand",30.1640815817438,9,7,2,0.537509460535866,8.46249053946413
"1960","e f",30.1640815817438,9,7,2,0.537509460535866,8.46249053946413
"1960","eyes seen",30.1640815817438,9,7,2,0.537509460535866,8.46249053946413
"1960","love potion",30.1640815817438,9,7,2,0.537509460535866,8.46249053946413
"1980","say say say",30.1397984916552,37,21,16,6.22472192281238,30.7752780771876
"1980","shack",30.1380632550622,111,43,68,18.6741657684371,92.3258342315629
"1970","closer get",30.090226061007,14,11,3,1.91587048580337,12.0841295141966
"1970","got time got",30.090226061007,14,11,3,1.91587048580337,12.0841295141966
"1970","never ending",30.090226061007,14,11,3,1.91587048580337,12.0841295141966
"1970","precious moments",30.090226061007,14,11,3,1.91587048580337,12.0841295141966
"1970","thank god im",30.090226061007,14,11,3,1.91587048580337,12.0841295141966
"1980","ooh ooh",30.0897807146102,426,117,309,71.6684199761642,354.331580023836
"2010","couple",30.068622095353,120,43,77,18.4755268774148,101.524473122585
"1960","love love",30.0541136509816,1001,105,896,59.7829966662668,941.217003333733
"2000","girl girl",30.03202474338,59,36,23,15.8760555455353,43.1239444544647
"2000","oops",29.9973055187731,31,23,8,8.34165630358633,22.6583436964137
"2010","better better",29.9893437618,46,23,23,7.08228530300899,38.917714696991
"2000","say make",29.9802097003036,33,24,9,8.87982767801125,24.1201723219887
"2010","tonights",29.9793124595351,56,26,30,8.62191254279355,47.3780874572064
"2010","im different",29.9609834468312,20,14,6,3.07925447956913,16.9207455204309
"2010","lipstick",29.9609834468312,20,14,6,3.07925447956913,16.9207455204309
"2010","rock house",29.9609834468312,20,14,6,3.07925447956913,16.9207455204309
"2010","things baby",29.9609834468312,20,14,6,3.07925447956913,16.9207455204309
"1990","way girl",29.9181033431124,27,19,8,5.72790679009735,21.2720932099026
"1960","diamond ring",29.8664038277865,20,10,10,1.19446546785748,18.8055345321425
"2000","cash",29.8602681513868,116,59,57,31.2139397166456,84.7860602833544
"1970","da la",29.8590104905194,58,25,33,7.93717772689968,50.0628222731003
"1980","cant disguise",29.8482611783559,19,14,5,3.19647882522798,15.803521174772
"1980","just waiting",29.8482611783559,19,14,5,3.19647882522798,15.803521174772
"1980","shes never",29.8482611783559,19,14,5,3.19647882522798,15.803521174772
"1980","spreading",29.8482611783559,19,14,5,3.19647882522798,15.803521174772
"1980","yes got",29.8482611783559,19,14,5,3.19647882522798,15.803521174772
"1980","prayer",29.820567883494,86,36,50,14.4682725773477,71.5317274226523
"1970","dont stop",29.8185846709073,317,80,237,43.380781714262,273.619218285738
"1960","dizzy",29.7986243293719,35,13,22,2.09031456875059,32.9096854312494
"1960","whyd",29.7986243293719,35,13,22,2.09031456875059,32.9096854312494
"1970","fine girl",29.7781043569626,19,13,6,2.60010994501886,16.3998900549811
"1970","get best",29.7781043569626,19,13,6,2.60010994501886,16.3998900549811
"1960","im gonna make",29.7058619997245,104,23,81,6.21122043285889,97.7887795671411
"1970","call call",29.6875858009866,62,26,36,8.48456929427207,53.5154307057279
"1990","pleasure",29.6730387630184,60,32,28,12.7286817557719,47.2713182442281
"1960","vine",29.6566830841803,16,9,7,0.955572374285983,15.044427625714
"2000","gots",29.6477463054429,48,31,17,12.9161129861982,35.0838870138018
"2000","scared",29.6467299806397,195,88,107,52.4717090064301,142.52829099357
"1990","mercy mercy",29.6068684390269,39,24,15,8.27364314125173,30.7263568587483
"2000","lean just",29.605054708914,20,17,3,5.38171374424925,14.6182862557508
"2000","love us",29.605054708914,20,17,3,5.38171374424925,14.6182862557508
"2000","move love",29.605054708914,20,17,3,5.38171374424925,14.6182862557508
"2000","p diddy",29.605054708914,20,17,3,5.38171374424925,14.6182862557508
"2000","room can",29.605054708914,20,17,3,5.38171374424925,14.6182862557508
"2000","see day",29.605054708914,20,17,3,5.38171374424925,14.6182862557508
"2000","well fly",29.605054708914,20,17,3,5.38171374424925,14.6182862557508
"1990","make go",29.5908735195527,83,40,43,17.6080097621511,65.3919902378489
"1990","love will",29.5864164647439,262,94,168,55.5819103335373,206.418089666463
"1970","smiling",29.5731135998169,82,31,51,11.221527131134,70.778472868866
"1960","love need",29.5670307409402,129,26,103,7.70430226768074,121.295697732319
"2010","baby ooh",29.558072514478,67,29,38,10.3155025065566,56.6844974934434
"1970","cause come",29.5528933502488,12,10,2,1.64217470211718,10.3578252978828
"1970","evil mind",29.5528933502488,12,10,2,1.64217470211718,10.3578252978828
"1970","got runnin",29.5528933502488,12,10,2,1.64217470211718,10.3578252978828
"1970","love love youre",29.5528933502488,12,10,2,1.64217470211718,10.3578252978828
"2010","say bye bye",29.5394595168318,31,18,13,4.77284444333215,26.2271555566679
"1990","life oh oh",29.5080272809338,25,18,7,5.30361739823829,19.6963826017617
"2010","woke",29.5027550830252,101,38,63,15.5502351218241,85.4497648781759
"1970","gonna miss",29.501284185692,74,29,45,10.1267439963892,63.8732560036107
"1990","cause even",29.4861837422986,15,13,2,3.18217043894297,11.817829561057
"1990","every beat heart",29.4861837422986,15,13,2,3.18217043894297,11.817829561057
"1990","goes thats way",29.4861837422986,15,13,2,3.18217043894297,11.817829561057
"1990","hold tight dont let",29.4861837422986,15,13,2,3.18217043894297,11.817829561057
"1990","will save",29.4861837422986,15,13,2,3.18217043894297,11.817829561057
"2010","friday night",29.4769326237137,37,20,17,5.69662078720288,31.3033792127971
"2010","gotta gotta",29.4592727960925,109,40,69,16.7819369136517,92.2180630863483
"2010","daylight",29.4531281354742,34,19,15,5.23473261526751,28.7652673847325
"1980","eye",29.4449062911932,263,80,183,44.245996370261,218.754003629739
"1980","ive searching",29.4310717530638,24,16,8,4.03765746344587,19.9623425365541
"1980","like wind",29.4310717530638,24,16,8,4.03765746344587,19.9623425365541
"1980","mirror mirror",29.4310717530638,24,16,8,4.03765746344587,19.9623425365541
"1960","young girl",29.4245164847926,25,11,14,1.49308183482185,23.5069181651781
"1960","hey hey",29.3924133070949,597,71,526,35.6547942155457,561.345205784454
"1980","nothing nothing",29.3719331050921,56,27,29,9.42120074804036,46.5787992519596
"2000","every time",29.3063671058529,356,143,213,95.7945046476366,260.205495352363
"1980","starlight",29.2904154563108,32,19,13,5.38354328459449,26.6164567154055
"2000","liked",29.286415483177,55,34,21,14.7997127966854,40.2002872033146
"2000","double",29.266591520719,122,61,61,32.8284538399204,89.1715461600796
"1980","another one bites",29.265551823909,17,13,4,2.86000736994083,14.1399926300592
"1980","catch im",29.265551823909,17,13,4,2.86000736994083,14.1399926300592
"1980","first time like",29.265551823909,17,13,4,2.86000736994083,14.1399926300592
"1980","just wanna just",29.265551823909,17,13,4,2.86000736994083,14.1399926300592
"1980","just wanna just wanna",29.265551823909,17,13,4,2.86000736994083,14.1399926300592
"1970","much love",29.2429688666831,108,37,71,14.7795723190546,93.2204276809454
"1970","baby shake",29.2022184791574,22,14,8,3.01065362054815,18.9893463794518
"1970","get enough",29.1271121122615,126,41,85,17.2428343722303,108.75716562777
"1980","bop bop bop",29.1126165978666,87,36,51,14.6365083049913,72.3634916950087
"1990","jerk",29.10822844249,69,35,34,14.6379840191377,54.3620159808623
"2010","birthday",29.0961017517268,64,28,36,9.8536143346212,54.1463856653788
"1980","movin",29.0945857634135,192,63,129,32.301259707567,159.698740292433
"2010","come like",29.086249247563,23,15,8,3.5411426515045,19.4588573484955
"2010","im just gonna",29.086249247563,23,15,8,3.5411426515045,19.4588573484955
"2000","hating",29.0778215418768,44,29,15,11.8397702373483,32.1602297626517
"1970","spill",29.0583524506821,31,17,14,4.24228464713604,26.757715352864
"2010","la la oh",29.0487614294836,18,13,5,2.77132903161221,15.2286709683878
"2010","la oh",29.0487614294836,18,13,5,2.77132903161221,15.2286709683878
"2010","make like",29.0487614294836,18,13,5,2.77132903161221,15.2286709683878
"2010","still get",29.0487614294836,18,13,5,2.77132903161221,15.2286709683878
"1980","tell lies",29.018184507987,35,20,15,5.88825046752523,29.1117495324748
"2010","life life",29.0103360049741,75,31,44,11.5472042983842,63.4527957016158
"1990","cant describe",29.0002981012862,17,14,3,3.60645983080204,13.393540169198
"1990","ill true",29.0002981012862,17,14,3,3.60645983080204,13.393540169198
"1990","im diggin",29.0002981012862,17,14,3,3.60645983080204,13.393540169198
"1990","make sweat",29.0002981012862,17,14,3,3.60645983080204,13.393540169198
"1990","wont back",29.0002981012862,17,14,3,3.60645983080204,13.393540169198
"1980","talk talk",28.9652904690639,63,29,34,10.5988508415454,52.4011491584546
"1970","youre one love",28.9592610706238,25,15,10,3.42119729607745,21.5788027039226
"2010","still got",28.9587113197226,47,23,24,7.23624802698745,39.7637519730126
"1990","rocked",28.9472588472648,21,16,5,4.45503861452016,16.5449613854798
"1970","see will",28.9334184481282,28,16,12,3.83174097160674,24.1682590283933
"2000","now cause",28.9260860517844,53,33,20,14.2615414222605,38.7384585777395
"1970","like like like",28.924990148153,83,31,52,11.3583750229771,71.6416249770229
"1990","right front",28.9171454948307,37,23,14,7.84935374939267,29.1506462506073
"1990","til end",28.9171454948307,37,23,14,7.84935374939267,29.1506462506073
"1990","thats way",28.9155215340489,204,77,127,43.2775179696245,160.722482030376
"1990","youve",28.9067379897461,1117,313,804,236.965625353287,880.034374646713
"2000","im hung",28.9036573577128,22,18,4,5.91988511867417,16.0801148813258
"2000","moe",28.9036573577128,22,18,4,5.91988511867417,16.0801148813258
"2000","rover",28.9036573577128,22,18,4,5.91988511867417,16.0801148813258
"2010","bring back",28.8827316519196,106,39,67,16.3200487417164,89.6799512582836
"1980","head youre",28.8705039384646,15,12,3,2.52353591465367,12.4764640853463
"1980","hearts beat",28.8705039384646,15,12,3,2.52353591465367,12.4764640853463
"1980","infatuation",28.8705039384646,15,12,3,2.52353591465367,12.4764640853463
"1980","just died",28.8705039384646,15,12,3,2.52353591465367,12.4764640853463
"1980","love rest",28.8705039384646,15,12,3,2.52353591465367,12.4764640853463
"1980","reveal",28.8705039384646,15,12,3,2.52353591465367,12.4764640853463
"1980","waiting love",28.8705039384646,15,12,3,2.52353591465367,12.4764640853463
"1980","will boys",28.8705039384646,15,12,3,2.52353591465367,12.4764640853463
"1990","come ride",28.8653076304988,19,15,4,4.0307492226611,14.9692507773389
"1990","gonna make happen",28.8653076304988,19,15,4,4.0307492226611,14.9692507773389
"1990","got hook",28.8653076304988,19,15,4,4.0307492226611,14.9692507773389
"1990","lovin lovin",28.8653076304988,19,15,4,4.0307492226611,14.9692507773389
"1990","will always",28.8633500897529,137,57,80,29.0638233423458,107.936176657654
"1970","tryin get",28.8296873791415,67,27,40,9.16880875348756,57.8311912465124
"1970","sunshine",28.8225349187385,183,53,130,25.0431642072869,157.956835792713
"2000","sex",28.8158975317288,245,105,140,65.9259933670533,179.074006632947
"2010","try try",28.8111108917173,79,32,47,12.163055194298,66.8369448057019
"1980","change heart",28.7869873801631,13,11,2,2.18706445936651,10.8129355406335
"1980","ever oh",28.7869873801631,13,11,2,2.18706445936651,10.8129355406335
"1980","ever youre",28.7869873801631,13,11,2,2.18706445936651,10.8129355406335
"1980","moment time",28.7869873801631,13,11,2,2.18706445936651,10.8129355406335
"1980","ninetynine",28.7869873801631,13,11,2,2.18706445936651,10.8129355406335
"1980","now stand",28.7869873801631,13,11,2,2.18706445936651,10.8129355406335
"1980","party time",28.7869873801631,13,11,2,2.18706445936651,10.8129355406335
"1980","since found",28.7869873801631,13,11,2,2.18706445936651,10.8129355406335
"1980","want share",28.7869873801631,13,11,2,2.18706445936651,10.8129355406335
"1960","today",28.780701578223,377,51,326,22.5156740691135,354.484325930886
"2010","turn turn",28.7694795855348,68,29,39,10.469465230535,57.530534769465
"1990","take heart",28.7563718357609,87,41,46,18.4565885458693,68.5434114541307
"1980","think love",28.7518919878668,70,31,39,11.7765009350505,58.2234990649496
"1990","opened",28.7256722190481,50,28,22,10.6072347964766,39.3927652035234
"1970","get love",28.694902746897,96,34,62,13.1373976169374,82.8626023830626
"1960","dont go",28.6919025854272,167,30,137,9.97378665660995,157.02621334339
"1980","science",28.6911197286247,27,17,10,4.5423646463766,22.4576353536234
"1980","stand oh",28.6911197286247,27,17,10,4.5423646463766,22.4576353536234
"1980","talk dont",28.6911197286247,27,17,10,4.5423646463766,22.4576353536234
"2010","get money",28.6854592504174,44,22,22,6.77435985505208,37.2256401449479
"2010","want bad",28.6854592504174,44,22,22,6.77435985505208,37.2256401449479
"1960","heartaches",28.6509086413151,21,10,11,1.25418874125035,19.7458112587496
"1960","round round round round",28.6509086413151,21,10,11,1.25418874125035,19.7458112587496
"1970","like like like like",28.6307989726583,52,23,29,7.11609037584109,44.8839096241589
"1980","hear",28.6207998236041,1398,313,1085,235.193547245722,1162.80645275428
"1970","love music",28.607774468271,17,12,5,2.32641416133266,14.6735858386673
"1970","time love will",28.607774468271,17,12,5,2.32641416133266,14.6735858386673
"1990","front back",28.5974348738144,30,20,10,6.36434087788595,23.6356591221141
"1990","hadnt",28.5974348738144,30,20,10,6.36434087788595,23.6356591221141
"1990","leave baby",28.5974348738144,30,20,10,6.36434087788595,23.6356591221141
"1960","higher higher",28.5921181838653,31,12,19,1.85142147517909,29.1485785248209
"1970","doin",28.5897480667399,348,85,263,47.6230663613981,300.376933638602
"2010","beast",28.5707904261302,26,16,10,4.00303082343986,21.9969691765601
"2010","contigo",28.5707904261302,26,16,10,4.00303082343986,21.9969691765601
"2010","everybody just",28.5707904261302,26,16,10,4.00303082343986,21.9969691765601
"2010","million dollar",28.5707904261302,26,16,10,4.00303082343986,21.9969691765601
"1990","check",28.5423970545436,261,93,168,55.3697656376078,205.630234362392
"1980","ooo ooo",28.5289413090385,22,15,7,3.70118600815871,18.2988139918413
"1990","hole",28.455125345387,64,33,31,13.57726053949,50.42273946051
"2000","angels",28.4468493389938,82,45,37,22.0650263514219,59.9349736485781
"2010","going",28.4409303056446,1104,237,867,169.974847272216,934.025152727784
"1990","yeah yeah yeah yeah",28.4354537235331,549,170,379,116.467438065313,432.532561934687
"1960","belonged",28.4183506689941,26,11,15,1.55280510821472,24.4471948917853
"1960","rain rain",28.4183506689941,26,11,15,1.55280510821472,24.4471948917853
"1970","night away",28.4139713177442,45,21,24,6.15815513293941,38.8418448670606
"2000","never wanna",28.4056038157292,58,35,23,15.6069698583228,42.3930301416772
"1960","beautys",28.3811069951574,13,8,5,0.776402554107361,12.2235974458926
"1960","last train",28.3811069951574,13,8,5,0.776402554107361,12.2235974458926
"1960","let heart",28.3811069951574,13,8,5,0.776402554107361,12.2235974458926
"1960","woman now",28.3811069951574,13,8,5,0.776402554107361,12.2235974458926
"1980","build",28.3532535771726,114,43,71,19.1788729513679,94.8211270486321
"2000","bitch just",28.3204395468843,17,15,2,4.57445668261186,12.4255433173881
"2000","jeeps",28.3204395468843,17,15,2,4.57445668261186,12.4255433173881
"2000","wanna work",28.3204395468843,17,15,2,4.57445668261186,12.4255433173881
"1980","give love",28.3154312846191,219,69,150,36.8436243539436,182.156375646056
"2010","animal",28.2919815366344,29,17,12,4.46491899537523,24.5350810046248
"2010","im getting",28.287405324131,76,31,45,11.7011670223627,64.2988329776373
"2010","im wide",28.2478844339803,16,12,4,2.4634035836553,13.5365964163447
"2010","like drunk",28.2478844339803,16,12,4,2.4634035836553,13.5365964163447
"2010","look back dont",28.2478844339803,16,12,4,2.4634035836553,13.5365964163447
"2010","make without",28.2478844339803,16,12,4,2.4634035836553,13.5365964163447
"2010","money bitch",28.2478844339803,16,12,4,2.4634035836553,13.5365964163447
"2010","time keep",28.2478844339803,16,12,4,2.4634035836553,13.5365964163447
"2010","yeahyour",28.2478844339803,16,12,4,2.4634035836553,13.5365964163447
"1990","fields",28.2410637272056,35,22,13,7.42506435753361,27.5749356424664
"2010","buzz",28.1869963014317,35,19,16,5.38869533924597,29.611304660754
"1960","now love",28.1827109103022,77,19,58,4.59869205125129,72.4013079487487
"2010","glue",28.1788740686664,32,18,14,4.9268071673106,27.0731928326894
"2010","watch watch",28.1788740686664,32,18,14,4.9268071673106,27.0731928326894
"1980","take",28.1769016930682,4302,857,3445,723.750100322672,3578.24989967733
"1970","force",28.1343581310968,76,29,47,10.4004397800754,65.5995602199246
"1970","can cant",28.1117294664515,35,18,17,4.78967621450843,30.2103237854916
"1990","yeah yeah",28.059465307375,1719,457,1262,364.676732302865,1354.32326769714
"2000","just",28.0535422172148,9577,2809,6768,2577.03362643375,6999.96637356625
"1990","total",28.0457009232319,28,19,9,5.94005148602689,22.0599485139731
"2000","please dont stop",28.0321257669165,28,21,7,7.53439924194894,20.4656007580511
"1960","hill",28.0078827429034,63,17,46,3.76256622375106,59.2374337762489
"2000","im sick",28.0033102333882,32,23,9,8.61074199079879,23.3892580092012
"2010","eenie",27.9963441783556,21,14,7,3.23321720354758,17.7667827964524
"2010","right track",27.9963441783556,21,14,7,3.23321720354758,17.7667827964524
"2000","lifted",27.9803524915877,30,22,8,8.07257061637387,21.9274293836261
"1980","loving",27.9600068712959,504,132,372,84.7908067323633,419.209193267637
"1980","always feel",27.9013485235332,33,19,14,5.55177901223807,27.4482209877619
"1980","broken heart",27.8963850966396,111,42,69,18.6741657684371,92.3258342315629
"1980","take home",27.8937418181516,162,55,107,27.2541878782596,134.74581212174
"1970","just little time",27.8734517758121,20,13,7,2.73695783686196,17.263042163138
"1970","ramblin",27.8734517758121,20,13,7,2.73695783686196,17.263042163138
"1990","steps",27.8441033293783,59,31,28,12.5165370598424,46.4834629401576
"2000","na na na",27.8329414718998,1049,360,689,282.270885885873,766.729114114127
"1980","maybe",27.8161672206266,740,181,559,124.494438456248,615.505561543752
"2010","fake",27.8076511442088,116,41,75,17.8596759815009,98.1403240184991
"2010","im coming",27.8061156267958,92,35,57,14.164570606018,77.835429393982
"1970","guaranteed",27.8006908500644,32,17,15,4.37913253897913,27.6208674610209
"1970","like first",27.7722163257623,53,23,30,7.25293826768419,45.7470617323158
"2010","million",27.7670576902807,207,62,145,31.8702838635405,175.12971613646
"1970","lonely",27.7588325489885,748,155,593,102.362223098637,645.637776901363
"1980","wants",27.7389455822828,557,143,414,93.7073002974729,463.292699702527
"1980","around dont",27.7339513593524,45,23,22,7.57060774396101,37.429392256039
"2000","like like",27.7179675347182,318,129,189,85.569248533563,232.430751466437
"1980","end",27.6964479673948,629,158,471,105.820272687811,523.179727312189
"1970","shame",27.6897421446495,157,47,110,21.4851190193664,135.514880980634
"1980","brighter day",27.6827983605169,20,14,6,3.36471455287156,16.6352854471284
"1980","danger zone",27.6827983605169,20,14,6,3.36471455287156,16.6352854471284
"1980","hush hush",27.6827983605169,20,14,6,3.36471455287156,16.6352854471284
"1980","never part",27.6827983605169,20,14,6,3.36471455287156,16.6352854471284
"1980","lost love",27.68125450113,25,16,9,4.20589319108945,20.7941068089106
"1980","see smile",27.68125450113,25,16,9,4.20589319108945,20.7941068089106
"1990","raise",27.6789330812031,126,53,73,26.730231687121,99.269768312879
"1970","shake shake shake",27.6714910828248,272,70,202,37.2226265813226,234.777373418677
"1980","stomp",27.6642814084456,42,22,20,7.06590056103027,34.9340994389697
"1980","alone im",27.6572846210049,39,21,18,6.56119337809954,32.4388066219005
"1980","thing called",27.6572846210049,39,21,18,6.56119337809954,32.4388066219005
"1990","creepin",27.642169925279,43,25,18,9.12222192496986,33.8777780750301
"1990","promise promise",27.642169925279,43,25,18,9.12222192496986,33.8777780750301
"1980","dont",27.630446768928,11587,2164,9423,1949.34737620614,9637.65262379386
"2010","blue jean",27.6179003325054,14,11,3,2.15547813569839,11.8445218643016
"2010","let go got",27.6179003325054,14,11,3,2.15547813569839,11.8445218643016
"2010","ooohh",27.6179003325054,14,11,3,2.15547813569839,11.8445218643016
"2010","shine im",27.6179003325054,14,11,3,2.15547813569839,11.8445218643016
"1960","can care",27.6046692377532,10,7,3,0.597232733928739,9.40276726607126
"1960","green grass",27.6046692377532,10,7,3,0.597232733928739,9.40276726607126
"1960","popcorn",27.6046692377532,10,7,3,0.597232733928739,9.40276726607126
"1960","unusual",27.6046692377532,10,7,3,0.597232733928739,9.40276726607126
"1980","paradise",27.6000403793984,123,45,78,20.6929945001601,102.30700549984
"1970","hollywood",27.587577297082,57,24,33,7.80032983505658,49.1996701649434
"1990","come along",27.5855058694791,51,28,23,10.8193794924061,40.1806205075939
"1990","creep",27.5855058694791,51,28,23,10.8193794924061,40.1806205075939
"1980","way make",27.5836095781974,104,40,64,17.4965156749321,86.5034843250679
"2010","fucked",27.5826061975648,77,31,46,11.8551297463411,65.1448702536589
"1970","hallelujah",27.5789652744587,29,16,13,3.96858886344984,25.0314111365502
"1970","mind love",27.5789652744587,29,16,13,3.96858886344984,25.0314111365502
"2000","wet",27.5750574645205,93,49,44,25.024968910759,67.975031089241
"1970","believe believe believe",27.5486589160036,23,14,9,3.14750151239125,19.8524984876087
"1970","lazy",27.5486589160036,23,14,9,3.14750151239125,19.8524984876087
"1970","take home take",27.5486589160036,23,14,9,3.14750151239125,19.8524984876087
"1970","yesterdays",27.5486589160036,23,14,9,3.14750151239125,19.8524984876087
"1990","love meant",27.5360027878524,26,18,8,5.51576209416782,20.4842379058322
"1990","oh will",27.5360027878524,26,18,8,5.51576209416782,20.4842379058322
"1970","adored",27.535335110765,15,11,4,2.05271837764647,12.9472816223535
"1970","left us",27.535335110765,15,11,4,2.05271837764647,12.9472816223535
"1970","love hey",27.535335110765,15,11,4,2.05271837764647,12.9472816223535
"1970","terrible",27.535335110765,15,11,4,2.05271837764647,12.9472816223535
"1960","gone gone",27.5238501322781,38,13,25,2.26948438892921,35.7305156110708
"1960","much longer",27.5222087853503,22,10,12,1.31391201464323,20.6860879853568
"1960","summer",27.5117608239667,331,46,285,19.7684034930413,311.231596506959
"2010","city",27.510794539819,545,131,414,83.9096845682587,461.090315431741
"2010","turn lights",27.5106624800636,66,28,38,10.1615397825781,55.8384602174219
"1990","believe can",27.4933053556597,38,23,15,8.0614984453222,29.9385015546778
"1990","na na nana",27.4933053556597,38,23,15,8.0614984453222,29.9385015546778
"1970","now bring",27.4783551752467,26,15,11,3.55804518792055,22.4419548120795
"1970","tender love",27.4783551752467,26,15,11,3.55804518792055,22.4419548120795
"1960","daydream",27.4686750745536,27,11,16,1.6125283816076,25.3874716183924
"1960","still see",27.4686750745536,27,11,16,1.6125283816076,25.3874716183924
"1970","dont worry bout",27.4243771278238,39,19,20,5.33706778188082,33.6629322181192
"2010","miney",27.3857607664878,24,15,9,3.69510537548295,20.3048946245171
"2010","just gonna",27.3815747390348,42,21,21,6.46643440709516,35.5335655929048
"2010","whats name",27.3700907511877,59,26,33,9.08380071472892,49.9161992852711
"1960","grow",27.3205287944852,210,34,176,12.5418874125035,197.458112587496
"1980","nasty",27.3193912799653,112,42,70,18.8424014960807,93.1575985039193
"2000","loaded gun",27.3137990359505,19,16,3,5.11262805703678,13.8873719429632
"2000","wont turn",27.3137990359505,19,16,3,5.11262805703678,13.8873719429632
"1990","ever want",27.286942997851,54,29,25,11.4558135801947,42.5441864198053
"2010","come raise",27.2761935817461,12,10,2,1.84755268774148,10.1524473122585
"2010","im wide awake",27.2761935817461,12,10,2,1.84755268774148,10.1524473122585
"2010","time begin",27.2761935817461,12,10,2,1.84755268774148,10.1524473122585
"2000","might get",27.2598300576756,52,32,20,13.992455735048,38.007544264952
"1970","upon",27.2350751747065,207,57,150,28.3275136115213,178.672486388479
"1990","relax",27.2248240729863,74,36,38,15.6987074987853,58.3012925012147
"1980","lonely",27.2231472123475,748,182,566,125.840324277396,622.159675722604
"1980","rhythm",27.2133075943055,252,76,176,42.3954033661816,209.604596633818
"1970","moonlight",27.2095593989903,103,35,68,14.0953328598391,88.9046671401609
"2000","number one",27.1932294510125,96,50,46,25.8322259723964,70.1677740276036
"1990","love shack",27.1835297978375,77,37,40,16.3351415865739,60.6648584134261
"2010","push",27.1565367872456,164,52,112,25.2498867324668,138.750113267533
"2000","take away",27.1479893865639,191,85,106,51.3953662575803,139.60463374242
"1980","love bring",27.1332644743305,28,17,11,4.71060037402018,23.2893996259798
"1980","nananana",27.1332644743305,28,17,11,4.71060037402018,23.2893996259798
"2000","name",27.132747175516,977,337,640,262.896716406576,714.103283593424
"1990","please forgive",27.0801316629781,24,17,7,5.09147270230876,18.9085272976912
"1970","ring",27.0750779788318,274,70,204,37.4963223650088,236.503677634991
"2010","ask im",27.0529974984076,27,16,11,4.15699354741832,22.8430064525817
"2010","now wish",27.0529974984076,27,16,11,4.15699354741832,22.8430064525817
"2000","dirt",27.0316557183143,81,44,37,21.7959406642094,59.2040593357906
"1980","live",27.0125942572004,1210,274,936,203.565230448729,1006.43476955127
"1980","open door",26.9711183947509,62,28,34,10.4306151139018,51.5693848860982
"2010","ice cold",26.9545817295273,19,13,6,2.92529175559067,16.0747082444093
"2010","oh oh oh youre",26.9545817295273,19,13,6,2.92529175559067,16.0747082444093
"2010","us like",26.9545817295273,19,13,6,2.92529175559067,16.0747082444093
"1970","love oh",26.9518306285608,228,61,167,31.2013193402263,196.798680659774
"1990","appeal",26.9409468976705,31,20,11,6.57648557381548,24.4235144261845
"1990","pig",26.9409468976705,31,20,11,6.57648557381548,24.4235144261845
"1980","waiting",26.934738515134,686,169,517,115.409709163494,570.590290836506
"2000","time see",26.9145504352782,64,37,27,17.2214839815976,46.7785160184024
"1980","crying crying",26.9138588825406,18,13,5,3.0282430975844,14.9717569024156
"1980","long way home",26.9138588825406,18,13,5,3.0282430975844,14.9717569024156
"1980","love might",26.9138588825406,18,13,5,3.0282430975844,14.9717569024156
"1980","night give",26.9138588825406,18,13,5,3.0282430975844,14.9717569024156
"1980","shes love",26.9138588825406,18,13,5,3.0282430975844,14.9717569024156
"1980","something said",26.9138588825406,18,13,5,3.0282430975844,14.9717569024156
"1980","wanna just wanna",26.9138588825406,18,13,5,3.0282430975844,14.9717569024156
"2010","take way",26.9086041929193,30,17,13,4.61888171935369,25.3811182806463
"1980","uh uh",26.898437062523,227,70,157,38.1895101750922,188.810489824908
"1960","farewell",26.8797634450079,18,9,9,1.07501892107173,16.9249810789283
"1960","wait long",26.8797634450079,18,9,9,1.07501892107173,16.9249810789283
"1990","survive",26.8335485380636,105,46,59,22.2751930726008,82.7248069273992
"1970","know never",26.832420938432,78,29,49,10.6741355637616,67.3258644362384
"2000","make ya",26.801849055055,57,34,23,15.3378841711103,41.6621158288897
"1970","express",26.8013779205941,58,24,34,7.93717772689968,50.0628222731003
"1990","love tell",26.8003483231298,49,27,22,10.3950901005471,38.604909899453
"1990","yeah yeah yeah",26.7912740795569,913,260,653,193.688107383662,719.311892616338
"1980","just roll",26.7902303487007,31,18,13,5.21530755695092,25.7846924430491
"1970","stuff",26.7871457232928,164,48,116,22.4430542622681,141.556945737732
"1990","free mind",26.7838680583745,36,22,14,7.63720905346314,28.3627909465369
"2000","yard",26.7635513846384,39,26,13,10.494341801286,28.505658198714
"1970","weve got",26.7551245246594,131,41,90,17.9270738314458,113.072926168554
"1960","hey little",26.7060816803953,14,8,6,0.836125827500235,13.1638741724998
"1960","keep hangin",26.7060816803953,14,8,6,0.836125827500235,13.1638741724998
"1980","love shake",26.6988103137668,23,15,8,3.86942173580229,19.1305782641977
"1990","best things",26.694949450801,22,16,6,4.6671833104497,17.3328166895503
"1990","gangster",26.694949450801,22,16,6,4.6671833104497,17.3328166895503
"1990","gonna im",26.694949450801,22,16,6,4.6671833104497,17.3328166895503
"1990","make noise",26.694949450801,22,16,6,4.6671833104497,17.3328166895503
"1990","sun comes",26.6938097941729,63,32,31,13.3651158435605,49.6348841564395
"1990","uhhuh",26.6938097941729,63,32,31,13.3651158435605,49.6348841564395
"2000","dont wanna dance",26.6900025141843,21,17,4,5.65079943146171,15.3492005685383
"2000","dose",26.6900025141843,21,17,4,5.65079943146171,15.3492005685383
"2000","matter cause",26.6900025141843,21,17,4,5.65079943146171,15.3492005685383
"2000","wonder feel",26.6900025141843,21,17,4,5.65079943146171,15.3492005685383
"1990","back good",26.6821874287359,14,12,2,2.97002574301344,11.0299742569866
"1990","barn",26.6821874287359,14,12,2,2.97002574301344,11.0299742569866
"1990","candy sweet",26.6821874287359,14,12,2,2.97002574301344,11.0299742569866
"1990","got feeling im",26.6821874287359,14,12,2,2.97002574301344,11.0299742569866
"1990","got want got",26.6821874287359,14,12,2,2.97002574301344,11.0299742569866
"1990","hold dear",26.6821874287359,14,12,2,2.97002574301344,11.0299742569866
"1990","just anybody",26.6821874287359,14,12,2,2.97002574301344,11.0299742569866
"1990","lied cheated",26.6821874287359,14,12,2,2.97002574301344,11.0299742569866
"1990","soul like",26.6821874287359,14,12,2,2.97002574301344,11.0299742569866
"1990","tuesday wednesday thursday",26.6821874287359,14,12,2,2.97002574301344,11.0299742569866
"1990","tuesday wednesday thursday friday",26.6821874287359,14,12,2,2.97002574301344,11.0299742569866
"1980","affair",26.6603836528224,87,35,52,14.6365083049913,72.3634916950087
"1970","back jack",26.6153833575763,13,10,3,1.77902259396027,11.2209774060397
"1970","can boogie",26.6153833575763,13,10,3,1.77902259396027,11.2209774060397
"1970","dont wanna right",26.6153833575763,13,10,3,1.77902259396027,11.2209774060397
"1970","ive got go",26.6153833575763,13,10,3,1.77902259396027,11.2209774060397
"1970","may sound",26.6153833575763,13,10,3,1.77902259396027,11.2209774060397
"1970","railway",26.6153833575763,13,10,3,1.77902259396027,11.2209774060397
"1970","theres whole",26.6153833575763,13,10,3,1.77902259396027,11.2209774060397
"1970","time night",26.6153833575763,13,10,3,1.77902259396027,11.2209774060397
"2000","dee",26.5967902564493,115,57,58,30.9448540294332,84.0551459705668
"1970","daddy dont",26.5847080849628,18,12,6,2.46326205317576,15.5367379468242
"1970","us well",26.5847080849628,18,12,6,2.46326205317576,15.5367379468242
"1990","paid",26.5758850195413,96,43,53,20.365890809235,75.634109190765
"1980","step take",26.5743832464266,43,22,21,7.23413628867385,35.7658637113261
"1990","bills",26.5737897676908,66,33,33,14.0015499313491,51.9984500686509
"1960","cryin",26.5502044090581,130,25,105,7.76402554107361,122.235974458926
"2000","cant take",26.5488241168472,164,75,89,44.1300527028438,119.869947297156
"2000","nobody wants",26.5329129031792,37,25,12,9.9561704268611,27.0438295731389
"1980","always mind",26.509195760619,37,20,17,6.22472192281238,30.7752780771876
"1980","like bad",26.509195760619,37,20,17,6.22472192281238,30.7752780771876
"2010","make night",26.5060753548834,53,24,29,8.16002437085818,44.8399756291418
"1980","get away",26.4358593002358,137,48,89,23.0482946871702,113.95170531283
"1990","keep coming",26.4088716747038,44,25,19,9.33436662089939,34.6656333791006
"1990","money get",26.4056037925684,20,15,5,4.24289391859063,15.7571060814094
"1990","remember time",26.4056037925684,20,15,5,4.24289391859063,15.7571060814094
"1990","ride just",26.4056037925684,20,15,5,4.24289391859063,15.7571060814094
"1990","say hes",26.4056037925684,20,15,5,4.24289391859063,15.7571060814094
"1990","prove",26.3781363987165,138,56,82,29.2759680382754,108.724031961725
"2010","staring",26.3582027229454,75,30,45,11.5472042983842,63.4527957016158
"2010","stops",26.3529220062843,43,21,22,6.62039713107362,36.3796028689264
"1990","jump jump jump",26.3245364821794,29,19,10,6.15219618195642,22.8478038180436
"1960","youll",26.3166458985936,1377,131,1246,82.2389474619874,1294.76105253801
"2000","girls like",26.3077336986637,23,18,5,6.18897080588663,16.8110291941134
"2000","phantom",26.3077336986637,23,18,5,6.18897080588663,16.8110291941134
"2000","see dance",26.3077336986637,23,18,5,6.18897080588663,16.8110291941134
"2000","side put",26.3077336986637,23,18,5,6.18897080588663,16.8110291941134
"2000","smell like",26.3077336986637,23,18,5,6.18897080588663,16.8110291941134
"2000","standing still",26.3077336986637,23,18,5,6.18897080588663,16.8110291941134
"1990","attract",26.3008173339834,16,13,3,3.39431513487251,12.6056848651275
"1990","ill home",26.3008173339834,16,13,3,3.39431513487251,12.6056848651275
"1990","little game",26.3008173339834,16,13,3,3.39431513487251,12.6056848651275
"1990","mercy mercy mercy",26.3008173339834,16,13,3,3.39431513487251,12.6056848651275
"1990","one lives",26.3008173339834,16,13,3,3.39431513487251,12.6056848651275
"1990","place stay",26.3008173339834,16,13,3,3.39431513487251,12.6056848651275
"1990","tight dont let",26.3008173339834,16,13,3,3.39431513487251,12.6056848651275
"1980","aint nothin gonna",26.2562644264086,16,12,4,2.69177164229725,13.3082283577028
"1980","dont mean nothin",26.2562644264086,16,12,4,2.69177164229725,13.3082283577028
"1980","im time",26.2562644264086,16,12,4,2.69177164229725,13.3082283577028
"1980","just two us",26.2562644264086,16,12,4,2.69177164229725,13.3082283577028
"1980","mean nothin",26.2562644264086,16,12,4,2.69177164229725,13.3082283577028
"1980","prisoner",26.2562644264086,16,12,4,2.69177164229725,13.3082283577028
"1980","yeah yeah youre",26.2562644264086,16,12,4,2.69177164229725,13.3082283577028
"1990","brokenhearted",26.2517313324087,18,14,4,3.81860452673157,14.1813954732684
"1990","love seems",26.2517313324087,18,14,4,3.81860452673157,14.1813954732684
"1990","man wont",26.2517313324087,18,14,4,3.81860452673157,14.1813954732684
"1990","say see",26.2517313324087,18,14,4,3.81860452673157,14.1813954732684
"2010","grande",26.2231249127873,22,14,8,3.38717992752604,18.612820072474
"2010","just now",26.2231249127873,22,14,8,3.38717992752604,18.612820072474
"2010","let love baby",26.2231249127873,22,14,8,3.38717992752604,18.612820072474
"2010","like baby baby baby",26.2231249127873,22,14,8,3.38717992752604,18.612820072474
"2010","like fuck",26.2231249127873,22,14,8,3.38717992752604,18.612820072474
"2010","diamonds",26.220160298306,193,58,135,29.7148057278421,163.285194272158
"1970","foot",26.2044772368388,79,29,50,10.8109834556047,68.1890165443953
"1960","baby im gonna",26.193482269695,34,12,22,2.03059129535771,31.9694087046423
"2010","worth",26.1794681705899,272,75,197,41.8778609221401,230.12213907786
"1970","give just little",26.1554516103376,21,13,8,2.87380572870506,18.1261942712949
"1970","love love dont",26.1554516103376,21,13,8,2.87380572870506,18.1261942712949
"1960","painted",26.1477656913313,40,13,27,2.38893093571496,37.611069064285
"1970","somebody love",26.1404210594619,55,23,32,7.52663405137039,47.4733659486296
"1970","worry bout",26.1404210594619,55,23,32,7.52663405137039,47.4733659486296
"1980","bad boy",26.1121504338821,77,32,45,12.9541510285555,64.0458489714445
"2000","lick",26.1036449071563,77,42,35,20.7195979153596,56.2804020846404
"1970","gonna put",26.1025766781245,27,15,12,3.69489307976364,23.3051069202364
"2010","back dont",26.1020433983183,50,23,27,7.69813619892281,42.3018638010772
"2000","know take",26.091077729557,25,19,6,6.72714218031156,18.2728578196884
"2000","lady youre",26.091077729557,25,19,6,6.72714218031156,18.2728578196884
"1990","gangsta lean",26.0860133758696,34,21,13,7.21291966160408,26.7870803383959
"1980","night youll",26.0740976448522,26,16,10,4.37412891873303,21.625871081267
"1980","wont give",26.0727102654691,70,30,40,11.7765009350505,58.2234990649496
"1960","sunny",26.0682765346214,53,15,38,3.16533348982232,49.8346665101777
"1970","tender",26.0677247707997,92,32,60,12.590006049565,79.409993950435
"1980","dont need",26.0649032837847,395,107,288,66.4531124192133,328.546887580787
"2010","wanna rock",26.0574382212977,87,33,54,13.3947569861257,73.6052430138743
"2000","oh boy",26.0508845289565,31,22,9,8.34165630358633,22.6583436964137
"1970","get sleep",26.0307971565187,24,14,10,3.28434940423435,20.7156505957656
"1970","huggin",26.0307971565187,24,14,10,3.28434940423435,20.7156505957656
"1990","baby dont know",26.0169115478904,47,26,21,9.97080070868799,37.029199291312
"2010","cant live without",26.0148454714809,91,34,57,14.0106078820395,76.9893921179605
"2010","song",26.0073097368861,816,181,635,125.63358276642,690.36641723358
"2000","like way move",25.9942853097099,27,20,7,7.26531355473648,19.7346864452635
"2010","condo",25.9798778008347,17,12,5,2.61736630763376,14.3826336923662
"2010","part youre",25.9798778008347,17,12,5,2.61736630763376,14.3826336923662
"2010","right now will",25.9798778008347,17,12,5,2.61736630763376,14.3826336923662
"2010","run",25.9772729344316,1088,231,857,167.51144368856,920.48855631144
"1970","air breathe",25.957526978793,11,9,2,1.50532681027408,9.49467318972592
"1970","can go way",25.957526978793,11,9,2,1.50532681027408,9.49467318972592
"1970","goodbye now",25.957526978793,11,9,2,1.50532681027408,9.49467318972592
"1970","knows way",25.957526978793,11,9,2,1.50532681027408,9.49467318972592
"1970","last song",25.957526978793,11,9,2,1.50532681027408,9.49467318972592
"1970","lets fall",25.957526978793,11,9,2,1.50532681027408,9.49467318972592
"1970","money honey",25.957526978793,11,9,2,1.50532681027408,9.49467318972592
"1970","mr big",25.957526978793,11,9,2,1.50532681027408,9.49467318972592
"2000","around comes around",25.9535025087234,16,14,2,4.3053709953994,11.6946290046006
"2000","cha know",25.9535025087234,16,14,2,4.3053709953994,11.6946290046006
"2000","earlier",25.9535025087234,16,14,2,4.3053709953994,11.6946290046006
"2000","goes well",25.9535025087234,16,14,2,4.3053709953994,11.6946290046006
"2000","let wont",25.9535025087234,16,14,2,4.3053709953994,11.6946290046006
"2000","tell gotta",25.9535025087234,16,14,2,4.3053709953994,11.6946290046006
"1970","youre best",25.9262531387446,37,18,19,5.06337199819462,31.9366280018054
"2010","road",25.9225153304704,370,95,275,56.9662078720288,313.033792127971
"1980","next time",25.8987047722302,50,24,26,8.4117863821789,41.5882136178211
"1970","oh yeah oh",25.8913929781274,88,31,57,12.0426144821926,75.9573855178074
"2000","back like",25.8609163210632,44,28,16,11.8397702373483,32.1602297626517
"2000","take ride",25.8609163210632,44,28,16,11.8397702373483,32.1602297626517
"1970","da da da da",25.8437069029962,191,53,138,26.1379473420317,164.862052657968
"2000","dat",25.7802378585057,350,138,212,94.1799905243618,255.820009475638
"1980","anticipating",25.769562864305,14,11,3,2.35530018701009,11.6446998129899
"1980","chance love",25.769562864305,14,11,3,2.35530018701009,11.6446998129899
"1980","love rain",25.769562864305,14,11,3,2.35530018701009,11.6446998129899
"1980","rule world",25.769562864305,14,11,3,2.35530018701009,11.6446998129899
"1980","sings song",25.769562864305,14,11,3,2.35530018701009,11.6446998129899
"1980","touch yeah",25.769562864305,14,11,3,2.35530018701009,11.6446998129899
"1990","like way",25.7600647456096,211,77,134,44.7625308411312,166.237469158869
"1980","girls just",25.7521877839308,21,14,7,3.53295028051514,17.4670497194849
"1980","l o v",25.7521877839308,21,14,7,3.53295028051514,17.4670497194849
"1980","love oh baby",25.7521877839308,21,14,7,3.53295028051514,17.4670497194849
"1980","o v",25.7521877839308,21,14,7,3.53295028051514,17.4670497194849
"1980","one really",25.7521877839308,21,14,7,3.53295028051514,17.4670497194849
"1980","step step step",25.7521877839308,21,14,7,3.53295028051514,17.4670497194849
"2000","huh",25.7489258198914,618,224,394,166.294954697302,451.705045302698
"1960","laugh",25.7459095330693,169,29,140,10.0932332033957,158.906766796604
"1990","got gun",25.7376913864329,27,18,9,5.72790679009735,21.2720932099026
"1990","just another day",25.7376913864329,27,18,9,5.72790679009735,21.2720932099026
"1970","taught",25.7317622511536,84,30,54,11.4952229148202,72.5047770851798
"1970","tree",25.7317622511536,84,30,54,11.4952229148202,72.5047770851798
"1970","da da",25.7168163754984,550,119,431,75.2663405137039,474.733659486296
"1980","come know",25.6972416060717,47,23,24,7.90707919924816,39.0929208007518
"2010","baby ooh baby",25.6914574918173,34,18,16,5.23473261526751,28.7652673847325
"2010","say bye",25.6914574918173,34,18,16,5.23473261526751,28.7652673847325
"2010","wont ever",25.6914574918173,34,18,16,5.23473261526751,28.7652673847325
"1960","delilah",25.6692871028435,19,9,10,1.13474219446461,17.8652578055354
"1960","love need love need",25.6692871028435,19,9,10,1.13474219446461,17.8652578055354
"1960","refrain",25.6692871028435,19,9,10,1.13474219446461,17.8652578055354
"2000","now im",25.6504972781128,555,204,351,149.342556402917,405.657443597083
"2010","take can",25.6431830038886,28,16,12,4.31095627139678,23.6890437286032
"2000","huh uh huh",25.6390723793135,58,34,24,15.6069698583228,42.3930301416772
"1990","snow",25.6324648854233,110,47,63,23.3359165522485,86.6640834477515
"2000","livin life",25.6176203305993,51,31,20,13.7233700478356,37.2766299521644
"2000","uh huh uh huh",25.6176203305993,51,31,20,13.7233700478356,37.2766299521644
"2010","like come",25.6125460675077,31,17,14,4.77284444333215,26.2271555566679
"1980","away key",25.5711386529171,12,10,2,2.01882873172294,9.98117126827706
"1980","days like",25.5711386529171,12,10,2,2.01882873172294,9.98117126827706
"1980","dead alive",25.5711386529171,12,10,2,2.01882873172294,9.98117126827706
"1980","dont want baby",25.5711386529171,12,10,2,2.01882873172294,9.98117126827706
"1980","hearts beat one",25.5711386529171,12,10,2,2.01882873172294,9.98117126827706
"1980","set got",25.5711386529171,12,10,2,2.01882873172294,9.98117126827706
"1980","temporary",25.5711386529171,12,10,2,2.01882873172294,9.98117126827706
"2000","tell one",25.5433923747789,42,27,15,11.3015988629234,30.6984011370766
"1960","love yes",25.5333647151812,54,15,39,3.22505676321519,50.7749432367848
"1980","youre angel",25.5332433842484,44,22,22,7.40237201631743,36.5976279836826
"2010","ooh ooh ooh",25.5302305685726,227,65,162,34.9495383431096,192.05046165689
"1980","dancer",25.5254022205868,57,26,31,9.58943647568394,47.4105635243161
"1960","come well",25.52451836709,11,7,4,0.656956007321613,10.3430439926784
"1960","easy say",25.52451836709,11,7,4,0.656956007321613,10.3430439926784
"1960","look whats",25.52451836709,11,7,4,0.656956007321613,10.3430439926784
"1960","lovin every",25.52451836709,11,7,4,0.656956007321613,10.3430439926784
"1960","please please please",25.52451836709,11,7,4,0.656956007321613,10.3430439926784
"1960","seen lot",25.52451836709,11,7,4,0.656956007321613,10.3430439926784
"1960","world behind",25.52451836709,11,7,4,0.656956007321613,10.3430439926784
"1960","magic",25.5221847966198,279,40,239,16.6627932766118,262.337206723388
"1960","born",25.5125480114198,300,42,258,17.9169820178622,282.083017982138
"2010","full",25.5068584545901,342,89,253,52.6552516006321,289.344748399368
"1970","da la da",25.4891759478691,52,22,30,7.11609037584109,44.8839096241589
"1960","love sweet love",25.4836627388691,24,10,14,1.43335856142897,22.566641438571
"1980","dont let",25.4734666543432,324,91,233,54.5083757565192,269.491624243481
"1980","lala la",25.4636735924248,32,18,14,5.38354328459449,26.6164567154055
"1960","world",25.4586687060512,2103,184,1919,125.598043945214,1977.40195605479
"1980","radio",25.4315122988046,180,58,122,30.282430975844,149.717569024156
"2000","bottom",25.4204529647886,152,70,82,40.9010244562943,111.098975543706
"1980","time time time",25.4149160264624,41,21,20,6.8976648333867,34.1023351666133
"2000","na na",25.4078271996629,1366,452,914,367.571048732224,998.428951267777
"1990","dance come",25.4020010504375,32,20,12,6.78863026974501,25.211369730255
"1990","start new",25.4020010504375,32,20,12,6.78863026974501,25.211369730255
"1990","well good",25.4020010504375,32,20,12,6.78863026974501,25.211369730255
"2000","actin",25.3965967925903,63,36,27,16.9523982943851,46.0476017056149
"1980","far",25.3950201531473,616,153,463,103.633208228444,512.366791771556
"2010","good life",25.3686938738095,44,21,23,6.77435985505208,37.2256401449479
"2010","now need",25.3686938738095,44,21,23,6.77435985505208,37.2256401449479
"1970","big ol",25.3523549641869,16,11,5,2.18956626948957,13.8104337305104
"1970","ladder",25.3523549641869,16,11,5,2.18956626948957,13.8104337305104
"1970","miscellaneous",25.3232719008635,89,31,58,12.1794623740357,76.8205376259643
"2010","got money",25.2979032768104,69,28,41,10.6234279545135,58.3765720454865
"2010","haters",25.2979032768104,69,28,41,10.6234279545135,58.3765720454865
"2000","whole life",25.2892746132449,88,46,42,23.6795404746967,64.3204595253033
"2010","ceiling",25.2888016590593,58,25,33,8.92983799075047,49.0701620092495
"2010","girls girls",25.2888016590593,58,25,33,8.92983799075047,49.0701620092495
"2010","hotter",25.2888016590593,58,25,33,8.92983799075047,49.0701620092495
"1970","can work",25.2876465650707,64,25,39,8.75826507795827,55.2417349220417
"2000","run run",25.2500170325858,68,38,30,18.2978267304474,49.7021732695526
"1980","new york city",25.2400893483619,54,25,29,9.08472929275321,44.9152707072468
"1990","thing youre",25.2354267745395,45,25,20,9.54651131682892,35.4534886831711
"1960","can need",25.2229714466635,15,8,7,0.895849100893109,14.1041508991069
"1960","come baby lets",25.2229714466635,15,8,7,0.895849100893109,14.1041508991069
"1960","dream last",25.2229714466635,15,8,7,0.895849100893109,14.1041508991069
"1960","love sure",25.2229714466635,15,8,7,0.895849100893109,14.1041508991069
"1960","must sent",25.2229714466635,15,8,7,0.895849100893109,14.1041508991069
"1960","whats game",25.2229714466635,15,8,7,0.895849100893109,14.1041508991069
"2010","turn",25.1960683707472,1733,345,1388,266.817400654665,1466.18259934534
"1960","riding",25.1694715737034,69,17,52,4.1209058641083,64.8790941358917
"1980","standing",25.1660568990801,307,87,220,51.6483683865784,255.351631613422
"1960","instrumental",25.1432736076165,48,14,34,2.86671712285795,45.1332828771421
"1970","fly high",25.1163968679548,31,16,15,4.24228464713604,26.757715352864
"2010","burnin burnin burnin",25.1030644033276,15,11,4,2.30944085967684,12.6905591403232
"2010","im pretty",25.1030644033276,15,11,4,2.30944085967684,12.6905591403232
"2010","low go",25.1030644033276,15,11,4,2.30944085967684,12.6905591403232
"2010","take side",25.1030644033276,15,11,4,2.30944085967684,12.6905591403232
"2010","bury",25.0899841694409,20,13,7,3.07925447956913,16.9207455204309
"2010","ill admit",25.0899841694409,20,13,7,3.07925447956913,16.9207455204309
"1960","boogaloo",25.0653638599317,8,6,2,0.477786187142992,7.52221381285701
"1960","cant stop stop",25.0653638599317,8,6,2,0.477786187142992,7.52221381285701
"1960","coming strong",25.0653638599317,8,6,2,0.477786187142992,7.52221381285701
"1960","courts",25.0653638599317,8,6,2,0.477786187142992,7.52221381285701
"1960","dont know many",25.0653638599317,8,6,2,0.477786187142992,7.52221381285701
"1960","homecoming",25.0653638599317,8,6,2,0.477786187142992,7.52221381285701
"1960","im glad made",25.0653638599317,8,6,2,0.477786187142992,7.52221381285701
"1960","sing dance",25.0653638599317,8,6,2,0.477786187142992,7.52221381285701
"1960","stars fall",25.0653638599317,8,6,2,0.477786187142992,7.52221381285701
"1960","tired tired",25.0653638599317,8,6,2,0.477786187142992,7.52221381285701
"1960","youre soul",25.0653638599317,8,6,2,0.477786187142992,7.52221381285701
"1990","lover",25.0598964223125,500,154,346,106.072347964766,393.927652035234
"2010","windows",25.0501722469488,41,20,21,6.31247168311671,34.6875283168833
"2010","getting",25.0481656270991,609,141,468,93.7632989028799,515.23670109712
"2000","always talkin bout",25.0423130608465,18,15,3,4.84354236982432,13.1564576301757
"2000","beverly",25.0423130608465,18,15,3,4.84354236982432,13.1564576301757
"2000","boy now",25.0423130608465,18,15,3,4.84354236982432,13.1564576301757
"2000","motel",25.0423130608465,18,15,3,4.84354236982432,13.1564576301757
"2000","telling everybody",25.0423130608465,18,15,3,4.84354236982432,13.1564576301757
"1980","emotional",25.0323505245812,24,15,9,4.03765746344587,19.9623425365541
"1980","l o",25.0323505245812,24,15,9,4.03765746344587,19.9623425365541
"1980","one wont",25.0323505245812,24,15,9,4.03765746344587,19.9623425365541
"1980","shes like",25.0323505245812,24,15,9,4.03765746344587,19.9623425365541
"1980","can dance",25.0109502790266,75,31,44,12.6176795732683,62.3823204267317
"2010","drinking",25.0018610516559,62,26,36,9.54568888666429,52.4543111133357
"1990","way love",24.9901579789375,227,81,146,48.1568459760037,178.843154023996
"2010","got one",24.9838979152264,109,38,71,16.7819369136517,92.2180630863483
"1980","excited",24.9773739738806,51,24,27,8.58002210982247,42.4199778901775
"2000","right way",24.9621320892784,38,25,13,10.2252561140736,27.7747438859264
"2010","dollars",24.9327050427581,81,31,50,12.470980642255,68.529019357745
"2000","give fuck",24.9267167097433,91,47,44,24.4867975363341,66.5132024636659
"1960","got babe",24.9073513779182,30,11,19,1.79169820178622,28.2083017982138
"2000","uh uh",24.8987921389931,227,96,131,61.0824509972289,165.917549002771
"1990","wanna fun",24.8810081516404,40,23,17,8.48578783718126,31.5142121628187
"1990","wanna make",24.8578248744416,161,62,99,34.1552960446546,126.844703955345
"1980","music make",24.8537078744738,19,13,6,3.19647882522798,15.803521174772
"1980","one look",24.8537078744738,19,13,6,3.19647882522798,15.803521174772
"1980","youre gonna lose",24.8537078744738,19,13,6,3.19647882522798,15.803521174772
"1970","back love",24.8493896819282,49,21,28,6.7055467003118,42.2944532996882
"1980","youre",24.8217790169187,6592,1263,5329,1109.00991662647,5482.99008337353
"1970","sad sad",24.8195672682814,28,15,13,3.83174097160674,24.1682590283933
"1990","just wont",24.8137963797449,68,33,35,14.4258393232082,53.5741606767919
"1970","lay lay",24.7853673135843,19,12,7,2.60010994501886,16.3998900549811
"1990","lied",24.7674292138519,77,36,41,16.3351415865739,60.6648584134261
"1960","little things",24.7596745118285,36,12,24,2.15003784214346,33.8499621578565
"1990","aww",24.7347275238715,30,19,11,6.36434087788595,23.6356591221141
"1990","dont wanna miss",24.7347275238715,30,19,11,6.36434087788595,23.6356591221141
"1970","let us",24.6972723188091,53,22,31,7.25293826768419,45.7470617323158
"1980","lets dance",24.6901610410446,58,26,32,9.75767220332752,48.2423277966725
"1990","back want back want",24.6865935823864,23,16,7,4.87932800637923,18.1206719936208
"1990","give try",24.6865935823864,23,16,7,4.87932800637923,18.1206719936208
"1990","personal",24.6859683412595,35,21,14,7.42506435753361,27.5749356424664
"1970","turnin",24.6490599024117,108,35,73,14.7795723190546,93.2204276809454
"1970","didnt get",24.62991260814,25,14,11,3.42119729607745,21.5788027039226
"1970","draggin",24.62991260814,25,14,11,3.42119729607745,21.5788027039226
"1970","yes im ready",24.62991260814,25,14,11,3.42119729607745,21.5788027039226
"2000","cant believe",24.6274186999521,145,67,78,39.017424645807,105.982575354193
"1980","whip",24.623062697662,182,58,124,30.6189024311312,151.381097568869
"2010","gaye",24.6096203706977,23,14,9,3.5411426515045,19.4588573484955
"2010","go thats",24.6096203706977,23,14,9,3.5411426515045,19.4588573484955
"2010","marvin gaye",24.6096203706977,23,14,9,3.5411426515045,19.4588573484955
"1970","angel",24.6017898756461,288,71,217,39.4121928508122,248.587807149188
"1970","know know know know",24.601212776325,65,25,40,8.89511296980137,56.1048870301986
"1970","ah ha",24.5928324687767,22,13,9,3.01065362054815,18.9893463794518
"1980","im head",24.5903334090191,27,16,11,4.5423646463766,22.4576353536234
"1960","got way",24.5851921843621,49,14,35,2.92644039625082,46.0735596037492
"1990","groove",24.5824448259243,297,100,197,63.0069746910709,233.993025308929
"2000","real",24.5806410043164,1354,447,907,364.342020485674,989.657979514326
"1960","ann",24.5538336247613,20,9,11,1.19446546785748,18.8055345321425
"2010","just watch",24.5504071654065,35,18,17,5.38869533924597,29.611304660754
"2010","love let love",24.5504071654065,35,18,17,5.38869533924597,29.611304660754
"2010","roll roll",24.5504071654065,35,18,17,5.38869533924597,29.611304660754
"2010","bones",24.5081728363912,59,25,34,9.08380071472892,49.9161992852711
"2010","im happy",24.5081728363912,59,25,34,9.08380071472892,49.9161992852711
"2000","lets make love",24.4987885496099,20,16,4,5.38171374424925,14.6182862557508
"2000","lovely lady",24.4987885496099,20,16,4,5.38171374424925,14.6182862557508
"2000","one blame",24.4987885496099,20,16,4,5.38171374424925,14.6182862557508
"2000","opportunity",24.4987885496099,20,16,4,5.38171374424925,14.6182862557508
"2000","meall",24.4753821292717,34,23,11,9.14891336522372,24.8510866347763
"2000","buy",24.4675652544847,225,95,130,60.544279622804,164.455720377196
"2010","love let",24.4658180830042,110,38,72,16.9358996376302,93.0641003623698
"2010","doesnt",24.4654691179855,341,88,253,52.5012888766536,288.498711123346
"1970","fool",24.4614162368593,381,88,293,52.1390467922203,328.86095320778
"1980","little girl",24.4508646630813,98,37,61,16.4871013090706,81.5128986909294
"1970","can count",24.4282876661235,35,17,18,4.78967621450843,30.2103237854916
"2000","pole",24.4020576687801,52,31,21,13.992455735048,38.007544264952
"2010","something baby",24.3949394879542,32,17,15,4.9268071673106,27.0731928326894
"2010","problem",24.3818172523799,127,42,85,19.5532659452639,107.446734054736
"1980","york city",24.3808131718459,55,25,30,9.25296502039679,45.7470349796032
"2010","find way make",24.3787386101378,13,10,3,2.00151541171993,10.9984845882801
"2010","goes baby",24.3787386101378,13,10,3,2.00151541171993,10.9984845882801
"2010","high youre",24.3787386101378,13,10,3,2.00151541171993,10.9984845882801
"2010","im turning",24.3787386101378,13,10,3,2.00151541171993,10.9984845882801
"2010","run night",24.3787386101378,13,10,3,2.00151541171993,10.9984845882801
"2010","yeah love love",24.3787386101378,13,10,3,2.00151541171993,10.9984845882801
"2010","yes please",24.3787386101378,13,10,3,2.00151541171993,10.9984845882801
"2010","youre feeling low",24.3787386101378,13,10,3,2.00151541171993,10.9984845882801
"2010","can go",24.3724358013392,198,58,140,30.4846193477343,167.515380652266
"1990","want know",24.3721634245415,305,102,203,64.7041322585071,240.295867741493
"2010","heart break",24.3717320190678,52,23,29,8.00606164687973,43.9939383531203
"2000","didnt want",24.349717544007,64,36,28,17.2214839815976,46.7785160184024
"2010","man im",24.3378835480672,102,36,66,15.7041978458025,86.2958021541975
"1980","around youre",24.336686256049,30,17,13,5.04707182930734,24.9529281706927
"1980","dont lose",24.336686256049,30,17,13,5.04707182930734,24.9529281706927
"1980","nineteen",24.336686256049,30,17,13,5.04707182930734,24.9529281706927
"1960","baby can",24.3343077372557,194,31,163,11.5863150382175,182.413684961782
"2010","place id rather",24.3287848512833,29,16,13,4.46491899537523,24.5350810046248
"1960","worst",24.3028811928705,71,17,54,4.24035241089405,66.759647589106
"1990","make",24.2906207596261,5520,1323,4197,1171.03872153101,4348.96127846899
"1980","playing",24.2831258656318,217,66,151,36.5071528986564,180.492847101344
"2000","get one",24.2795709862259,32,22,10,8.61074199079879,23.3892580092012
"2000","save life",24.2795709862259,32,22,10,8.61074199079879,23.3892580092012
"2000","go crazy",24.2643165953357,79,42,37,21.2577692897845,57.7422307102155
"1990","dont know need",24.2485685172626,21,15,6,4.45503861452016,16.5449613854798
"1990","might know",24.2485685172626,21,15,6,4.45503861452016,16.5449613854798
"1990","stab",24.2485685172626,21,15,6,4.45503861452016,16.5449613854798
"1980","surrender",24.2283393444827,62,27,35,10.4306151139018,51.5693848860982
"1980","ladies night",24.217585528259,33,18,15,5.55177901223807,27.4482209877619
"1960","much",24.2095599143445,1552,142,1410,92.6905203057404,1459.30947969426
"1970","across floor",24.2034712759462,14,10,4,1.91587048580337,12.0841295141966
"1970","inferno",24.2034712759462,14,10,4,1.91587048580337,12.0841295141966
"1970","just cant live",24.2034712759462,14,10,4,1.91587048580337,12.0841295141966
"1970","know easy",24.2034712759462,14,10,4,1.91587048580337,12.0841295141966
"1970","sung",24.2034712759462,14,10,4,1.91587048580337,12.0841295141966
"1980","baby youve",24.198369708966,36,19,17,6.05648619516881,29.9435138048312
"1980","came along",24.198369708966,36,19,17,6.05648619516881,29.9435138048312
"1980","can now",24.198369708966,36,19,17,6.05648619516881,29.9435138048312
"2000","armor",24.1850192767279,22,17,5,5.91988511867417,16.0801148813258
"2000","drill",24.1850192767279,22,17,5,5.91988511867417,16.0801148813258
"2000","ever like",24.1850192767279,22,17,5,5.91988511867417,16.0801148813258
"2000","lady im",24.1850192767279,22,17,5,5.91988511867417,16.0801148813258
"1980","apart",24.139739814368,279,80,199,46.9377680125582,232.062231987442
"1970","war",24.1371338087116,137,41,96,18.7481611825044,118.251838817496
"1980","bop bop",24.1259047041246,150,50,100,25.2353591465367,124.764640853463
"2000","wonder ill",24.124871923364,30,21,9,8.07257061637387,21.9274293836261
"1990","know really wanna",24.1236806915002,38,22,16,8.0614984453222,29.9385015546778
"1990","lets ride",24.1236806915002,38,22,16,8.0614984453222,29.9385015546778
"1990","la da da",24.1175754796183,46,25,21,9.75865601275846,36.2413439872415
"1960","mornin",24.1059255042429,112,22,90,6.68900662000188,105.310993379998
"2000","just cant stop",24.094149631888,57,33,24,15.3378841711103,41.6621158288897
"2000","let rock",24.094149631888,57,33,24,15.3378841711103,41.6621158288897
"1980","hall",24.0909159944713,52,24,28,8.74825783746605,43.251742162534
"1990","love will never",24.0879707092069,28,18,10,5.94005148602689,22.0599485139731
"1990","love woman",24.0879707092069,28,18,10,5.94005148602689,22.0599485139731
"1960","just wait",24.085482045774,37,12,25,2.20976111553634,34.7902388844637
"1980","voices",24.074834048158,80,32,48,13.4588582114862,66.5411417885138
"1960","spring",24.0434422350393,50,14,36,2.9861636696437,47.0138363303563
"2000","floss",24.0275363716427,24,18,6,6.45805649309909,17.5419435069009
"2000","shopping",24.0275363716427,24,18,6,6.45805649309909,17.5419435069009
"2000","without dont wanna",24.0275363716427,24,18,6,6.45805649309909,17.5419435069009
"2010","drug",24.024719622171,56,24,32,8.62191254279355,47.3780874572064
"1980","can without",24.0222864851525,17,12,5,2.86000736994083,14.1399926300592
"1980","im bad im",24.0222864851525,17,12,5,2.86000736994083,14.1399926300592
"1980","im winning",24.0222864851525,17,12,5,2.86000736994083,14.1399926300592
"1980","knock feet",24.0222864851525,17,12,5,2.86000736994083,14.1399926300592
"1980","now face",24.0222864851525,17,12,5,2.86000736994083,14.1399926300592
"2000","betta",24.0212641747792,28,20,8,7.53439924194894,20.4656007580511
"2000","things used",24.0212641747792,28,20,8,7.53439924194894,20.4656007580511
"1980","clover",24.012997210252,22,14,8,3.70118600815871,18.2988139918413
"1980","education",24.012997210252,22,14,8,3.70118600815871,18.2988139918413
"1980","really turn",24.012997210252,22,14,8,3.70118600815871,18.2988139918413
"1990","sweat",24.0117166620783,139,55,84,29.4881127342049,109.511887265795
"2010","already",24.010697630307,241,67,174,37.105016478808,203.894983521192
"1990","player",24.0103133494056,66,32,34,14.0015499313491,51.9984500686509
"2000","recognize",24.000719726756,50,30,20,13.4542843606231,36.5457156393769
"2010","belong youre",23.9968664385905,18,12,6,2.77132903161221,15.2286709683878
"2010","come put",23.9968664385905,18,12,6,2.77132903161221,15.2286709683878
"2010","eyes eyes",23.9968664385905,18,12,6,2.77132903161221,15.2286709683878
"2010","love sometimes",23.9968664385905,18,12,6,2.77132903161221,15.2286709683878
"2010","mind ooh",23.9968664385905,18,12,6,2.77132903161221,15.2286709683878
"2010","song im",23.9968664385905,18,12,6,2.77132903161221,15.2286709683878
"1970","como",23.9921675421047,32,16,16,4.37913253897913,27.6208674610209
"2000","like beat",23.9823955424316,26,19,7,6.99622786752402,19.003772132476
"2000","toes",23.9717060972836,87,45,42,23.4104547874842,63.5895452125158
"1990","us cause",23.9674051324429,33,20,13,7.00077496567454,25.9992250343255
"1990","wednesday",23.9674051324429,33,20,13,7.00077496567454,25.9992250343255
"2010","lips",23.9584637732536,338,87,251,52.0394007047182,285.960599295282
"1970","garden",23.9321579241424,54,22,32,7.38978615952729,46.6102138404727
"2010","home tell",23.9165081913534,11,9,2,1.69358996376302,9.30641003623698
"2010","money make",23.9165081913534,11,9,2,1.69358996376302,9.30641003623698
"2010","push limit",23.9165081913534,11,9,2,1.69358996376302,9.30641003623698
"2010","rim",23.9165081913534,11,9,2,1.69358996376302,9.30641003623698
"2010","sun just",23.9165081913534,11,9,2,1.69358996376302,9.30641003623698
"1970","mary",23.9149721759711,96,32,64,13.1373976169374,82.8626023830626
"1970","im back",23.902919039737,105,34,71,14.3690286435253,90.6309713564747
"1990","around will",23.9020723523015,13,11,2,2.75788104708391,10.2421189529161
"1990","cant dance cant",23.9020723523015,13,11,2,2.75788104708391,10.2421189529161
"1990","life beautiful",23.9020723523015,13,11,2,2.75788104708391,10.2421189529161
"1990","like money",23.9020723523015,13,11,2,2.75788104708391,10.2421189529161
"1990","love yous",23.9020723523015,13,11,2,2.75788104708391,10.2421189529161
"1990","night pray",23.9020723523015,13,11,2,2.75788104708391,10.2421189529161
"1990","shes high",23.9020723523015,13,11,2,2.75788104708391,10.2421189529161
"1990","just sweet",23.8973393042504,19,14,5,4.0307492226611,14.9692507773389
"1990","set heart",23.8973393042504,19,14,5,4.0307492226611,14.9692507773389
"1990","time fell",23.8973393042504,19,14,5,4.0307492226611,14.9692507773389
"1990","want us",23.8973393042504,19,14,5,4.0307492226611,14.9692507773389
"1960","di di",23.8931230622292,16,8,8,0.955572374285983,15.044427625714
"1960","everlasting love",23.8931230622292,16,8,8,0.955572374285983,15.044427625714
"1960","sigh",23.8931230622292,16,8,8,0.955572374285983,15.044427625714
"1990","roof",23.8818423327649,163,62,101,34.5795854365137,128.420414563486
"1990","strength",23.8611289224519,100,43,57,21.2144695929532,78.7855304070468
"1980","lose control",23.8390382965616,66,28,38,11.1035580244761,54.8964419755239
"1980","touch",23.8382984034025,942,217,725,158.47805544025,783.52194455975
"2000","boom boom",23.8374425769635,138,64,74,37.1338248353198,100.86617516468
"1960","care baby",23.7676411231935,12,7,5,0.716679280714487,11.2833207192855
"1960","clyde",23.7676411231935,12,7,5,0.716679280714487,11.2833207192855
"1960","think think think",23.7676411231935,12,7,5,0.716679280714487,11.2833207192855
"2010","youre ready",23.7524760986848,60,25,35,9.23776343870738,50.7622365612926
"2000","want go",23.719122251894,103,51,52,27.7158257828836,75.2841742171164
"1990","na nana",23.6794662578753,41,23,18,8.6979325331108,32.3020674668892
"1960","rivers",23.6740986057624,44,13,31,2.62782402928645,41.3721759707135
"1990","day make",23.6699655652182,17,13,4,3.60645983080204,13.393540169198
"2000","hell",23.6546472269487,402,153,249,108.17244625941,293.82755374059
"1970","love wont",23.6489803309403,101,33,68,13.8216370761529,87.1783629238471
"1980","love thats",23.6436066452956,111,40,71,18.6741657684371,92.3258342315629
"1990","cant live without love",23.6302532951883,15,12,3,3.18217043894297,11.817829561057
"1990","cry time",23.6302532951883,15,12,3,3.18217043894297,11.817829561057
"1990","girl youll never",23.6302532951883,15,12,3,3.18217043894297,11.817829561057
"1990","got show",23.6302532951883,15,12,3,3.18217043894297,11.817829561057
"1990","heart quit",23.6302532951883,15,12,3,3.18217043894297,11.817829561057
"1990","im far away",23.6302532951883,15,12,3,3.18217043894297,11.817829561057
"1990","son youre",23.6302532951883,15,12,3,3.18217043894297,11.817829561057
"1990","world seems",23.6302532951883,15,12,3,3.18217043894297,11.817829561057
"1970","keep comin",23.6135832774182,43,19,24,5.88445934925321,37.1155406507468
"1970","right right right",23.6135832774182,43,19,24,5.88445934925321,37.1155406507468
"1970","thing dont",23.6135832774182,43,19,24,5.88445934925321,37.1155406507468
"1970","well can",23.6135832774182,43,19,24,5.88445934925321,37.1155406507468
"2000","cause head",23.6044628315427,15,13,2,4.03628530818693,10.9637146918131
"2000","goes around comes around",23.6044628315427,15,13,2,4.03628530818693,10.9637146918131
"2000","gut",23.6044628315427,15,13,2,4.03628530818693,10.9637146918131
"2000","lexus",23.6044628315427,15,13,2,4.03628530818693,10.9637146918131
"2000","pockets full",23.6044628315427,15,13,2,4.03628530818693,10.9637146918131
"2000","popped",23.6044628315427,15,13,2,4.03628530818693,10.9637146918131
"2000","real big",23.6044628315427,15,13,2,4.03628530818693,10.9637146918131
"2000","right girl",23.6044628315427,15,13,2,4.03628530818693,10.9637146918131
"2000","ripe",23.6044628315427,15,13,2,4.03628530818693,10.9637146918131
"2000","support",23.6044628315427,15,13,2,4.03628530818693,10.9637146918131
"2000","wont let wont",23.6044628315427,15,13,2,4.03628530818693,10.9637146918131
"2000","world wish",23.6044628315427,15,13,2,4.03628530818693,10.9637146918131
"2000","can get",23.5915410886546,356,138,218,95.7945046476366,260.205495352363
"2010","makes wanna",23.553204393236,53,23,30,8.16002437085818,44.8399756291418
"1980","heart can",23.551850373031,56,25,31,9.42120074804036,46.5787992519596
"1960","believe magic",23.5204078899546,21,9,12,1.25418874125035,19.7458112587496
"1960","can catch",23.5204078899546,21,9,12,1.25418874125035,19.7458112587496
"1960","game love",23.5204078899546,21,9,12,1.25418874125035,19.7458112587496
"2000","daddy",23.5079779845602,344,134,210,92.565476401087,251.434523598913
"1980","home cause",23.5052150153018,25,15,10,4.20589319108945,20.7941068089106
"1980","miss ya",23.5052150153018,25,15,10,4.20589319108945,20.7941068089106
"2010","side",23.5010643998418,799,175,624,123.016216458787,675.983783541213
"2000","pants",23.4943614681519,85,44,41,22.8722834130593,62.1277165869407
"1990","bag",23.4859648000052,140,55,85,29.7002574301344,110.299742569866
"1990","cruel",23.4859648000052,140,55,85,29.7002574301344,110.299742569866
"1970","letter",23.4761320896955,88,30,58,12.0426144821926,75.9573855178074
"1990","love say",23.4750535053719,55,28,27,11.6679582761242,43.3320417238758
"1960","summertime",23.4717818866063,73,17,56,4.3597989576798,68.6402010423202
"1990","beat just",23.4667591688852,26,17,9,5.51576209416782,20.4842379058322
"1970","call us",23.4470035809908,17,11,6,2.32641416133266,14.6735858386673
"1970","deep blue",23.4470035809908,17,11,6,2.32641416133266,14.6735858386673
"1970","gently",23.4470035809908,17,11,6,2.32641416133266,14.6735858386673
"1970","gone far",23.4470035809908,17,11,6,2.32641416133266,14.6735858386673
"1970","two can",23.4470035809908,17,11,6,2.32641416133266,14.6735858386673
"1960","driver",23.4372502900178,38,12,26,2.26948438892921,35.7305156110708
"1960","na na nana",23.4372502900178,38,12,26,2.26948438892921,35.7305156110708
"2000","gettin",23.4262107129709,440,165,275,118.397702373483,321.602297626517
"1970","home take",23.418915022252,36,17,19,4.92652410635153,31.0734758936485
"1970","make know",23.418915022252,36,17,19,4.92652410635153,31.0734758936485
"2010","baby roll",23.4120390250306,21,13,8,3.23321720354758,17.7667827964524
"2010","mama mama",23.4120390250306,21,13,8,3.23321720354758,17.7667827964524
"1960","people",23.383395017235,972,97,875,58.0510217378735,913.948978262127
"1980","gonna stand",23.3780173713761,43,21,22,7.23413628867385,35.7658637113261
"1980","now youve",23.3780173713761,43,21,22,7.23413628867385,35.7658637113261
"1990","every morning",23.3717515410402,36,21,15,7.63720905346314,28.3627909465369
"1990","give world",23.3717515410402,36,21,15,7.63720905346314,28.3627909465369
"1990","stay stay",23.3717515410402,36,21,15,7.63720905346314,28.3627909465369
"1990","oh want",23.352724341304,58,29,29,12.3043923639128,45.6956076360872
"2000","phone",23.3393900213418,311,123,188,83.6856487230758,227.314351276924
"2000","hate",23.3386920664104,369,142,227,99.2926185813986,269.707381418601
"1970","good oh",23.3310761644274,26,14,12,3.55804518792055,22.4419548120795
"1970","woman like",23.3310761644274,26,14,12,3.55804518792055,22.4419548120795
"2000","seen",23.3284865230786,576,208,368,154.993355834378,421.006644165622
"2000","right im",23.319798042582,93,47,46,25.024968910759,67.975031089241
"2010","probably",23.310097913105,138,44,94,21.246855909027,116.753144090973
"1990","forgive",23.3012842647943,82,37,45,17.3958650662216,64.6041349337784
"2000","wanna go",23.296756830496,184,80,104,49.5117664470931,134.488233552907
"2010","youre gonna",23.2912474338632,421,103,318,64.8183067949301,356.18169320507
"1980","doesnt seem",23.2887556270167,15,11,4,2.52353591465367,12.4764640853463
"1980","dont use",23.2887556270167,15,11,4,2.52353591465367,12.4764640853463
"1980","like white",23.2887556270167,15,11,4,2.52353591465367,12.4764640853463
"1980","million girls",23.2887556270167,15,11,4,2.52353591465367,12.4764640853463
"1980","steal away",23.2887556270167,15,11,4,2.52353591465367,12.4764640853463
"1980","tell youre gonna",23.2887556270167,15,11,4,2.52353591465367,12.4764640853463
"1980","want touch",23.2887556270167,15,11,4,2.52353591465367,12.4764640853463
"1980","youre fooling",23.2887556270167,15,11,4,2.52353591465367,12.4764640853463
"1970","spark",23.2586120820995,51,21,30,6.97924248399799,44.020757516002
"2000","ah ah",23.254128476159,213,90,123,57.3152513762545,155.684748623746
"1980","im lost",23.2374378694192,53,24,29,8.91649356510963,44.0835064348904
"1980","wanna live",23.2323914522555,74,30,44,12.4494438456248,61.5505561543752
"2000","back around",23.2189759825502,46,28,18,12.3779416117733,33.6220583882267
"1980","gonna try",23.2145476063896,28,16,12,4.71060037402018,23.2893996259798
"1980","heart tell",23.2145476063896,28,16,12,4.71060037402018,23.2893996259798
"1980","nonstop",23.2145476063896,28,16,12,4.71060037402018,23.2893996259798
"1980","old song",23.2145476063896,28,16,12,4.71060037402018,23.2893996259798
"1980","thing called love",23.2145476063896,28,16,12,4.71060037402018,23.2893996259798
"1980","think might",23.2145476063896,28,16,12,4.71060037402018,23.2893996259798
"2000","six",23.2121271977735,128,60,68,34.4429679631952,93.5570320368048
"1980","shoo",23.2120394402258,40,20,20,6.72942910574312,33.2705708942569
"1990","give give give",23.2069418298046,64,31,33,13.57726053949,50.42273946051
"1970","easy im",23.1868770918607,12,9,3,1.64217470211718,10.3578252978828
"1970","love air",23.1868770918607,12,9,3,1.64217470211718,10.3578252978828
"1970","night didnt",23.1868770918607,12,9,3,1.64217470211718,10.3578252978828
"1970","reunion",23.1868770918607,12,9,3,1.64217470211718,10.3578252978828
"1970","go outside",23.1674088564991,20,12,8,2.73695783686196,17.263042163138
"1970","got brand",23.1674088564991,20,12,8,2.73695783686196,17.263042163138
"1970","got brand new",23.1674088564991,20,12,8,2.73695783686196,17.263042163138
"1970","mama dont",23.1674088564991,20,12,8,2.73695783686196,17.263042163138
"1970","right now baby",23.1674088564991,20,12,8,2.73695783686196,17.263042163138
"2010","aint never",23.1651606967298,96,34,62,14.7804215019318,81.2195784980682
"2010","baby baby oh",23.131813632277,24,14,10,3.69510537548295,20.3048946245171
"1980","china",23.0963497380842,37,19,18,6.22472192281238,30.7752780771876
"1970","come get",23.0940061411625,194,52,142,26.548491017561,167.451508982439
"1980","la lala",23.0746568225269,31,17,14,5.21530755695092,25.7846924430491
"1980","someone new",23.0746568225269,31,17,14,5.21530755695092,25.7846924430491
"1970","joy",23.0525581803623,169,47,122,23.1272937214836,145.872706278516
"2010","bee",23.048022214948,27,15,12,4.15699354741832,22.8430064525817
"2010","girl gotta",23.048022214948,27,15,12,4.15699354741832,22.8430064525817
"2010","nina",23.048022214948,27,15,12,4.15699354741832,22.8430064525817
"1970","love come get",23.0239951746834,40,18,22,5.47391567372392,34.5260843262761
"1980","arms tonight",23.0231390062769,20,13,7,3.36471455287156,16.6352854471284
"1980","never gonna let",23.0231390062769,20,13,7,3.36471455287156,16.6352854471284
"1980","want rock",23.0231390062769,20,13,7,3.36471455287156,16.6352854471284
"1980","woman dont",23.0231390062769,20,13,7,3.36471455287156,16.6352854471284
"1980","youre just like",23.0231390062769,20,13,7,3.36471455287156,16.6352854471284
"2010","chest",23.0205951184847,61,25,36,9.39172616268583,51.6082738373142
"1970","soon",23.0112540533397,294,71,223,40.2332802018708,253.766719798129
"1960","troubles",23.0059048438898,52,14,38,3.10561021642945,48.8943897835706
"1970","goodbye",22.9763179278705,410,92,318,56.1076356556702,353.89236434433
"2010","cant live",22.9682985736138,113,38,75,17.3977878095656,95.6022121904344
"1990","wrong",22.9682416065458,946,263,683,200.688882349337,745.311117650663
"2010","bout us",22.9601392778136,16,11,5,2.4634035836553,13.5365964163447
"2010","came like",22.9601392778136,16,11,5,2.4634035836553,13.5365964163447
"2010","name dont",22.9601392778136,16,11,5,2.4634035836553,13.5365964163447
"2010","youre sexy",22.9601392778136,16,11,5,2.4634035836553,13.5365964163447
"1980","mine mine",22.9426597603359,50,23,27,8.4117863821789,41.5882136178211
"1970","well im",22.9424954796759,89,30,59,12.1794623740357,76.8205376259643
"2000","see eyes",22.913711034939,78,41,37,20.9886836025721,57.0113163974279
"1990","ill right",22.905716679354,39,22,17,8.27364314125173,30.7263568587483
"1970","leave alone",22.9049546133195,121,37,84,16.5585949130148,104.441405086985
"2000","possibly",22.9045151828035,35,23,12,9.41799905243618,25.5820009475638
"2000","whatchu",22.9045151828035,35,23,12,9.41799905243618,25.5820009475638
"1970","oh yeah",22.8815518804231,542,115,427,74.1715573789591,467.828442621041
"1990","baby nobody",22.8779478990515,24,16,8,5.09147270230876,18.9085272976912
"2000","now go",22.8510427446838,73,39,34,19.6432551665097,53.3567448334902
"2010","fire",22.8447338856298,674,151,523,103.77087596148,570.22912403852
"2000","cant read",22.8405363717077,44,27,17,11.8397702373483,32.1602297626517
"1960","cab",22.8133229322968,39,12,27,2.32920766232208,36.6707923376779
"1980","want baby",22.8009673594992,82,32,50,13.7953296667734,68.2046703332266
"2010","die",22.7932842503967,516,121,395,79.4447655728835,436.555234427117
"2000","bows",22.7930910227979,17,14,3,4.57445668261186,12.4255433173881
"2000","move right",22.7930910227979,17,14,3,4.57445668261186,12.4255433173881
"2000","way gotta",22.7930910227979,17,14,3,4.57445668261186,12.4255433173881
"2010","now wanna",22.7636176968798,54,23,31,8.31398709483664,45.6860129051634
"2000","favorite",22.7599541656485,99,49,50,26.6394830340338,72.3605169659662
"1980","hold back",22.7516987129327,57,25,32,9.58943647568394,47.4105635243161
"1980","way say",22.7516987129327,57,25,32,9.58943647568394,47.4105635243161
"1960","anyway want",22.7286332585955,9,6,3,0.537509460535866,8.46249053946413
"1960","capture moment",22.7286332585955,9,6,3,0.537509460535866,8.46249053946413
"1960","dooby",22.7286332585955,9,6,3,0.537509460535866,8.46249053946413
"1960","glad made",22.7286332585955,9,6,3,0.537509460535866,8.46249053946413
"1960","let roll",22.7286332585955,9,6,3,0.537509460535866,8.46249053946413
"1960","like thank",22.7286332585955,9,6,3,0.537509460535866,8.46249053946413
"1960","rhythm got",22.7286332585955,9,6,3,0.537509460535866,8.46249053946413
"1960","session",22.7286332585955,9,6,3,0.537509460535866,8.46249053946413
"1960","suspicious",22.7286332585955,9,6,3,0.537509460535866,8.46249053946413
"1960","way groove",22.7286332585955,9,6,3,0.537509460535866,8.46249053946413
"2000","girl know",22.7257077612901,188,81,107,50.5881091959429,137.411890804057
"2010","age",22.7132741390816,69,27,42,10.6234279545135,58.3765720454865
"1980","guiding",22.7077123731983,13,10,3,2.18706445936651,10.8129355406335
"1980","live tell",22.7077123731983,13,10,3,2.18706445936651,10.8129355406335
"1980","oh dont want",22.7077123731983,13,10,3,2.18706445936651,10.8129355406335
"1980","show way feel",22.7077123731983,13,10,3,2.18706445936651,10.8129355406335
"1980","want let go",22.7077123731983,13,10,3,2.18706445936651,10.8129355406335
"1960","let rain",22.6963683025095,33,11,22,1.97086802196484,31.0291319780352
"1960","little prayer",22.6888483152349,17,8,9,1.01529564767886,15.9847043523211
"1960","piece heart",22.6888483152349,17,8,9,1.01529564767886,15.9847043523211
"2000","want come",22.675596672496,86,44,42,23.1413691002718,62.8586308997282
"1960","just little bit",22.6739673530117,75,17,58,4.47924550446555,70.5207544955345
"1990","youll never",22.6728200327531,176,65,111,37.3374664835976,138.662533516402
"2000","flo",22.6460819408479,33,22,11,8.87982767801125,24.1201723219887
"2010","care",22.6319708753628,702,156,546,108.081832232876,593.918167767124
"1990","tell gonna",22.6261921110815,34,20,14,7.21291966160408,26.7870803383959
"1970","hand",22.5966984320439,859,168,691,117.552339093221,741.447660906779
"1990","cry",22.5964659521685,899,251,648,190.718081640649,708.281918359351
"2000","gone",22.5861479897194,1359,445,914,365.687448921736,993.312551078264
"2010","sippin",22.579317884665,93,33,60,14.3185333299964,78.6814666700036
"2000","just just",22.5747527045247,56,32,24,15.0687984838979,40.9312015161021
"1990","around way",22.5671409420087,29,18,11,6.15219618195642,22.8478038180436
"1960","bit little",22.5585681397299,22,9,13,1.31391201464323,20.6860879853568
"1960","can mean",22.5585681397299,22,9,13,1.31391201464323,20.6860879853568
"1960","go now go now",22.5585681397299,22,9,13,1.31391201464323,20.6860879853568
"1960","little bit little",22.5585681397299,22,9,13,1.31391201464323,20.6860879853568
"1960","now go now",22.5585681397299,22,9,13,1.31391201464323,20.6860879853568
"1990","satisfy",22.5474579847073,56,28,28,11.8801029720538,44.1198970279462
"2010","say hey",22.5444049186871,89,32,57,13.7026824340826,75.2973175659174
"1990","buck",22.540307376411,42,23,19,8.91007722904033,33.0899227709597
"2010","club",22.5216183175374,612,139,473,94.2251870748153,517.774812925185
"2010","gonna good",22.5069050912612,58,24,34,8.92983799075047,49.0701620092495
"1970","floor dont",22.4926570707232,30,15,15,4.10543675529294,25.8945632447071
"1990","give love",22.4796506689772,219,77,142,46.4596884085674,172.540311591433
"1990","deeper",22.4615003612641,99,42,57,21.0023248970236,77.9976751029764
"1990","gonna come",22.4602616048502,59,29,30,12.5165370598424,46.4834629401576
"1970","island",22.4592914859009,37,17,20,5.06337199819462,31.9366280018054
"2010","let love let",22.4450408798279,37,18,19,5.69662078720288,31.3033792127971
"1980","away ive",22.4335213600518,23,14,9,3.86942173580229,19.1305782641977
"1980","baby dont want",22.4335213600518,23,14,9,3.86942173580229,19.1305782641977
"1980","ive love",22.4335213600518,23,14,9,3.86942173580229,19.1305782641977
"1980","movin keep",22.4335213600518,23,14,9,3.86942173580229,19.1305782641977
"2000","position",22.4332113527183,61,34,27,16.4142269199602,44.5857730800398
"2000","done",22.4270816999594,605,216,389,162.79684076354,442.20315923646
"1970","baby dance",22.402772898327,10,8,2,1.36847891843098,8.63152108156902
"1970","better hurry",22.402772898327,10,8,2,1.36847891843098,8.63152108156902
"1970","know dont come",22.402772898327,10,8,2,1.36847891843098,8.63152108156902
"1970","lady whos",22.402772898327,10,8,2,1.36847891843098,8.63152108156902
"1970","lets fall love",22.402772898327,10,8,2,1.36847891843098,8.63152108156902
"1970","still free",22.402772898327,10,8,2,1.36847891843098,8.63152108156902
"1970","vehicle",22.402772898327,10,8,2,1.36847891843098,8.63152108156902
"1980","cold day",22.3887644937852,11,9,2,1.85059300407936,9.14940699592064
"1980","dont want let go",22.3887644937852,11,9,2,1.85059300407936,9.14940699592064
"1980","em turn",22.3887644937852,11,9,2,1.85059300407936,9.14940699592064
"1980","good woman",22.3887644937852,11,9,2,1.85059300407936,9.14940699592064
"1980","ill never go",22.3887644937852,11,9,2,1.85059300407936,9.14940699592064
"1980","looking can",22.3887644937852,11,9,2,1.85059300407936,9.14940699592064
"1980","really wanna know really",22.3887644937852,11,9,2,1.85059300407936,9.14940699592064
"1980","theyre coming",22.3887644937852,11,9,2,1.85059300407936,9.14940699592064
"1980","wanna know really",22.3887644937852,11,9,2,1.85059300407936,9.14940699592064
"2000","type",22.3787553569556,146,66,80,39.2865103330195,106.71348966698
"1990","changes",22.3663026089295,68,32,36,14.4258393232082,53.5741606767919
"1960","hey hey hey",22.3539164702699,297,40,257,17.7378121976836,279.262187802316
"1980","believe love",22.3474425891626,61,26,35,10.2623793862583,50.7376206137417
"1990","rhythm",22.3414902059652,252,86,166,53.460463374242,198.539536625758
"2000","baby cause im",22.332614384278,19,15,4,5.11262805703678,13.8873719429632
"2000","cant leave alone",22.332614384278,19,15,4,5.11262805703678,13.8873719429632
"2000","oh yeah theres",22.332614384278,19,15,4,5.11262805703678,13.8873719429632
"2000","want real",22.332614384278,19,15,4,5.11262805703678,13.8873719429632
"1990","ever felt",22.3311530704408,22,15,7,4.6671833104497,17.3328166895503
"1990","kind man",22.3311530704408,22,15,7,4.6671833104497,17.3328166895503
"2000","ride",22.3239561201612,898,306,592,241.638947116791,656.361052883209
"2010","spinnin",22.2859087127684,51,22,29,7.85209892290127,43.1479010770987
"2010","know know",22.2547059749799,390,96,294,60.045462351598,329.954537648402
"1960","bottle wine",22.2466140445706,13,7,6,0.776402554107361,12.2235974458926
"1960","cant walk",22.2466140445706,13,7,6,0.776402554107361,12.2235974458926
"1960","five oclock",22.2466140445706,13,7,6,0.776402554107361,12.2235974458926
"1960","im ready ready",22.2466140445706,13,7,6,0.776402554107361,12.2235974458926
"1960","work can",22.2466140445706,13,7,6,0.776402554107361,12.2235974458926
"1990","fear",22.2415262491326,184,67,117,39.0346240510338,144.965375948966
"2010","calling calling",22.2375806882763,19,12,7,2.92529175559067,16.0747082444093
"2010","cooler",22.2375806882763,19,12,7,2.92529175559067,16.0747082444093
"2010","lover dont",22.2375806882763,19,12,7,2.92529175559067,16.0747082444093
"2010","night till",22.2375806882763,19,12,7,2.92529175559067,16.0747082444093
"2010","good night",22.2341865573451,44,20,24,6.77435985505208,37.2256401449479
"2000","life complete",22.2274544210936,29,20,9,7.80348492916141,21.1965150708386
"2000","mommas",22.2274544210936,29,20,9,7.80348492916141,21.1965150708386
"1980","dont wanna live",22.2185501514119,41,20,21,6.8976648333867,34.1023351666133
"1980","get yeah",22.2185501514119,41,20,21,6.8976648333867,34.1023351666133
"1970","gets",22.2153033988631,352,81,271,48.1704579287705,303.82954207123
"2010","good",22.2045845899974,2885,538,2347,444.182458677846,2440.81754132215
"1980","away dont",22.1877094212684,83,32,51,13.963565394417,69.036434605583
"2010","open eyes",22.1666264808773,66,26,40,10.1615397825781,55.8384602174219
"2010","get good",22.1660366935043,34,17,17,5.23473261526751,28.7652673847325
"1970","help find",22.1539234041356,15,10,5,2.05271837764647,12.9472816223535
"1970","knock knock knock",22.1539234041356,15,10,5,2.05271837764647,12.9472816223535
"1970","let life",22.1539234041356,15,10,5,2.05271837764647,12.9472816223535
"1970","ramblin man",22.1539234041356,15,10,5,2.05271837764647,12.9472816223535
"1970","stop love",22.1539234041356,15,10,5,2.05271837764647,12.9472816223535
"1980","choice",22.1467508182351,72,29,43,12.1129723903376,59.8870276096624
"1980","well make",22.1467508182351,72,29,43,12.1129723903376,59.8870276096624
"1970","just enough",22.1426367156667,41,18,23,5.61076356556702,35.389236434433
"1990","never",22.139390141988,4753,1143,3610,1008.32373975306,3744.67626024694
"1980","love yeah",22.1363046466489,110,39,71,18.5059300407936,91.4940699592064
"2000","coke",22.114982819523,40,25,15,10.7634274884985,29.2365725115015
"2000","ready",22.1126534232797,571,205,366,153.647927398316,417.352072601684
"1980","time time time time",22.0983928328783,26,15,11,4.37412891873303,21.625871081267
"1980","wow wow",22.0983928328783,26,15,11,4.37412891873303,21.625871081267
"1980","better love",22.0954199804472,51,23,28,8.58002210982247,42.4199778901775
"2000","call im",22.0890794333116,21,16,5,5.65079943146171,15.3492005685383
"2000","got trippin",22.0890794333116,21,16,5,5.65079943146171,15.3492005685383
"2000","like yall",22.0890794333116,21,16,5,5.65079943146171,15.3492005685383
"2000","one shot",22.0890794333116,21,16,5,5.65079943146171,15.3492005685383
"2000","way let",22.0890794333116,21,16,5,5.65079943146171,15.3492005685383
"2000","youre gone youre",22.0890794333116,21,16,5,5.65079943146171,15.3492005685383
"2000","play song",22.0834654259618,27,19,8,7.26531355473648,19.7346864452635
"1960","dont seem",22.0792205370716,28,10,18,1.67225165500047,26.3277483449995
"1960","know place",22.0792205370716,28,10,18,1.67225165500047,26.3277483449995
"1960","love hold",22.0792205370716,28,10,18,1.67225165500047,26.3277483449995
"1960","oh lets",22.0792205370716,28,10,18,1.67225165500047,26.3277483449995
"1980","boys will",22.0733038147978,18,12,6,3.0282430975844,14.9717569024156
"1980","nothin gonna",22.0733038147978,18,12,6,3.0282430975844,14.9717569024156
"1980","one moment",22.0733038147978,18,12,6,3.0282430975844,14.9717569024156
"1990","ill never",22.0546150285968,286,95,191,60.6733830358461,225.326616964154
"1980","sensation",22.0514374682145,38,19,19,6.39295765045596,31.607042349544
"1980","time wont",22.0514374682145,38,19,19,6.39295765045596,31.607042349544
"1980","trigger",22.0514374682145,38,19,19,6.39295765045596,31.607042349544
"2010","doesnt mean im",22.0068815495718,14,10,4,2.15547813569839,11.8445218643016
"2010","feeling never",22.0068815495718,14,10,4,2.15547813569839,11.8445218643016
"2010","going like",22.0068815495718,14,10,4,2.15547813569839,11.8445218643016
"2010","got stay",22.0068815495718,14,10,4,2.15547813569839,11.8445218643016
"2010","hard im",22.0068815495718,14,10,4,2.15547813569839,11.8445218643016
"2010","like girl like",22.0068815495718,14,10,4,2.15547813569839,11.8445218643016
"2010","meant just",22.0068815495718,14,10,4,2.15547813569839,11.8445218643016
"2010","need light",22.0068815495718,14,10,4,2.15547813569839,11.8445218643016
"2010","ones ever",22.0068815495718,14,10,4,2.15547813569839,11.8445218643016
"2010","running time",22.0068815495718,14,10,4,2.15547813569839,11.8445218643016
"2010","yelling",22.0068815495718,14,10,4,2.15547813569839,11.8445218643016
"2010","youre missing",22.0068815495718,14,10,4,2.15547813569839,11.8445218643016
"2000","sun goes",22.0023259134082,47,28,19,12.6470272989857,34.3529727010143
"2000","werent",22.0023259134082,47,28,19,12.6470272989857,34.3529727010143
"2010","doesnt mean",22.0015191690639,55,23,32,8.4679498188151,46.5320501811849
"2000","hit em",21.9988755315157,25,18,7,6.72714218031156,18.2728578196884
"2000","shake like",21.9988755315157,25,18,7,6.72714218031156,18.2728578196884
"2000","wait til",21.9988755315157,25,18,7,6.72714218031156,18.2728578196884
"2010","byamandah",21.9969847128126,74,28,46,11.3932415744058,62.6067584255942
"2010","byamandah editor",21.9969847128126,74,28,46,11.3932415744058,62.6067584255942
"2010","cant even",21.9969847128126,74,28,46,11.3932415744058,62.6067584255942
"2000","hotel room",21.9918058886925,23,17,6,6.18897080588663,16.8110291941134
"2000","ill lover",21.9918058886925,23,17,6,6.18897080588663,16.8110291941134
"2000","know hey",21.9918058886925,23,17,6,6.18897080588663,16.8110291941134
"2000","must know",21.9918058886925,23,17,6,6.18897080588663,16.8110291941134
"2000","tock",21.9918058886925,23,17,6,6.18897080588663,16.8110291941134
"1990","holdin",21.9851424598464,103,43,60,21.8509036807418,81.1490963192582
"1970","jungle",21.9830965816255,82,28,54,11.221527131134,70.778472868866
"2000","spit",21.9808480856554,59,33,26,15.8760555455353,43.1239444544647
"1980","night can",21.9789677098923,58,25,33,9.75767220332752,48.2423277966725
"2000","dick",21.9709322056254,158,70,88,42.515538579569,115.484461420431
"2010","truck",21.9498718791698,82,30,52,12.6249433662334,69.3750566337666
"2010","alcohol",21.9463264869077,31,16,15,4.77284444333215,26.2271555566679
"2010","heart beats",21.9463264869077,31,16,15,4.77284444333215,26.2271555566679
"2010","place id",21.9463264869077,31,16,15,4.77284444333215,26.2271555566679
"1970","love right",21.9291157606765,100,32,68,13.6847891843098,86.3152108156902
"1970","good youre",21.9259512132705,34,16,18,4.65282832266533,29.3471716773347
"1970","burn burn",21.9231167299267,65,24,41,8.89511296980137,56.1048870301986
"1970","thats im",21.9231167299267,65,24,41,8.89511296980137,56.1048870301986
"1960","roses",21.9074318893973,77,17,60,4.59869205125129,72.4013079487487
"1990","lookin girl",21.8911295101201,27,17,10,5.72790679009735,21.2720932099026
"1990","ride train",21.8911295101201,27,17,10,5.72790679009735,21.2720932099026
"1990","young im",21.8911295101201,27,17,10,5.72790679009735,21.2720932099026
"1980","like dream",21.8910789348628,32,17,15,5.38354328459449,26.6164567154055
"1980","winds",21.8910789348628,32,17,15,5.38354328459449,26.6164567154055
"2010","bad bitch",21.8894749045338,22,13,9,3.38717992752604,18.612820072474
"2010","dont run",21.8894749045338,22,13,9,3.38717992752604,18.612820072474
"2010","end night",21.8894749045338,22,13,9,3.38717992752604,18.612820072474
"2010","goin home",21.8894749045338,22,13,9,3.38717992752604,18.612820072474
"2010","like glue",21.8894749045338,22,13,9,3.38717992752604,18.612820072474
"2010","say let",21.8894749045338,22,13,9,3.38717992752604,18.612820072474
"2010","trash",21.8894749045338,22,13,9,3.38717992752604,18.612820072474
"2010","treat good",21.8894749045338,22,13,9,3.38717992752604,18.612820072474
"2010","youre giving",21.8894749045338,22,13,9,3.38717992752604,18.612820072474
"1990","door baby",21.8882232578994,32,19,13,6.78863026974501,25.211369730255
"1990","feel real",21.8882232578994,32,19,13,6.78863026974501,25.211369730255
"1990","feelings",21.8719152852753,246,84,162,52.1875951986648,193.812404801335
"1990","dont walk away",21.8403457373338,20,14,6,4.24289391859063,15.7571060814094
"1990","party party",21.8403457373338,20,14,6,4.24289391859063,15.7571060814094
"1990","quiero",21.8403457373338,20,14,6,4.24289391859063,15.7571060814094
"1990","wanna baby",21.8403457373338,20,14,6,4.24289391859063,15.7571060814094
"2010","im doin",21.8377822782952,41,19,22,6.31247168311671,34.6875283168833
"1970","afternoon",21.8250020087801,49,20,29,6.7055467003118,42.2944532996882
"1970","whiskey",21.8250020087801,49,20,29,6.7055467003118,42.2944532996882
"1990","strong",21.8182848090584,470,143,327,99.7080070868799,370.29199291312
"2010","kill",21.807618647242,146,45,101,22.4785577008546,123.521442299145
"2000","bust",21.7974273619378,122,57,65,32.8284538399204,89.1715461600796
"1980","works",21.7954357896502,48,22,26,8.07531492689174,39.9246850731083
"2010","momma",21.7931042284626,164,49,115,25.2498867324668,138.750113267533
"1990","way feel",21.7909289504709,171,63,108,36.2767430039499,134.72325699605
"2010","harder",21.7840821352225,155,47,108,23.8642222166607,131.135777783339
"2010","jeans",21.7840821352225,155,47,108,23.8642222166607,131.135777783339
"1970","laughter",21.7777960562023,53,21,32,7.25293826768419,45.7470617323158
"2000","checkin",21.7713139077808,38,24,14,10.2252561140736,27.7747438859264
"2010","fire fire",21.7709841049624,25,14,11,3.84906809946141,21.1509319005386
"2010","like baby baby",21.7709841049624,25,14,11,3.84906809946141,21.1509319005386
"1970","tennessee",21.7588311473246,18,11,7,2.46326205317576,15.5367379468242
"1970","theres new",21.7588311473246,18,11,7,2.46326205317576,15.5367379468242
"1960","long",21.7468455239801,1918,166,1752,114.549238367532,1803.45076163247
"1980","dance night",21.741669239688,80,31,49,13.4588582114862,66.5411417885138
"2000","pull",21.7061950532922,282,112,170,75.8821637939144,206.117836206086
"1970","rolling",21.7037055708643,148,42,106,20.2534879927785,127.746512007221
"1970","night couldnt",21.7000638360962,21,12,9,2.87380572870506,18.1261942712949
"1970","one ive",21.7000638360962,21,12,9,2.87380572870506,18.1261942712949
"1970","youre goin",21.7000638360962,21,12,9,2.87380572870506,18.1261942712949
"1960","better take",21.6597862040516,23,9,14,1.3736352880361,21.6263647119639
"1960","subway",21.6597862040516,23,9,14,1.3736352880361,21.6263647119639
"1960","na nana",21.6325134637767,41,12,29,2.44865420910783,38.5513457908922
"1980","oh dont",21.6201726922905,119,41,78,20.0200515895858,98.9799484104142
"1990","yall",21.6086005844405,621,181,440,131.741856172239,489.258143827761
"2000","im scared",21.6006477540804,45,27,18,12.1088559245608,32.8911440754392
"1960","heaven must",21.5895403107828,18,8,10,1.07501892107173,16.9249810789283
"1960","im hungry",21.5895403107828,18,8,10,1.07501892107173,16.9249810789283
"1960","leave girl",21.5895403107828,18,8,10,1.07501892107173,16.9249810789283
"1960","sha la",21.5895403107828,18,8,10,1.07501892107173,16.9249810789283
"1960","sha la la",21.5895403107828,18,8,10,1.07501892107173,16.9249810789283
"1960","sha la la la",21.5895403107828,18,8,10,1.07501892107173,16.9249810789283
"2000","ever seen",21.5862490718495,77,40,37,20.7195979153596,56.2804020846404
"1990","ill ever",21.5840965058135,69,32,37,14.6379840191377,54.3620159808623
"1990","love",21.5752767196287,15283,3479,11804,3242.20738789103,12040.792612109
"1960","come let",21.5716082686397,70,16,54,4.18062913750118,65.8193708624988
"1960","love sweet",21.5716082686397,70,16,54,4.18062913750118,65.8193708624988
"1990","got need",21.568179120871,66,31,35,14.0015499313491,51.9984500686509
"1960","message",21.5353159678497,78,17,61,4.65841532464417,73.3415846753558
"2000","got thing",21.5304230109753,57,32,25,15.3378841711103,41.6621158288897
"2000","uh huh uh",21.5304230109753,57,32,25,15.3378841711103,41.6621158288897
"1980","line",21.5300935793056,461,117,344,77.5566704436894,383.443329556311
"2010","aint gotta",21.5091782883252,67,26,41,10.3155025065566,56.6844974934434
"1960","peace mind",21.5072954258697,48,13,35,2.86671712285795,45.1332828771421
"2010","ooooh",21.5058449964059,52,22,30,8.00606164687973,43.9939383531203
"2000","underneath",21.4914889345697,72,38,34,19.3741694792973,52.6258305207027
"1980","dreamin",21.4652360056871,88,33,55,14.8047440326349,73.1952559673651
"1990","like nobody",21.4588367569251,43,23,20,9.12222192496986,33.8777780750301
"2000","go know",21.4503389323925,62,34,28,16.6833126071727,45.3166873928273
"1980","baby love",21.4477326768876,270,76,194,45.423646463766,224.576353536234
"2000","crash",21.4433577078544,36,23,13,9.68708473964864,26.3129152603514
"2000","just live",21.4433577078544,36,23,13,9.68708473964864,26.3129152603514
"2000","aint gotta",21.4424495955549,67,36,31,18.028741043235,48.971258956765
"1960","hide",21.4339593910147,358,45,313,21.3809318746489,336.619068125351
"1990","ive said",21.4267418747721,18,13,5,3.81860452673157,14.1813954732684
"1990","sweeter sweeter",21.4267418747721,18,13,5,3.81860452673157,14.1813954732684
"1990","yeah everybody",21.4267418747721,18,13,5,3.81860452673157,14.1813954732684
"1990","coming",21.3991579789758,614,179,435,130.256843300732,483.743156699268
"1990","ever ever",21.3881526367604,104,43,61,22.0630483766713,81.9369516233287
"1980","big big",21.379222553756,21,13,8,3.53295028051514,17.4670497194849
"1980","chance dont",21.379222553756,21,13,8,3.53295028051514,17.4670497194849
"1980","dance hall",21.379222553756,21,13,8,3.53295028051514,17.4670497194849
"1980","dont stop keep",21.379222553756,21,13,8,3.53295028051514,17.4670497194849
"1980","much late",21.379222553756,21,13,8,3.53295028051514,17.4670497194849
"1980","thats ill",21.379222553756,21,13,8,3.53295028051514,17.4670497194849
"1960","youll ever",21.3785431921127,35,11,24,2.09031456875059,32.9096854312494
"2010","never told",21.3748413672428,45,20,25,6.92832257903053,38.0716774209695
"1960","love love love",21.3742286964438,381,47,334,22.754567162685,358.245432837315
"2000","stare",21.3212653125658,93,46,47,25.024968910759,67.975031089241
"1970","sun",21.3133367632893,675,136,539,92.3723269940911,582.627673005909
"2000","ohh",21.3056480061434,188,80,108,50.5881091959429,137.411890804057
"2000","boy stay",21.2759891157337,14,12,2,3.76719962097447,10.2328003790255
"2000","fine ooh",21.2759891157337,14,12,2,3.76719962097447,10.2328003790255
"2000","flick",21.2759891157337,14,12,2,3.76719962097447,10.2328003790255
"2000","gone let",21.2759891157337,14,12,2,3.76719962097447,10.2328003790255
"2000","noticing",21.2759891157337,14,12,2,3.76719962097447,10.2328003790255
"2000","something keeps",21.2759891157337,14,12,2,3.76719962097447,10.2328003790255
"2000","time gave",21.2759891157337,14,12,2,3.76719962097447,10.2328003790255
"2000","time gone",21.2759891157337,14,12,2,3.76719962097447,10.2328003790255
"2000","without girl",21.2759891157337,14,12,2,3.76719962097447,10.2328003790255
"2010","drum",21.265565177615,56,23,33,8.62191254279355,47.3780874572064
"2000","twenty",21.2397454942219,80,41,39,21.526854976997,58.473145023003
"1970","come home",21.2366724508548,79,27,52,10.8109834556047,68.1890165443953
"1990","keep coming back",21.23659989804,25,16,9,5.30361739823829,19.6963826017617
"1990","never turned",21.23659989804,25,16,9,5.30361739823829,19.6963826017617
"1990","say love just",21.23659989804,25,16,9,5.30361739823829,19.6963826017617
"2000","boy dont",21.2063925991915,43,26,17,11.5706845501359,31.4293154498641
"2000","cause every",21.2063925991915,43,26,17,11.5706845501359,31.4293154498641
"2000","im real",21.2063925991915,43,26,17,11.5706845501359,31.4293154498641
"1960","simple",21.2024294242009,131,23,108,7.82374881446649,123.176251185534
"1970","belong belong",21.1934191848988,62,23,39,8.48456929427207,53.5154307057279
"1970","mile",21.1934191848988,62,23,39,8.48456929427207,53.5154307057279
"1970","sorrow",21.1934191848988,62,23,39,8.48456929427207,53.5154307057279
"1980","giving",21.1875853628942,235,68,167,39.5353959962408,195.464604003759
"2010","can smell",21.1859133254852,12,9,3,1.84755268774148,10.1524473122585
"2010","debut",21.1859133254852,12,9,3,1.84755268774148,10.1524473122585
"2010","die ill",21.1859133254852,12,9,3,1.84755268774148,10.1524473122585
"2010","esto",21.1859133254852,12,9,3,1.84755268774148,10.1524473122585
"2010","gets little",21.1859133254852,12,9,3,1.84755268774148,10.1524473122585
"2010","girl like girl",21.1859133254852,12,9,3,1.84755268774148,10.1524473122585
"2010","girl like girl like",21.1859133254852,12,9,3,1.84755268774148,10.1524473122585
"2010","head let",21.1859133254852,12,9,3,1.84755268774148,10.1524473122585
"2010","im gonna find way",21.1859133254852,12,9,3,1.84755268774148,10.1524473122585
"2010","im gonna lose",21.1859133254852,12,9,3,1.84755268774148,10.1524473122585
"2010","oh oh cant",21.1859133254852,12,9,3,1.84755268774148,10.1524473122585
"2010","revenge",21.1859133254852,12,9,3,1.84755268774148,10.1524473122585
"2010","sky cause",21.1859133254852,12,9,3,1.84755268774148,10.1524473122585
"2010","tell wrong",21.1859133254852,12,9,3,1.84755268774148,10.1524473122585
"1960","hungry",21.1799350763829,71,16,55,4.24035241089405,66.759647589106
"1980","ive got much",21.1798591933922,16,11,5,2.69177164229725,13.3082283577028
"1980","life around",21.1798591933922,16,11,5,2.69177164229725,13.3082283577028
"1980","say ooh ooh",21.1798591933922,16,11,5,2.69177164229725,13.3082283577028
"1980","senorita",21.1798591933922,16,11,5,2.69177164229725,13.3082283577028
"1980","talking sleep",21.1798591933922,16,11,5,2.69177164229725,13.3082283577028
"1980","will know will",21.1798591933922,16,11,5,2.69177164229725,13.3082283577028
"1960","every day",21.1673662845561,209,31,178,12.4821641391107,196.517835860889
"1990","enough never",21.1500284913924,12,10,2,2.54573635115438,9.45426364884562
"1990","friends will",21.1500284913924,12,10,2,2.54573635115438,9.45426364884562
"1990","know whos",21.1500284913924,12,10,2,2.54573635115438,9.45426364884562
"1990","let friends",21.1500284913924,12,10,2,2.54573635115438,9.45426364884562
"1990","mcs",21.1500284913924,12,10,2,2.54573635115438,9.45426364884562
"1990","right money",21.1500284913924,12,10,2,2.54573635115438,9.45426364884562
"1990","say bye bye bye",21.1500284913924,12,10,2,2.54573635115438,9.45426364884562
"1990","someone know",21.1500284913924,12,10,2,2.54573635115438,9.45426364884562
"1990","sweet low",21.1500284913924,12,10,2,2.54573635115438,9.45426364884562
"1990","wishful",21.1500284913924,12,10,2,2.54573635115438,9.45426364884562
"1990","woman baby",21.1500284913924,12,10,2,2.54573635115438,9.45426364884562
"1990","wrong yeah",21.1500284913924,12,10,2,2.54573635115438,9.45426364884562
"2010","sing along",21.1427013672058,35,17,18,5.38869533924597,29.611304660754
"2000","like now",21.1340470076284,34,22,12,9.14891336522372,24.8510866347763
"2000","yep",21.1340470076284,34,22,12,9.14891336522372,24.8510866347763
"1960","bop bop",21.1285763725179,150,25,125,8.95849100893109,141.041508991069
"1990","alone alone",21.1244830340547,16,12,4,3.39431513487251,12.6056848651275
"1990","arms one",21.1244830340547,16,12,4,3.39431513487251,12.6056848651275
"1990","boy wants",21.1244830340547,16,12,4,3.39431513487251,12.6056848651275
"1990","days dont",21.1244830340547,16,12,4,3.39431513487251,12.6056848651275
"1990","gone tomorrow",21.1244830340547,16,12,4,3.39431513487251,12.6056848651275
"1990","just run",21.1244830340547,16,12,4,3.39431513487251,12.6056848651275
"1990","lay sleep",21.1244830340547,16,12,4,3.39431513487251,12.6056848651275
"1990","let body",21.1244830340547,16,12,4,3.39431513487251,12.6056848651275
"1990","mind let",21.1244830340547,16,12,4,3.39431513487251,12.6056848651275
"1990","wax",21.1244830340547,16,12,4,3.39431513487251,12.6056848651275
"1990","will ill",21.1244830340547,16,12,4,3.39431513487251,12.6056848651275
"1990","world wanna",21.1244830340547,16,12,4,3.39431513487251,12.6056848651275
"1970","gentle",21.1146263059434,58,22,36,7.93717772689968,50.0628222731003
"2000","like just",21.1103283100268,88,44,44,23.6795404746967,64.3204595253033
"2010","cell phone",21.0948429156817,17,11,6,2.61736630763376,14.3826336923662
"2010","going nowhere",21.0948429156817,17,11,6,2.61736630763376,14.3826336923662
"2010","heart wants",21.0948429156817,17,11,6,2.61736630763376,14.3826336923662
"2010","high life",21.0948429156817,17,11,6,2.61736630763376,14.3826336923662
"2010","im hoping",21.0948429156817,17,11,6,2.61736630763376,14.3826336923662
"1980","wait",21.0947385201801,758,177,581,127.522681553832,630.477318446168
"1990","confused",21.0892929841172,98,41,57,20.7901802010941,77.2098197989059
"1990","want get",21.0892929841172,98,41,57,20.7901802010941,77.2098197989059
"1970","singin",21.0770752416517,135,39,96,18.4744653988182,116.525534601182
"1990","can talk",21.0614811956591,49,25,24,10.3950901005471,38.604909899453
"1990","poppa",21.0614811956591,49,25,24,10.3950901005471,38.604909899453
"1970","burn",21.0308564641129,335,77,258,45.8440437674378,289.155956232562
"1970","fame",21.0282047397799,140,40,100,19.1587048580337,120.841295141966
"2000","body like",21.0180680542234,70,37,33,18.8359981048724,51.1640018951276
"2000","just might",21.0180680542234,70,37,33,18.8359981048724,51.1640018951276
"2000","keys",21.0180680542234,70,37,33,18.8359981048724,51.1640018951276
"1970","shake shake shake shake",21.0149101016258,180,48,132,24.6326205317576,155.367379468242
"1970","take easy",20.9931465993416,28,14,14,3.83174097160674,24.1682590283933
"1970","tragedy",20.9931465993416,28,14,14,3.83174097160674,24.1682590283933
"1990","aint good enough",20.9931170873657,14,11,3,2.97002574301344,11.0299742569866
"1990","away boy",20.9931170873657,14,11,3,2.97002574301344,11.0299742569866
"1990","dream real",20.9931170873657,14,11,3,2.97002574301344,11.0299742569866
"1990","fire love",20.9931170873657,14,11,3,2.97002574301344,11.0299742569866
"1990","first night",20.9931170873657,14,11,3,2.97002574301344,11.0299742569866
"1990","im gonna im",20.9931170873657,14,11,3,2.97002574301344,11.0299742569866
"1990","leave one",20.9931170873657,14,11,3,2.97002574301344,11.0299742569866
"1990","life us",20.9931170873657,14,11,3,2.97002574301344,11.0299742569866
"1990","money come",20.9931170873657,14,11,3,2.97002574301344,11.0299742569866
"1990","tryin take",20.9931170873657,14,11,3,2.97002574301344,11.0299742569866
"1990","will cry",20.9931170873657,14,11,3,2.97002574301344,11.0299742569866
"1990","woman im",20.9931170873657,14,11,3,2.97002574301344,11.0299742569866
"1990","ya call",20.9931170873657,14,11,3,2.97002574301344,11.0299742569866
"1980","blue eyes",20.9897433135206,24,14,10,4.03765746344587,19.9623425365541
"1980","dont put",20.9897433135206,24,14,10,4.03765746344587,19.9623425365541
"1980","night well",20.9897433135206,24,14,10,4.03765746344587,19.9623425365541
"1970","seems",20.9840930142321,477,102,375,65.2764444091577,411.723555590842
"1980","never",20.9779244704877,4753,920,3833,799.624413489926,3953.37558651007
"1970","shes gonna",20.9737292036199,35,16,19,4.78967621450843,30.2103237854916
"1990","little thing",20.9686340752708,108,44,64,22.9116271603894,85.0883728396106
"1990","find another",20.9474218508006,76,34,42,16.1229968906444,59.8770031093556
"2000","dont think",20.9448833946499,284,112,172,76.4203351683393,207.579664831661
"1990","know need",20.9371942845726,118,47,71,25.0330741196847,92.9669258803153
"2010","zone",20.9292346406304,92,32,60,14.164570606018,77.835429393982
"1970","gonna mess",20.9289632463698,13,9,4,1.77902259396027,11.2209774060397
"1970","heaven knows",20.9289632463698,13,9,4,1.77902259396027,11.2209774060397
"1970","loved like",20.9289632463698,13,9,4,1.77902259396027,11.2209774060397
"1970","much thats",20.9289632463698,13,9,4,1.77902259396027,11.2209774060397
"1970","tell tell tell",20.9289632463698,13,9,4,1.77902259396027,11.2209774060397
"1980","use",20.9273579085808,290,80,210,48.7883610166376,241.211638983362
"1970","ooh ooh ooh",20.9208019511577,227,57,170,31.0644714483832,195.935528551617
"2000","broke",20.9072315941457,233,95,138,62.6969651205037,170.303034879496
"1960","francisco",20.9064826794506,14,7,7,0.836125827500235,13.1638741724998
"1960","love mine",20.9064826794506,14,7,7,0.836125827500235,13.1638741724998
"1960","san francisco",20.9064826794506,14,7,7,0.836125827500235,13.1638741724998
"1970","take hand",20.9004422438359,121,36,85,16.5585949130148,104.441405086985
"1960","build",20.8916852953344,114,21,93,6.80845316678763,107.191546833212
"1960","yeah yeah yeah yeah",20.8855568781454,549,61,488,32.7880770926878,516.211922907312
"1990","vision",20.8801662034995,73,33,40,15.4865628028558,57.5134371971442
"2010","drag",20.8706635665246,68,26,42,10.469465230535,57.530534769465
"2010","chains",20.8684187658287,88,31,57,13.5487197101042,74.4512802898958
"1960","bonnie clyde",20.8488170617865,10,6,4,0.597232733928739,9.40276726607126
"1960","can people",20.8488170617865,10,6,4,0.597232733928739,9.40276726607126
"1960","come time",20.8488170617865,10,6,4,0.597232733928739,9.40276726607126
"1960","gown",20.8488170617865,10,6,4,0.597232733928739,9.40276726607126
"1960","place like",20.8488170617865,10,6,4,0.597232733928739,9.40276726607126
"1960","precious love",20.8488170617865,10,6,4,0.597232733928739,9.40276726607126
"2000","without im",20.8471068345108,32,21,11,8.61074199079879,23.3892580092012
"1970","smile",20.8336572512291,583,120,463,79.7823209445261,503.217679055474
"1990","rhymes",20.8269645173804,70,32,38,14.8501287150672,55.1498712849328
"2010","see just",20.8185779318497,72,27,45,11.0853161264489,60.9146838735512
"1960","ah come",20.8169991979997,24,9,15,1.43335856142897,22.566641438571
"1990","emotions",20.7976117746226,58,28,30,12.3043923639128,45.6956076360872
"1980","night will",20.7966980487097,27,15,12,4.5423646463766,22.4576353536234
"1960","back home",20.7964575787721,72,16,56,4.30007568428692,67.6999243157131
"2000","goes",20.7929444210768,712,247,465,191.589009295273,520.410990704727
"1960","tears",20.7823947356073,502,57,445,29.9810832432227,472.018916756777
"1980","mind know",20.7784231454646,33,17,16,5.55177901223807,27.4482209877619
"1960","baby please dont",20.7599134283098,36,11,25,2.15003784214346,33.8499621578565
"1980","eye eye",20.7388277299875,30,16,14,5.04707182930734,24.9529281706927
"1970","youre good",20.7036086911565,67,24,43,9.16880875348756,57.8311912465124
"1960","lonely",20.6982985753398,748,77,671,44.6730084978697,703.32699150213
"1990","apart",20.6939716269219,279,92,187,59.1883701643393,219.811629835661
"1980","now tell",20.687707183648,78,30,48,13.1223867561991,64.8776132438009
"2000","first",20.6774942473408,706,245,461,189.974495171998,516.025504828002
"1970","away know",20.6746430223606,39,17,22,5.33706778188082,33.6629322181192
"1980","searching",20.6665774771611,117,40,77,19.6835801342986,97.3164198657014
"1990","happy people",20.6638064391719,41,22,19,8.6979325331108,32.3020674668892
"2010","baby im just",20.6596772522552,20,12,8,3.07925447956913,16.9207455204309
"2010","back one",20.6596772522552,20,12,8,3.07925447956913,16.9207455204309
"2010","even dont",20.6596772522552,20,12,8,3.07925447956913,16.9207455204309
"2010","got fire",20.6596772522552,20,12,8,3.07925447956913,16.9207455204309
"2010","turn just",20.6596772522552,20,12,8,3.07925447956913,16.9207455204309
"1980","disguise",20.642246164542,67,27,40,11.2717937521197,55.7282062478803
"1970","light",20.6353940675716,1015,191,824,138.900610220744,876.099389779256
"1960","always will",20.6330620931904,30,10,20,1.79169820178622,28.2083017982138
"1960","like real",20.6330620931904,30,10,20,1.79169820178622,28.2083017982138
"1970","sealed",20.6256124659325,25,13,12,3.42119729607745,21.5788027039226
"1970","summer time",20.6256124659325,25,13,12,3.42119729607745,21.5788027039226
"1990","get lonely",20.6094913260914,23,15,8,4.87932800637923,18.1206719936208
"1990","let go can",20.6094913260914,23,15,8,4.87932800637923,18.1206719936208
"1990","thing ill",20.6094913260914,23,15,8,4.87932800637923,18.1206719936208
"1990","thursday",20.6076255760441,33,19,14,7.00077496567454,25.9992250343255
"1990","wanna miss",20.6076255760441,33,19,14,7.00077496567454,25.9992250343255
"2010","baby song",20.5974350919505,10,8,2,1.53962723978456,8.46037276021544
"2010","ever loved somebody",20.5974350919505,10,8,2,1.53962723978456,8.46037276021544
"2010","feel low",20.5974350919505,10,8,2,1.53962723978456,8.46037276021544
"2010","feel moment",20.5974350919505,10,8,2,1.53962723978456,8.46037276021544
"2010","feel thats",20.5974350919505,10,8,2,1.53962723978456,8.46037276021544
"2010","hand youre",20.5974350919505,10,8,2,1.53962723978456,8.46037276021544
"2010","hear thoughts",20.5974350919505,10,8,2,1.53962723978456,8.46037276021544
"2010","lie cant",20.5974350919505,10,8,2,1.53962723978456,8.46037276021544
"2010","like kid",20.5974350919505,10,8,2,1.53962723978456,8.46037276021544
"2010","like kind",20.5974350919505,10,8,2,1.53962723978456,8.46037276021544
"2010","love clear",20.5974350919505,10,8,2,1.53962723978456,8.46037276021544
"2010","loved somebody",20.5974350919505,10,8,2,1.53962723978456,8.46037276021544
"2010","oh sometimes",20.5974350919505,10,8,2,1.53962723978456,8.46037276021544
"2010","run faster",20.5974350919505,10,8,2,1.53962723978456,8.46037276021544
"2010","smell scent",20.5974350919505,10,8,2,1.53962723978456,8.46037276021544
"2010","stupid ass",20.5974350919505,10,8,2,1.53962723978456,8.46037276021544
"2010","talk friends",20.5974350919505,10,8,2,1.53962723978456,8.46037276021544
"2010","think can hide",20.5974350919505,10,8,2,1.53962723978456,8.46037276021544
"2010","wanna call",20.5974350919505,10,8,2,1.53962723978456,8.46037276021544
"2010","way lie",20.5974350919505,10,8,2,1.53962723978456,8.46037276021544
"2010","whats name whats",20.5974350919505,10,8,2,1.53962723978456,8.46037276021544
"2010","youre alone cause",20.5974350919505,10,8,2,1.53962723978456,8.46037276021544
"2000","wherever",20.5936925492666,94,46,48,25.2940545979715,68.7059454020285
"1990","fantasy",20.591762884199,122,48,74,25.8816529034029,96.1183470965971
"2000","like said",20.5873472189526,30,20,10,8.07257061637387,21.9274293836261
"1990","wild",20.5800427932999,479,144,335,101.617309350246,377.382690649754
"1960","real can",20.5793986424727,19,8,11,1.13474219446461,17.8652578055354
"2000","aint need",20.5691328532488,16,13,3,4.3053709953994,11.6946290046006
"2000","always gonna",20.5691328532488,16,13,3,4.3053709953994,11.6946290046006
"1980","jungle",20.5486243784119,82,31,51,13.7953296667734,68.2046703332266
"1980","know true",20.5486243784119,82,31,51,13.7953296667734,68.2046703332266
"1990","things",20.5428207482103,1560,406,1154,330.945725650069,1229.05427434993
"2000","gotta make",20.5310251449803,58,32,26,15.6069698583228,42.3930301416772
"2010","girl like",20.5298130918341,127,40,87,19.5532659452639,107.446734054736
"1960","mine baby",20.5201773897653,50,13,37,2.9861636696437,47.0138363303563
"2010","bands",20.512202682314,26,14,12,4.00303082343986,21.9969691765601
"2010","cry just little",20.512202682314,26,14,12,4.00303082343986,21.9969691765601
"2010","swimming",20.512202682314,26,14,12,4.00303082343986,21.9969691765601
"2010","try try try",20.512202682314,26,14,12,4.00303082343986,21.9969691765601
"2010","dont feel like",20.4986521050986,23,13,10,3.5411426515045,19.4588573484955
"2010","ever take",20.4986521050986,23,13,10,3.5411426515045,19.4588573484955
"2010","oh oh im",20.4986521050986,23,13,10,3.5411426515045,19.4588573484955
"2010","said get",20.4986521050986,23,13,10,3.5411426515045,19.4588573484955
"1970","id like",20.4919694122288,122,36,86,16.6954428048579,105.304557195142
"2000","pass",20.4758532016508,243,98,145,65.3878219926283,177.612178007372
"2000","looking",20.4678812822346,769,264,505,206.926893466383,562.073106533617
"1990","ah oh",20.4417435067483,28,17,11,5.94005148602689,22.0599485139731
"1990","girl ill",20.4308920245112,44,23,21,9.33436662089939,34.6656333791006
"1990","round round round",20.4308920245112,44,23,21,9.33436662089939,34.6656333791006
"2000","youre making",20.4274793710192,46,27,19,12.3779416117733,33.6220583882267
"1980","one night",20.4004694417054,159,50,109,26.7494806953289,132.250519304671
"1960","place",20.3926542026401,943,92,851,56.3190468094801,886.68095319052
"1970","feel can feel",20.3736535285712,16,10,6,2.18956626948957,13.8104337305104
"1970","heart gold",20.3736535285712,16,10,6,2.18956626948957,13.8104337305104
"1970","lookin love",20.3736535285712,16,10,6,2.18956626948957,13.8104337305104
"1970","mile shoes",20.3736535285712,16,10,6,2.18956626948957,13.8104337305104
"1970","runnin away",20.3736535285712,16,10,6,2.18956626948957,13.8104337305104
"1970","schools",20.3736535285712,16,10,6,2.18956626948957,13.8104337305104
"1970","sweet darlin",20.3736535285712,16,10,6,2.18956626948957,13.8104337305104
"1980","every bit",20.3698840045217,14,10,4,2.35530018701009,11.6446998129899
"1980","get come get",20.3698840045217,14,10,4,2.35530018701009,11.6446998129899
"1980","ive got let",20.3698840045217,14,10,4,2.35530018701009,11.6446998129899
"1980","oh im gonna",20.3698840045217,14,10,4,2.35530018701009,11.6446998129899
"1980","please let know",20.3698840045217,14,10,4,2.35530018701009,11.6446998129899
"1980","pledge",20.3698840045217,14,10,4,2.35530018701009,11.6446998129899
"2000","sunrise",20.3610994361026,28,19,9,7.53439924194894,20.4656007580511
"2000","tasty",20.3610994361026,28,19,9,7.53439924194894,20.4656007580511
"1970","honky tonk",20.3601264371896,22,12,10,3.01065362054815,18.9893463794518
"1970","right right right right",20.3601264371896,22,12,10,3.01065362054815,18.9893463794518
"1970","tear roof",20.3601264371896,22,12,10,3.01065362054815,18.9893463794518
"1970","tonk",20.3601264371896,22,12,10,3.01065362054815,18.9893463794518
"1980","full love",20.3480467563731,19,12,7,3.19647882522798,15.803521174772
"1980","gonna stop us",20.3480467563731,19,12,7,3.19647882522798,15.803521174772
"1980","much miss",20.3480467563731,19,12,7,3.19647882522798,15.803521174772
"1990","doubt",20.3473252399584,185,66,119,39.2467687469634,145.753231253037
"2000","star",20.3334504824915,375,141,234,100.907132704673,274.092867295327
"1980","fall",20.3092487767727,925,209,716,155.61804807031,769.38195192969
"1960","care",20.3035601735594,702,73,629,41.9257379217975,660.074262078203
"2010","make feel like",20.2815696233893,85,30,55,13.0868315381688,71.9131684618312
"1970","take home",20.2617346146018,162,44,118,22.1693584785819,139.830641521418
"1990","blind",20.2592431238623,214,74,140,45.3989649289198,168.60103507108
"2010","attack",20.2518076285413,50,21,29,7.69813619892281,42.3018638010772
"1970","cant go back",20.2461845000114,19,11,8,2.60010994501886,16.3998900549811
"1970","showers",20.2461845000114,19,11,8,2.60010994501886,16.3998900549811
"1980","theres something",20.2298524600795,122,41,81,20.5247587725165,101.475241227483
"2000","every time hear",20.1945606839417,18,14,4,4.84354236982432,13.1564576301757
"2000","everybody wanna",20.1945606839417,18,14,4,4.84354236982432,13.1564576301757
"2000","meant hurt",20.1945606839417,18,14,4,4.84354236982432,13.1564576301757
"2000","now wouldnt",20.1945606839417,18,14,4,4.84354236982432,13.1564576301757
"2000","touch body",20.1945606839417,18,14,4,4.84354236982432,13.1564576301757
"2000","youre waiting",20.1945606839417,18,14,4,4.84354236982432,13.1564576301757
"1980","street",20.1939459039703,339,90,249,57.0319116711729,281.968088328827
"2000","stack",20.1930833373096,51,29,22,13.7233700478356,37.2766299521644
"2000","protection",20.1768874684556,26,18,8,6.99622786752402,19.003772132476
"2000","take em",20.1768874684556,26,18,8,6.99622786752402,19.003772132476
"2000","want come get",20.1768874684556,26,18,8,6.99622786752402,19.003772132476
"1990","spread",20.1650456181084,74,33,41,15.6987074987853,58.3012925012147
"2000","cause aint",20.1507679322984,84,42,42,22.6031977258468,61.3968022741532
"1980","give little",20.1476897058881,50,22,28,8.4117863821789,41.5882136178211
"1990","want give",20.1316589149172,50,25,25,10.6072347964766,39.3927652035234
"1960","know much",20.1163184936553,82,17,65,4.89730841821566,77.1026915817843
"1980","can try",20.1157152735646,40,19,21,6.72942910574312,33.2705708942569
"1980","undercover",20.1157152735646,40,19,21,6.72942910574312,33.2705708942569
"2000","mad",20.1007611313025,262,104,158,70.5004500496651,191.499549950335
"2010","get em",20.0969651427592,43,19,24,6.62039713107362,36.3796028689264
"2010","gotta know",20.0969651427592,43,19,24,6.62039713107362,36.3796028689264
"2010","hands hands",20.0969651427592,43,19,24,6.62039713107362,36.3796028689264
"2010","thinking bout",20.0969651427592,43,19,24,6.62039713107362,36.3796028689264
"2000","okay",20.0968445172094,226,92,134,60.8133653100165,165.186634689984
"2010","throw",20.0962444581271,441,104,337,67.8975612744992,373.102438725501
"2000","tell like",20.0806357667929,37,23,14,9.9561704268611,27.0438295731389
"2000","can run can",20.0465025113137,24,17,7,6.45805649309909,17.5419435069009
"2000","charlie",20.0465025113137,24,17,7,6.45805649309909,17.5419435069009
"2000","gon make",20.0465025113137,24,17,7,6.45805649309909,17.5419435069009
"1990","got love",20.0458011175626,168,61,107,35.6403089161613,132.359691083839
"2010","girl world",20.0289370148075,54,22,32,8.31398709483664,45.6860129051634
"2010","need little",20.0289370148075,54,22,32,8.31398709483664,45.6860129051634
"1960","sleepy",20.0242870039672,25,9,16,1.49308183482185,23.5069181651781
"1960","trace",20.0242870039672,25,9,16,1.49308183482185,23.5069181651781
"1960","yes im ready",20.0242870039672,25,9,16,1.49308183482185,23.5069181651781
"2000","alright im",20.0229469763689,20,15,5,5.38171374424925,14.6182862557508
"2000","boys say",20.0229469763689,20,15,5,5.38171374424925,14.6182862557508
"2000","city city",20.0229469763689,20,15,5,5.38171374424925,14.6182862557508
"2000","cold youre",20.0229469763689,20,15,5,5.38171374424925,14.6182862557508
"2000","flashing lights",20.0229469763689,20,15,5,5.38171374424925,14.6182862557508
"2000","forever can",20.0229469763689,20,15,5,5.38171374424925,14.6182862557508
"2000","loveim",20.0229469763689,20,15,5,5.38171374424925,14.6182862557508
"2000","remember youre",20.0229469763689,20,15,5,5.38171374424925,14.6182862557508
"2000","status",20.0229469763689,20,15,5,5.38171374424925,14.6182862557508
"2000","way right",20.0229469763689,20,15,5,5.38171374424925,14.6182862557508
"1990","allow",20.01820441167,21,14,7,4.45503861452016,16.5449613854798
"1990","heart free",20.01820441167,21,14,7,4.45503861452016,16.5449613854798
"1990","never lie",20.01820441167,21,14,7,4.45503861452016,16.5449613854798
"1960","round round round",20.0101611308984,44,12,32,2.62782402928645,41.3721759707135
"2010","call mine",19.9973886988255,15,10,5,2.30944085967684,12.6905591403232
"2010","feeling low",19.9973886988255,15,10,5,2.30944085967684,12.6905591403232
"2010","girl know love",19.9973886988255,15,10,5,2.30944085967684,12.6905591403232
"2010","got couple",19.9973886988255,15,10,5,2.30944085967684,12.6905591403232
"2010","just sitting",19.9973886988255,15,10,5,2.30944085967684,12.6905591403232
"2010","miss im",19.9973886988255,15,10,5,2.30944085967684,12.6905591403232
"2010","rock ooh",19.9973886988255,15,10,5,2.30944085967684,12.6905591403232
"2010","take bite",19.9973886988255,15,10,5,2.30944085967684,12.6905591403232
"2000","always talkin",19.986806466869,22,16,6,5.91988511867417,16.0801148813258
"2000","best believe",19.986806466869,22,16,6,5.91988511867417,16.0801148813258
"2000","chasin",19.986806466869,22,16,6,5.91988511867417,16.0801148813258
"2000","dance just",19.986806466869,22,16,6,5.91988511867417,16.0801148813258
"2000","got job",19.986806466869,22,16,6,5.91988511867417,16.0801148813258
"2000","ima get",19.986806466869,22,16,6,5.91988511867417,16.0801148813258
"2000","parking lot",19.986806466869,22,16,6,5.91988511867417,16.0801148813258
"2000","shimmy",19.986806466869,22,16,6,5.91988511867417,16.0801148813258
"2000","sore",19.986806466869,22,16,6,5.91988511867417,16.0801148813258
"1980","know theres",19.9745846397017,83,31,52,13.963565394417,69.036434605583
"2010","beautiful",19.9519693646366,515,118,397,79.290802848905,435.709197151095
"2010","top",19.948517262852,421,100,321,64.8183067949301,356.18169320507
"1970","somebody",19.939752848315,672,134,538,91.9617833185618,580.038216681438
"1970","rising",19.9356705304233,29,14,15,3.96858886344984,25.0314111365502
"1970","summers",19.9356705304233,29,14,15,3.96858886344984,25.0314111365502
"2010","got",19.8926505750695,8289,1425,6864,1276.19701905742,7012.80298094258
"1980","got love got",19.8906871251488,22,13,9,3.70118600815871,18.2988139918413
"1980","power love",19.8906871251488,22,13,9,3.70118600815871,18.2988139918413
"1980","really wanna know",19.8906871251488,22,13,9,3.70118600815871,18.2988139918413
"1980","stop keep",19.8906871251488,22,13,9,3.70118600815871,18.2988139918413
"1990","go go go",19.8810465796221,120,47,73,25.4573635115438,94.5426364884562
"1980","dance",19.8741141281837,1542,327,1215,259.419492026397,1282.5805079736
"1990","im sayin",19.8698289445313,39,21,18,8.27364314125173,30.7263568587483
"1980","guilty",19.8161544280293,47,21,26,7.90707919924816,39.0929208007518
"1970","baby didnt",19.8141924630592,11,8,3,1.50532681027408,9.49467318972592
"1970","just cant live without",19.8141924630592,11,8,3,1.50532681027408,9.49467318972592
"1970","like moon",19.8141924630592,11,8,3,1.50532681027408,9.49467318972592
"1970","nights oh",19.8141924630592,11,8,3,1.50532681027408,9.49467318972592
"1970","now dont stop",19.8141924630592,11,8,3,1.50532681027408,9.49467318972592
"1970","rock roll music",19.8141924630592,11,8,3,1.50532681027408,9.49467318972592
"1970","roll music",19.8141924630592,11,8,3,1.50532681027408,9.49467318972592
"1970","somebody help",19.8141924630592,11,8,3,1.50532681027408,9.49467318972592
"1970","time didnt",19.8141924630592,11,8,3,1.50532681027408,9.49467318972592
"1970","wrong dont wanna",19.8141924630592,11,8,3,1.50532681027408,9.49467318972592
"1970","wrong dont wanna right",19.8141924630592,11,8,3,1.50532681027408,9.49467318972592
"1970","ya better",19.8141924630592,11,8,3,1.50532681027408,9.49467318972592
"1960","baby need",19.7910439340932,59,14,45,3.52367313017956,55.4763268698204
"1960","trees",19.7779771258824,83,17,66,4.95703169160854,78.0429683083915
"2010","feel like im",19.7607578420714,47,20,27,7.23624802698745,39.7637519730126
"2000","go right",19.7529086164591,49,28,21,13.1851986734107,35.8148013265894
"2000","walk",19.7433502888126,994,331,663,267.471173089188,726.528826910813
"1970","hed",19.7396021454069,56,21,35,7.66348194321348,48.3365180567865
"1990","back days",19.7379122926846,26,16,10,5.51576209416782,20.4842379058322
"1990","boy ill",19.7379122926846,26,16,10,5.51576209416782,20.4842379058322
"1990","dont know im gonna",19.7379122926846,26,16,10,5.51576209416782,20.4842379058322
"1990","one wanna",19.7379122926846,26,16,10,5.51576209416782,20.4842379058322
"1990","whole wide",19.7379122926846,26,16,10,5.51576209416782,20.4842379058322
"1990","whole wide world",19.7379122926846,26,16,10,5.51576209416782,20.4842379058322
"1990","wide world",19.7379122926846,26,16,10,5.51576209416782,20.4842379058322
"2010","told",19.7329982124786,780,167,613,120.090924703196,659.909075296804
"2000","boy really",19.7300401669003,35,22,13,9.41799905243618,25.5820009475638
"2000","cheese",19.7300401669003,35,22,13,9.41799905243618,25.5820009475638
"2000","jackson",19.7300401669003,35,22,13,9.41799905243618,25.5820009475638
"1970","ooh ooh",19.7296288656066,426,92,334,58.2972019251597,367.70279807484
"1960","cant hurry",19.710066569784,15,7,8,0.895849100893109,14.1041508991069
"1960","got come",19.710066569784,15,7,8,0.895849100893109,14.1041508991069
"1960","hes gone",19.710066569784,15,7,8,0.895849100893109,14.1041508991069
"1960","leave world",19.710066569784,15,7,8,0.895849100893109,14.1041508991069
"1960","tell whats mind",19.710066569784,15,7,8,0.895849100893109,14.1041508991069
"1960","youre tryin",19.710066569784,15,7,8,0.895849100893109,14.1041508991069
"2010","ooh ooh ooh ooh",19.6997613288498,129,40,89,19.8611913932209,109.138808606779
"1980","cant stand",19.6975540518344,107,37,70,18.0012228578628,88.9987771421372
"1970","leavin",19.695115303098,91,29,62,12.4531581577219,78.5468418422781
"1960","hush",19.6926770473841,75,16,59,4.47924550446555,70.5207544955345
"1980","best got",19.6921983198065,12,9,3,2.01882873172294,9.98117126827706
"1980","go long",19.6921983198065,12,9,3,2.01882873172294,9.98117126827706
"1980","going stay",19.6921983198065,12,9,3,2.01882873172294,9.98117126827706
"1980","im born",19.6921983198065,12,9,3,2.01882873172294,9.98117126827706
"1980","just work",19.6921983198065,12,9,3,2.01882873172294,9.98117126827706
"1980","makes life",19.6921983198065,12,9,3,2.01882873172294,9.98117126827706
"1980","mine girl",19.6921983198065,12,9,3,2.01882873172294,9.98117126827706
"1980","oh oh oh just",19.6921983198065,12,9,3,2.01882873172294,9.98117126827706
"1980","ooh ah",19.6921983198065,12,9,3,2.01882873172294,9.98117126827706
"1980","place live",19.6921983198065,12,9,3,2.01882873172294,9.98117126827706
"1980","ronnie",19.6921983198065,12,9,3,2.01882873172294,9.98117126827706
"1980","slow oh",19.6921983198065,12,9,3,2.01882873172294,9.98117126827706
"1980","talk anymore",19.6921983198065,12,9,3,2.01882873172294,9.98117126827706
"1980","time tonight",19.6921983198065,12,9,3,2.01882873172294,9.98117126827706
"1980","touch heart",19.6921983198065,12,9,3,2.01882873172294,9.98117126827706
"1990","baby baby baby baby",19.6835112026564,134,51,83,28.4273892545572,105.572610745443
"2000","shakin",19.6806915193191,69,36,33,18.5669124176599,50.4330875823401
"1990","bodys",19.679235749346,81,35,46,17.1837203702921,63.8162796297079
"1960","sure",19.67627858102,560,61,499,33.4450331000094,526.554966899991
"1970","free",19.6642988900362,710,140,570,97.1620032085995,612.8379967914
"2010","love long",19.6629479789592,40,18,22,6.15850895913825,33.8414910408617
"1980","careless",19.6629424780955,25,14,11,4.20589319108945,20.7941068089106
"1980","just two",19.6629424780955,25,14,11,4.20589319108945,20.7941068089106
"1980","love shes",19.6629424780955,25,14,11,4.20589319108945,20.7941068089106
"1980","ooh youre",19.6629424780955,25,14,11,4.20589319108945,20.7941068089106
"1970","country",19.6571534121627,105,32,73,14.3690286435253,90.6309713564747
"1970","times",19.6479052987744,626,126,500,85.6667802937793,540.333219706221
"2010","body like",19.6475848679906,70,26,44,10.7773906784919,59.2226093215081
"2010","faded",19.6475848679906,70,26,44,10.7773906784919,59.2226093215081
"2010","im gone",19.6475848679906,70,26,44,10.7773906784919,59.2226093215081
"2010","without without",19.6475848679906,70,26,44,10.7773906784919,59.2226093215081
"1960","baby sweet",19.6460146160552,20,8,12,1.19446546785748,18.8055345321425
"1960","let hang",19.6460146160552,20,8,12,1.19446546785748,18.8055345321425
"1960","oh say",19.6460146160552,20,8,12,1.19446546785748,18.8055345321425
"1960","see another",19.6460146160552,20,8,12,1.19446546785748,18.8055345321425
"1990","baby dont",19.6430544293828,366,114,252,77.6449587102086,288.355041289791
"1990","wreck",19.6299593674797,42,22,20,8.91007722904033,33.0899227709597
"2000","next",19.6247426572285,491,177,314,132.121072421319,358.878927578681
"2000","sorry",19.6134648514499,306,118,188,82.3402202870135,223.659779712987
"1980","devotion",19.5877723518203,28,15,13,4.71060037402018,23.2893996259798
"2010","home im",19.5582676707391,30,15,15,4.61888171935369,25.3811182806463
"1970","join",19.5507935780998,69,24,45,9.44250453717376,59.5574954628262
"1980","close eyes",19.5418698153014,218,63,155,36.6753886263,181.3246113737
"1980","cool",19.5129484310159,389,100,289,65.4436980533518,323.556301946648
"1960","aint got time",19.5047882280513,45,12,33,2.68754730267933,42.3124526973207
"1980","wont make",19.5046505374767,44,20,24,7.40237201631743,36.5976279836826
"2000","hoo",19.4955046933988,157,68,89,42.2464528923566,114.753547107643
"1990","aint proud",19.4750601176276,19,13,6,4.0307492226611,14.9692507773389
"1990","something else",19.4750601176276,19,13,6,4.0307492226611,14.9692507773389
"1990","ya gotta",19.4750601176276,19,13,6,4.0307492226611,14.9692507773389
"1990","youve always",19.4750601176276,19,13,6,4.0307492226611,14.9692507773389
"1990","smooth",19.4716825084513,75,33,42,15.9108521947149,59.0891478052851
"1990","woo woo",19.4527629538942,45,23,22,9.54651131682892,35.4534886831711
"2010","fall back",19.4467255030796,18,11,7,2.77132903161221,15.2286709683878
"2010","know youre alone",19.4467255030796,18,11,7,2.77132903161221,15.2286709683878
"2010","mud",19.4467255030796,18,11,7,2.77132903161221,15.2286709683878
"2010","text",19.4467255030796,18,11,7,2.77132903161221,15.2286709683878
"2010","cause youre",19.4277439817145,194,54,140,29.8687684518205,164.131231548179
"1990","every woman",19.4093914232945,34,19,15,7.21291966160408,26.7870803383959
"1990","get gotta",19.4093914232945,34,19,15,7.21291966160408,26.7870803383959
"2000","platinum",19.3956872407974,33,21,12,8.87982767801125,24.1201723219887
"2000","trunk",19.3956872407974,33,21,12,8.87982767801125,24.1201723219887
"1990","searchin",19.3839487769335,72,32,40,15.2744181069263,56.7255818930737
"1980","gonna change",19.3718936898258,51,22,29,8.58002210982247,42.4199778901775
"1980","look",19.3572903982469,1903,394,1509,320.152589705729,1582.84741029427
"1970","plays",19.3560903345353,101,31,70,13.8216370761529,87.1783629238471
"1980","can dont know",19.3485915231498,17,11,6,2.86000736994083,14.1399926300592
"1980","gonna call",19.3485915231498,17,11,6,2.86000736994083,14.1399926300592
"1980","just called",19.3485915231498,17,11,6,2.86000736994083,14.1399926300592
"1980","look away",19.3485915231498,17,11,6,2.86000736994083,14.1399926300592
"1980","take ill",19.3485915231498,17,11,6,2.86000736994083,14.1399926300592
"1980","given",19.3447617614457,124,41,83,20.8612302278037,103.138769772196
"2010","wit wit",19.3433393119961,27,14,13,4.15699354741832,22.8430064525817
"1960","take back",19.339517554155,76,16,60,4.53896877785842,71.4610312221416
"2000","apologize",19.3161411116492,47,27,20,12.6470272989857,34.3529727010143
"1990","shack",19.3156957526835,111,44,67,23.548061248178,87.451938751822
"2010","im like",19.2952551005474,130,40,90,20.0151541171993,109.984845882801
"2010","oh ooh",19.2830784120181,44,19,25,6.77435985505208,37.2256401449479
"1960","everyone knows",19.276634970568,26,9,17,1.55280510821472,24.4471948917853
"1960","please dont leave",19.276634970568,26,9,17,1.55280510821472,24.4471948917853
"1960","another guy",19.2740092695546,11,6,5,0.656956007321613,10.3430439926784
"1960","baby comes",19.2740092695546,11,6,5,0.656956007321613,10.3430439926784
"1960","days gone im",19.2740092695546,11,6,5,0.656956007321613,10.3430439926784
"1960","hawaii",19.2740092695546,11,6,5,0.656956007321613,10.3430439926784
"1960","let time",19.2740092695546,11,6,5,0.656956007321613,10.3430439926784
"1960","listen cause",19.2740092695546,11,6,5,0.656956007321613,10.3430439926784
"1960","next cant",19.2740092695546,11,6,5,0.656956007321613,10.3430439926784
"1960","oh woman",19.2740092695546,11,6,5,0.656956007321613,10.3430439926784
"1960","plead",19.2740092695546,11,6,5,0.656956007321613,10.3430439926784
"1960","shake oh",19.2740092695546,11,6,5,0.656956007321613,10.3430439926784
"1960","song song",19.2740092695546,11,6,5,0.656956007321613,10.3430439926784
"1960","will better",19.2740092695546,11,6,5,0.656956007321613,10.3430439926784
"2010","stopping",19.2538152291114,37,17,20,5.69662078720288,31.3033792127971
"1960","count",19.2500455584725,178,27,151,10.6307426639316,167.369257336068
"1990","right dont",19.247722849311,66,30,36,14.0015499313491,51.9984500686509
"1980","dont go away",19.2470026256431,10,8,2,1.68235727643578,8.31764272356422
"1980","heart want",19.2470026256431,10,8,2,1.68235727643578,8.31764272356422
"1980","im guilty",19.2470026256431,10,8,2,1.68235727643578,8.31764272356422
"1980","lock door",19.2470026256431,10,8,2,1.68235727643578,8.31764272356422
"1980","love waiting",19.2470026256431,10,8,2,1.68235727643578,8.31764272356422
"1980","misunderstanding",19.2470026256431,10,8,2,1.68235727643578,8.31764272356422
"1980","must kind",19.2470026256431,10,8,2,1.68235727643578,8.31764272356422
"1980","never gonna make",19.2470026256431,10,8,2,1.68235727643578,8.31764272356422
"1980","one kid",19.2470026256431,10,8,2,1.68235727643578,8.31764272356422
"1980","take time right",19.2470026256431,10,8,2,1.68235727643578,8.31764272356422
"1980","thats call",19.2470026256431,10,8,2,1.68235727643578,8.31764272356422
"1980","took long way",19.2470026256431,10,8,2,1.68235727643578,8.31764272356422
"1980","yeah crazy",19.2470026256431,10,8,2,1.68235727643578,8.31764272356422
"1980","youre givin",19.2470026256431,10,8,2,1.68235727643578,8.31764272356422
"1990","will let",19.2418553140803,51,25,26,10.8193794924061,40.1806205075939
"1990","youre never gonna",19.2418553140803,51,25,26,10.8193794924061,40.1806205075939
"2010","body",19.2339613284086,1089,222,867,167.665406412539,921.334593587461
"2010","hey mama",19.2323872529164,21,12,9,3.23321720354758,17.7667827964524
"2010","song make",19.2323872529164,21,12,9,3.23321720354758,17.7667827964524
"1970","oh lord",19.2268350193965,61,22,39,8.34772140242897,52.652278597571
"1970","one another",19.2268350193965,61,22,39,8.34772140242897,52.652278597571
"2010","oh like",19.2211800405322,24,13,11,3.69510537548295,20.3048946245171
"2010","weird",19.2211800405322,24,13,11,3.69510537548295,20.3048946245171
"1970","aint aint",19.2100865415586,37,16,21,5.06337199819462,31.9366280018054
"1970","know ill never",19.2100865415586,37,16,21,5.06337199819462,31.9366280018054
"2000","huh uh",19.2048087020612,67,35,32,18.028741043235,48.971258956765
"2010","cloud",19.2025518242615,59,23,36,9.08380071472892,49.9161992852711
"2000","cause want",19.2005757814048,40,24,16,10.7634274884985,29.2365725115015
"2000","ride ride ride",19.2005757814048,40,24,16,10.7634274884985,29.2365725115015
"1990","wishin",19.171921240977,57,27,30,12.0922476679833,44.9077523320167
"2000","biggest",19.1637352182412,52,29,23,13.992455735048,38.007544264952
"2000","crazy",19.1616437943207,861,290,571,231.68277668993,629.31722331007
"1990","forever",19.1368539513513,874,240,634,185.414464242411,688.585535757589
"1990","mercy",19.1323748987138,108,43,65,22.9116271603894,85.0883728396106
"1970","honky",19.1295832905445,23,12,11,3.14750151239125,19.8524984876087
"1970","roller",19.1295832905445,23,12,11,3.14750151239125,19.8524984876087
"1970","wanna stop",19.1295832905445,23,12,11,3.14750151239125,19.8524984876087
"2000","need say",19.1284951546691,62,33,29,16.6833126071727,45.3166873928273
"1980","ooh",19.1193099757142,2077,426,1651,349.425606315711,1727.57439368429
"2000","rock",19.1088148452567,1320,427,893,355.19310712045,964.80689287955
"1990","people world",19.1029831912147,29,17,12,6.15219618195642,22.8478038180436
"2010","yeah baby",19.0939287466825,144,43,101,22.1706322528977,121.829367747102
"2000","comes around",19.08089567283,31,20,11,8.34165630358633,22.6583436964137
"2000","since came",19.08089567283,31,20,11,8.34165630358633,22.6583436964137
"1990","found someone",19.0770756995599,37,20,17,7.84935374939267,29.1506462506073
"1990","miracles",19.0770756995599,37,20,17,7.84935374939267,29.1506462506073
"1970","darlin",19.0742743378216,181,47,134,24.7694684236007,156.230531576399
"2010","dont even",19.0656949519998,181,51,130,27.8672530401006,153.132746959899
"1980","higher",19.0606791232686,233,66,167,39.1989245409537,193.801075459046
"1990","ill baby",19.0515007878281,24,15,9,5.09147270230876,18.9085272976912
"1990","like girls",19.0515007878281,24,15,9,5.09147270230876,18.9085272976912
"1990","say remember",19.0515007878281,24,15,9,5.09147270230876,18.9085272976912
"1990","see let",19.0515007878281,24,15,9,5.09147270230876,18.9085272976912
"1970","school",19.0345040452541,202,51,151,27.6432741523058,174.356725847694
"1960","just little",19.030996758499,274,36,238,16.3641769096475,257.635823090353
"1970","deep blue sea",19.0223942431711,14,9,5,1.91587048580337,12.0841295141966
"1970","find find",19.0223942431711,14,9,5,1.91587048580337,12.0841295141966
"1970","granny",19.0223942431711,14,9,5,1.91587048580337,12.0841295141966
"1970","hum",19.0223942431711,14,9,5,1.91587048580337,12.0841295141966
"1970","love money",19.0223942431711,14,9,5,1.91587048580337,12.0841295141966
"1970","put spell",19.0223942431711,14,9,5,1.91587048580337,12.0841295141966
"1970","somebody want",19.0223942431711,14,9,5,1.91587048580337,12.0841295141966
"1970","whatever will",19.0223942431711,14,9,5,1.91587048580337,12.0841295141966
"1990","come end",18.9989743437209,17,12,5,3.60645983080204,13.393540169198
"1990","ive watching",18.9989743437209,17,12,5,3.60645983080204,13.393540169198
"1990","legit",18.9989743437209,17,12,5,3.60645983080204,13.393540169198
"1990","somethin like",18.9989743437209,17,12,5,3.60645983080204,13.393540169198
"1990","thought heard",18.9989743437209,17,12,5,3.60645983080204,13.393540169198
"1990","tiene",18.9989743437209,17,12,5,3.60645983080204,13.393540169198
"1990","tonight make",18.9989743437209,17,12,5,3.60645983080204,13.393540169198
"2000","aint got",18.9852023597352,268,105,163,72.1149641729399,195.88503582706
"2000","came party",18.971396637053,13,11,2,3.49811393376201,9.50188606623799
"2000","can fuck",18.971396637053,13,11,2,3.49811393376201,9.50188606623799
"2000","dont stop music",18.971396637053,13,11,2,3.49811393376201,9.50188606623799
"2000","floor aint",18.971396637053,13,11,2,3.49811393376201,9.50188606623799
"2000","lights camera",18.971396637053,13,11,2,3.49811393376201,9.50188606623799
"2000","show tonight",18.971396637053,13,11,2,3.49811393376201,9.50188606623799
"1970","love ooh",18.969635235131,49,19,30,6.7055467003118,42.2944532996882
"1970","rock boat",18.969635235131,49,19,30,6.7055467003118,42.2944532996882
"1970","sock",18.969635235131,49,19,30,6.7055467003118,42.2944532996882
"2010","bring back bring",18.9680545010586,13,9,4,2.00151541171993,10.9984845882801
"2010","em aint",18.9680545010586,13,9,4,2.00151541171993,10.9984845882801
"2010","imma let",18.9680545010586,13,9,4,2.00151541171993,10.9984845882801
"2010","know used",18.9680545010586,13,9,4,2.00151541171993,10.9984845882801
"2010","need boy",18.9680545010586,13,9,4,2.00151541171993,10.9984845882801
"2010","never oh",18.9680545010586,13,9,4,2.00151541171993,10.9984845882801
"2010","talk say",18.9680545010586,13,9,4,2.00151541171993,10.9984845882801
"2010","tear apart",18.9680545010586,13,9,4,2.00151541171993,10.9984845882801
"2010","thread",18.9680545010586,13,9,4,2.00151541171993,10.9984845882801
"2010","want party",18.9680545010586,13,9,4,2.00151541171993,10.9984845882801
"2000","full",18.9482279048129,342,129,213,92.0273050266621,249.972694973338
"1970","always time",18.9426475451628,30,14,16,4.10543675529294,25.8945632447071
"1970","mississippi",18.9426475451628,30,14,16,4.10543675529294,25.8945632447071
"1970","rocky",18.9426475451628,30,14,16,4.10543675529294,25.8945632447071
"1980","ill keep",18.9176821436758,66,26,40,11.1035580244761,54.8964419755239
"1990","love always",18.9121500096273,79,34,45,16.759430978433,62.240569021567
"1970","wine",18.9074933727618,161,43,118,22.0325105867388,138.967489413261
"1970","young",18.9032566047442,589,119,470,80.6034082955847,508.396591704415
"1970","come yeah yeah",18.8983392890783,9,7,2,1.23163102658788,7.76836897341212
"1970","fun youre",18.8983392890783,9,7,2,1.23163102658788,7.76836897341212
"1970","girl fall",18.8983392890783,9,7,2,1.23163102658788,7.76836897341212
"1970","girl fall love",18.8983392890783,9,7,2,1.23163102658788,7.76836897341212
"1970","gotta find",18.8983392890783,9,7,2,1.23163102658788,7.76836897341212
"1970","gotta rock",18.8983392890783,9,7,2,1.23163102658788,7.76836897341212
"1970","knows like",18.8983392890783,9,7,2,1.23163102658788,7.76836897341212
"1970","leave today",18.8983392890783,9,7,2,1.23163102658788,7.76836897341212
"1970","let hear ya",18.8983392890783,9,7,2,1.23163102658788,7.76836897341212
"1970","light taking",18.8983392890783,9,7,2,1.23163102658788,7.76836897341212
"1970","little children",18.8983392890783,9,7,2,1.23163102658788,7.76836897341212
"1970","money wont",18.8983392890783,9,7,2,1.23163102658788,7.76836897341212
"1970","nothin can take",18.8983392890783,9,7,2,1.23163102658788,7.76836897341212
"1970","reelin",18.8983392890783,9,7,2,1.23163102658788,7.76836897341212
"1970","son gun",18.8983392890783,9,7,2,1.23163102658788,7.76836897341212
"1970","wooo",18.8983392890783,9,7,2,1.23163102658788,7.76836897341212
"1970","yesterday",18.8900517965797,131,37,94,17.9270738314458,113.072926168554
"2000","im comin",18.8832421610103,45,26,19,12.1088559245608,32.8911440754392
"2000","raw",18.8832421610103,45,26,19,12.1088559245608,32.8911440754392
"2000","dont know",18.8812614780074,1641,521,1120,441.569612715651,1199.43038728435
"1970","aint stoppin",18.8788811879978,20,11,9,2.73695783686196,17.263042163138
"1970","beat around",18.8788811879978,20,11,9,2.73695783686196,17.263042163138
"1970","beautiful day",18.8788811879978,20,11,9,2.73695783686196,17.263042163138
"1970","high enough",18.8788811879978,20,11,9,2.73695783686196,17.263042163138
"1970","lovin baby",18.8788811879978,20,11,9,2.73695783686196,17.263042163138
"1970","signed",18.8788811879978,20,11,9,2.73695783686196,17.263042163138
"2010","go oh oh",18.8760458954158,34,16,18,5.23473261526751,28.7652673847325
"1980","wont take",18.869167046257,85,31,54,14.3000368497041,70.6999631502959
"1990","upi",18.8294605981142,40,21,19,8.48578783718126,31.5142121628187
"1980","bop",18.823544807136,284,77,207,47.7789466507761,236.221053349224
"2000","im sorry",18.8132753337242,144,63,81,38.7483389585946,105.251661041405
"2000","say baby",18.8068320576432,38,23,15,10.2252561140736,27.7747438859264
"1980","dripping",18.8041720122414,20,12,8,3.36471455287156,16.6352854471284
"1980","good like",18.8041720122414,20,12,8,3.36471455287156,16.6352854471284
"1980","make think",18.8041720122414,20,12,8,3.36471455287156,16.6352854471284
"1980","without come",18.8041720122414,20,12,8,3.36471455287156,16.6352854471284
"1980","youre talking",18.8041720122414,20,12,8,3.36471455287156,16.6352854471284
"1970","easy dont",18.8031960950173,17,10,7,2.32641416133266,14.6735858386673
"1970","get far",18.8031960950173,17,10,7,2.32641416133266,14.6735858386673
"1970","glad im",18.8031960950173,17,10,7,2.32641416133266,14.6735858386673
"1970","hangin around",18.8031960950173,17,10,7,2.32641416133266,14.6735858386673
"1970","love oh love",18.8031960950173,17,10,7,2.32641416133266,14.6735858386673
"1970","love save",18.8031960950173,17,10,7,2.32641416133266,14.6735858386673
"1970","plays fool",18.8031960950173,17,10,7,2.32641416133266,14.6735858386673
"1970","rainy days",18.8031960950173,17,10,7,2.32641416133266,14.6735858386673
"1970","tat",18.8031960950173,17,10,7,2.32641416133266,14.6735858386673
"1970","till die",18.8031960950173,17,10,7,2.32641416133266,14.6735858386673
"1970","umm",18.8031960950173,17,10,7,2.32641416133266,14.6735858386673
"1990","upside",18.7992754897416,76,33,43,16.1229968906444,59.8770031093556
"2010","yeah can",18.7975774131727,52,21,31,8.00606164687973,43.9939383531203
"2000","fiesta",18.7899714250714,29,19,10,7.80348492916141,21.1965150708386
"2000","jail",18.7899714250714,29,19,10,7.80348492916141,21.1965150708386
"2000","motherfuckers",18.7899714250714,29,19,10,7.80348492916141,21.1965150708386
"2000","touchin",18.7899714250714,29,19,10,7.80348492916141,21.1965150708386
"1960","bit little bit",18.7794489869885,21,8,13,1.25418874125035,19.7458112587496
"1960","eve",18.7794489869885,21,8,13,1.25418874125035,19.7458112587496
"1960","eyes still",18.7794489869885,21,8,13,1.25418874125035,19.7458112587496
"1960","little bit little bit",18.7794489869885,21,8,13,1.25418874125035,19.7458112587496
"1960","oh darling",18.7794489869885,21,8,13,1.25418874125035,19.7458112587496
"1960","woman love",18.7794489869885,21,8,13,1.25418874125035,19.7458112587496
"1970","till",18.7730524760916,692,136,556,94.6987411554238,597.301258844576
"1980","wild wild",18.7697687664275,93,33,60,15.6459226708527,77.3540773291473
"2010","fall",18.7598595635613,925,192,733,142.415519680072,782.584480319928
"1980","beating",18.7460048525209,97,34,63,16.3188655814271,80.6811344185729
"2000","alright",18.74438407577,705,242,463,189.705409484786,515.294590515214
"2000","stage",18.7291659714504,65,34,31,17.49056966881,47.50943033119
"1960","play game",18.7098332939968,54,13,41,3.22505676321519,50.7749432367848
"1960","cry cry",18.7083352689218,33,10,23,1.97086802196484,31.0291319780352
"1960","red light",18.7083352689218,33,10,23,1.97086802196484,31.0291319780352
"1990","get little",18.6962263087414,73,32,41,15.4865628028558,57.5134371971442
"1960","yes",18.6853641704231,1017,96,921,60.7385690405528,956.261430959447
"1980","wanna ride",18.6793340392638,45,20,25,7.57060774396101,37.429392256039
"1980","shell",18.6673269446358,203,59,144,34.1518527116463,168.848147288354
"1960","now baby",18.6587893686758,151,24,127,9.01821428232397,141.981785717676
"2010","im good",18.6540100115505,56,22,34,8.62191254279355,47.3780874572064
"1990","dre",18.648530456383,43,22,21,9.12222192496986,33.8777780750301
"1990","dream love",18.6337555112726,32,18,14,6.78863026974501,25.211369730255
"1990","velvet",18.6337555112726,32,18,14,6.78863026974501,25.211369730255
"2010","shake",18.6328097561738,1207,242,965,185.833007841997,1021.166992158
"1960","know shed",18.6308733304213,16,7,9,0.955572374285983,15.044427625714
"1960","let shine",18.6308733304213,16,7,9,0.955572374285983,15.044427625714
"1960","made happy",18.6308733304213,16,7,9,0.955572374285983,15.044427625714
"1990","doom",18.6207791009997,15,11,4,3.18217043894297,11.817829561057
"1990","show party",18.6207791009997,15,11,4,3.18217043894297,11.817829561057
"1960","yeah yeah yeah",18.616788144808,913,88,825,54.5273486076939,858.472651392306
"1970","distant",18.5964742583986,34,15,19,4.65282832266533,29.3471716773347
"1970","left behind",18.5964742583986,34,15,19,4.65282832266533,29.3471716773347
"1970","love alive",18.5964742583986,34,15,19,4.65282832266533,29.3471716773347
"1960","go now go",18.5697558838714,27,9,18,1.6125283816076,25.3874716183924
"1960","now youre gone",18.5697558838714,27,9,18,1.6125283816076,25.3874716183924
"1980","walk walk",18.5696315521807,32,16,16,5.38354328459449,26.6164567154055
"1980","close",18.5606624368157,764,175,589,128.532095919694,635.467904080306
"2010","one knows",18.5595684230278,60,23,37,9.23776343870738,50.7622365612926
"1980","love will",18.558942907394,262,72,190,44.0777606426174,217.922239357383
"2010","thats real",18.5386206887069,31,15,16,4.77284444333215,26.2271555566679
"1980","just thinking",18.533893017603,23,13,10,3.86942173580229,19.1305782641977
"2000","god damn",18.5286124970574,27,18,9,7.26531355473648,19.7346864452635
"1970","year",18.5235619464681,132,37,95,18.0639217232889,113.936078276711
"2010","love life",18.5233313529953,76,27,49,11.7011670223627,64.2988329776373
"1990","speak",18.4891612600508,147,54,93,31.1852703016411,115.814729698359
"2010","beats",18.4846910484603,68,25,43,10.469465230535,57.530534769465
"1980","give little bit",18.4614011272438,29,15,14,4.87883610166376,24.1211638983362
"2000","whoa ooh",18.4547607218189,43,25,18,11.5706845501359,31.4293154498641
"1970","keep dancin",18.4387159727173,27,13,14,3.69489307976364,23.3051069202364
"1970","love right now",18.4387159727173,27,13,14,3.69489307976364,23.3051069202364
"1980","deja vu",18.4381897473366,26,14,12,4.37412891873303,21.625871081267
"1980","invisible",18.4381897473366,26,14,12,4.37412891873303,21.625871081267
"1980","oh shes",18.4381897473366,26,14,12,4.37412891873303,21.625871081267
"1990","something can",18.4373894378679,49,24,25,10.3950901005471,38.604909899453
"1990","cant nothin",18.4314591985974,11,9,2,2.33359165522485,8.66640834477515
"1990","given heart",18.4314591985974,11,9,2,2.33359165522485,8.66640834477515
"1990","ill give everything",18.4314591985974,11,9,2,2.33359165522485,8.66640834477515
"1990","ill rock",18.4314591985974,11,9,2,2.33359165522485,8.66640834477515
"1990","may got",18.4314591985974,11,9,2,2.33359165522485,8.66640834477515
"1990","pray lord",18.4314591985974,11,9,2,2.33359165522485,8.66640834477515
"1990","spice life",18.4314591985974,11,9,2,2.33359165522485,8.66640834477515
"1990","tell kind",18.4314591985974,11,9,2,2.33359165522485,8.66640834477515
"1990","want will",18.4314591985974,11,9,2,2.33359165522485,8.66640834477515
"1990","whippin",18.4314591985974,11,9,2,2.33359165522485,8.66640834477515
"1980","shining",18.4263864448758,160,49,111,26.9177164229725,133.082283577028
"2000","back door",18.4228809280905,36,22,14,9.68708473964864,26.3129152603514
"2000","follow follow",18.4228809280905,36,22,14,9.68708473964864,26.3129152603514
"2000","whoa ooh whoa",18.4228809280905,36,22,14,9.68708473964864,26.3129152603514
"2000","spend",18.4225542773762,291,112,179,78.3039349788265,212.696065021173
"1970","say goodbye",18.4086029540091,178,46,132,24.3589247480714,153.641075251929
"1990","lead back",18.3950714625959,13,10,3,2.75788104708391,10.2421189529161
"1990","miss dont",18.3950714625959,13,10,3,2.75788104708391,10.2421189529161
"1990","times got",18.3950714625959,13,10,3,2.75788104708391,10.2421189529161
"1990","together know",18.3950714625959,13,10,3,2.75788104708391,10.2421189529161
"1990","work ill",18.3950714625959,13,10,3,2.75788104708391,10.2421189529161
"1980","blood runs",18.3944198456649,15,10,5,2.52353591465367,12.4764640853463
"1980","elevator",18.3944198456649,15,10,5,2.52353591465367,12.4764640853463
"1980","gonna feel",18.3944198456649,15,10,5,2.52353591465367,12.4764640853463
"1980","love love way",18.3944198456649,15,10,5,2.52353591465367,12.4764640853463
"1980","shake just like",18.3944198456649,15,10,5,2.52353591465367,12.4764640853463
"1990","like like like like",18.3897755671324,52,25,27,11.0315241883356,40.9684758116644
"1990","dont belong",18.3874830889135,22,14,8,4.6671833104497,17.3328166895503
"1990","im confused",18.3874830889135,22,14,8,4.6671833104497,17.3328166895503
"1990","things gonna",18.3874830889135,22,14,8,4.6671833104497,17.3328166895503
"1990","know im gonna",18.3806219896034,58,27,31,12.3043923639128,45.6956076360872
"2010","just dance",18.3802277855137,38,17,21,5.85058351118134,32.1494164888187
"1980","kisses",18.3799311738086,118,39,79,19.8518158619422,98.1481841380578
"2000","circus",18.3740914122075,15,12,3,4.03628530818693,10.9637146918131
"2000","comes way",18.3740914122075,15,12,3,4.03628530818693,10.9637146918131
"2000","else cause",18.3740914122075,15,12,3,4.03628530818693,10.9637146918131
"2000","hey turn",18.3740914122075,15,12,3,4.03628530818693,10.9637146918131
"2000","home theres",18.3740914122075,15,12,3,4.03628530818693,10.9637146918131
"2000","jus",18.3740914122075,15,12,3,4.03628530818693,10.9637146918131
"2000","just play",18.3740914122075,15,12,3,4.03628530818693,10.9637146918131
"2000","lamborghini",18.3740914122075,15,12,3,4.03628530818693,10.9637146918131
"2000","matter go",18.3740914122075,15,12,3,4.03628530818693,10.9637146918131
"2000","music got",18.3740914122075,15,12,3,4.03628530818693,10.9637146918131
"2000","never right",18.3740914122075,15,12,3,4.03628530818693,10.9637146918131
"2000","open now",18.3740914122075,15,12,3,4.03628530818693,10.9637146918131
"2000","put bed",18.3740914122075,15,12,3,4.03628530818693,10.9637146918131
"2000","sing now",18.3740914122075,15,12,3,4.03628530818693,10.9637146918131
"2000","whats happenin",18.3740914122075,15,12,3,4.03628530818693,10.9637146918131
"1990","cant let go",18.3724047720769,55,26,29,11.6679582761242,43.3320417238758
"1980","answers",18.3614400344343,42,19,23,7.06590056103027,34.9340994389697
"1980","burns",18.3614400344343,42,19,23,7.06590056103027,34.9340994389697
"1990","playin",18.3407375997486,212,72,140,44.9746755370607,167.025324462939
"2010","love love",18.3267171816139,1001,205,796,154.116686702435,846.883313297565
"1980","says",18.3215476093862,361,93,268,60.7330976793316,300.266902320668
"2000","play love",18.3045357952519,25,17,8,6.72714218031156,18.2728578196884
"2000","yeah theres",18.3045357952519,25,17,8,6.72714218031156,18.2728578196884
"2000","yo yo",18.3045357952519,25,17,8,6.72714218031156,18.2728578196884
"1960","somebody love",18.2879605274858,55,13,42,3.28478003660807,51.7152199633919
"2010","admit im",18.2571738443252,16,10,6,2.4634035836553,13.5365964163447
"2010","artist",18.2571738443252,16,10,6,2.4634035836553,13.5365964163447
"2010","going head",18.2571738443252,16,10,6,2.4634035836553,13.5365964163447
"2010","life come",18.2571738443252,16,10,6,2.4634035836553,13.5365964163447
"2010","must way",18.2571738443252,16,10,6,2.4634035836553,13.5365964163447
"2010","never looked",18.2571738443252,16,10,6,2.4634035836553,13.5365964163447
"2010","sticks stones",18.2571738443252,16,10,6,2.4634035836553,13.5365964163447
"2010","volume",18.2571738443252,16,10,6,2.4634035836553,13.5365964163447
"2010","way shake",18.2571738443252,16,10,6,2.4634035836553,13.5365964163447
"2010","sound like",18.2543831593565,28,14,14,4.31095627139678,23.6890437286032
"2000","chevy",18.2537862259851,63,33,30,16.9523982943851,46.0476017056149
"2000","girl love",18.2316471768413,76,38,38,20.4505122281471,55.5494877718529
"1980","everybodys",18.2137521431749,152,47,105,25.5718306018238,126.428169398176
"2010","ridin",18.1868523613761,198,54,144,30.4846193477343,167.515380652266
"2000","hug",18.1829071286892,53,29,24,14.2615414222605,38.7384585777395
"1980","ooh ooh ooh",18.1693251789836,227,64,163,38.1895101750922,188.810489824908
"1980","love ive",18.1424957171579,71,27,44,11.944736662694,59.055263337306
"2000","front porch",18.1284870284757,23,16,7,6.18897080588663,16.8110291941134
"2000","right make",18.1284870284757,23,16,7,6.18897080588663,16.8110291941134
"2000","four",18.1204692888665,195,80,115,52.4717090064301,142.52829099357
"1990","baby ill",18.1049130368169,127,48,79,26.9423763830505,100.057623616949
"1990","gonna break",18.1038721980613,90,37,53,19.0930226336578,70.9069773663421
"2000","bumping",18.0883175145049,17,13,4,4.57445668261186,12.4255433173881
"2000","dont know name",18.0883175145049,17,13,4,4.57445668261186,12.4255433173881
"2000","im get",18.0883175145049,17,13,4,4.57445668261186,12.4255433173881
"2000","im star",18.0883175145049,17,13,4,4.57445668261186,12.4255433173881
"2000","keep cool",18.0883175145049,17,13,4,4.57445668261186,12.4255433173881
"2000","let ya",18.0883175145049,17,13,4,4.57445668261186,12.4255433173881
"2000","now im ready",18.0883175145049,17,13,4,4.57445668261186,12.4255433173881
"2000","song cause",18.0883175145049,17,13,4,4.57445668261186,12.4255433173881
"2000","years now",18.0883175145049,17,13,4,4.57445668261186,12.4255433173881
"1960","back baby",18.0824661144832,48,12,36,2.86671712285795,45.1332828771421
"2000","livin",18.081927613739,351,131,220,94.4490762115743,256.550923788426
"2010","ten",18.0708753907326,156,45,111,24.0181849406392,131.981815059361
"1980","get caught",18.0681869958535,39,18,21,6.56119337809954,32.4388066219005
"1980","lala",18.0681869958535,39,18,21,6.56119337809954,32.4388066219005
"1980","please take",18.0681869958535,39,18,21,6.56119337809954,32.4388066219005
"1980","wine",18.0662566830667,161,49,112,27.085952150616,133.914047849384
"1990","cant let",18.06518676124,134,50,84,28.4273892545572,105.572610745443
"2010","baby give one",18.0489096777469,11,8,3,1.69358996376302,9.30641003623698
"2010","bring back bring back",18.0489096777469,11,8,3,1.69358996376302,9.30641003623698
"2010","girl dont lie",18.0489096777469,11,8,3,1.69358996376302,9.30641003623698
"2010","goes night",18.0489096777469,11,8,3,1.69358996376302,9.30641003623698
"2010","hai",18.0489096777469,11,8,3,1.69358996376302,9.30641003623698
"2010","lifestyle",18.0489096777469,11,8,3,1.69358996376302,9.30641003623698
"2010","little im",18.0489096777469,11,8,3,1.69358996376302,9.30641003623698
"2010","money long",18.0489096777469,11,8,3,1.69358996376302,9.30641003623698
"2010","need bad",18.0489096777469,11,8,3,1.69358996376302,9.30641003623698
"2010","oh mean",18.0489096777469,11,8,3,1.69358996376302,9.30641003623698
"2010","side yeah",18.0489096777469,11,8,3,1.69358996376302,9.30641003623698
"2010","three six",18.0489096777469,11,8,3,1.69358996376302,9.30641003623698
"2010","times hard",18.0489096777469,11,8,3,1.69358996376302,9.30641003623698
"2010","wake im",18.0489096777469,11,8,3,1.69358996376302,9.30641003623698
"2010","walk road",18.0489096777469,11,8,3,1.69358996376302,9.30641003623698
"2010","wild one",18.0489096777469,11,8,3,1.69358996376302,9.30641003623698
"2010","write song",18.0489096777469,11,8,3,1.69358996376302,9.30641003623698
"2000","fancy",18.0455480424331,71,36,35,19.1050837920848,51.8949162079152
"2010","exist",18.0424199648822,25,13,12,3.84906809946141,21.1509319005386
"2010","honey im",18.0424199648822,25,13,12,3.84906809946141,21.1509319005386
"2010","oh yeah yeah yeah",18.0424199648822,25,13,12,3.84906809946141,21.1509319005386
"2000","panties",18.0313553175487,41,24,17,11.032513175711,29.9674868242891
"1990","standin",18.0298910487617,74,32,42,15.6987074987853,58.3012925012147
"1990","night youre",18.0294643429004,38,20,18,8.0614984453222,29.9385015546778
"1990","wanna lover",18.0294643429004,38,20,18,8.0614984453222,29.9385015546778
"2010","think ive",18.0185397166283,42,18,24,6.46643440709516,35.5335655929048
"2000","aint scared",18.0159481310844,21,15,6,5.65079943146171,15.3492005685383
"2000","awayoh",18.0159481310844,21,15,6,5.65079943146171,15.3492005685383
"2000","better think",18.0159481310844,21,15,6,5.65079943146171,15.3492005685383
"2000","got another",18.0159481310844,21,15,6,5.65079943146171,15.3492005685383
"2000","happenin",18.0159481310844,21,15,6,5.65079943146171,15.3492005685383
"2000","lost friend",18.0159481310844,21,15,6,5.65079943146171,15.3492005685383
"2000","man say",18.0159481310844,21,15,6,5.65079943146171,15.3492005685383
"2000","milk",18.0159481310844,21,15,6,5.65079943146171,15.3492005685383
"2000","tick tock",18.0159481310844,21,15,6,5.65079943146171,15.3492005685383
"1970","nearly",18.008027049698,31,14,17,4.24228464713604,26.757715352864
"1970","pardon",18.008027049698,31,14,17,4.24228464713604,26.757715352864
"1960","slip away",18.0042297540632,41,11,30,2.44865420910783,38.5513457908922
"2010","letting go",18.0017871888193,57,22,35,8.77587526677201,48.224124733228
"2010","oh yeah yeah",18.0017871888193,57,22,35,8.77587526677201,48.224124733228
"1990","whatcha",18.0015913986925,173,61,112,36.701032395809,136.298967604191
"1960","stone",18.0008220435628,154,24,130,9.19738410250259,144.802615897497
"1970","peaceful",17.9941256565785,24,12,12,3.28434940423435,20.7156505957656
"1970","take breath away",17.9941256565785,24,12,12,3.28434940423435,20.7156505957656
"2000","game dont",17.9902050858047,19,14,5,5.11262805703678,13.8873719429632
"2000","models",17.9902050858047,19,14,5,5.11262805703678,13.8873719429632
"2010","never felt",17.9870591567343,77,27,50,11.8551297463411,65.1448702536589
"2010","big enough",17.9741338768306,19,11,8,2.92529175559067,16.0747082444093
"2010","can learn",17.9741338768306,19,11,8,2.92529175559067,16.0747082444093
"2010","couch",17.9741338768306,19,11,8,2.92529175559067,16.0747082444093
"2010","face im",17.9741338768306,19,11,8,2.92529175559067,16.0747082444093
"2010","going going",17.9741338768306,19,11,8,2.92529175559067,16.0747082444093
"2010","pocket full",17.9741338768306,19,11,8,2.92529175559067,16.0747082444093
"2010","proceed",17.9741338768306,19,11,8,2.92529175559067,16.0747082444093
"1960","better go",17.9716074729031,22,8,14,1.31391201464323,20.6860879853568
"1960","honky tonk",17.9716074729031,22,8,14,1.31391201464323,20.6860879853568
"1960","tonk",17.9716074729031,22,8,14,1.31391201464323,20.6860879853568
"1970","knock",17.9462373218762,164,43,121,22.4430542622681,141.556945737732
"2010","get little",17.9381782763067,73,26,47,11.2392788504273,61.7607211495727
"2010","hit",17.9352094709737,765,162,603,117.781483843519,647.218516156481
"1960","listen",17.9332174078763,491,54,437,29.3241272359011,461.675872764099
"2010","banging",17.9325048750741,22,12,10,3.38717992752604,18.612820072474
"2010","earned",17.9325048750741,22,12,10,3.38717992752604,18.612820072474
"2010","high time",17.9325048750741,22,12,10,3.38717992752604,18.612820072474
"2010","love wouldnt",17.9325048750741,22,12,10,3.38717992752604,18.612820072474
"2010","never ever ever",17.9325048750741,22,12,10,3.38717992752604,18.612820072474
"1990","want one",17.9224628559614,71,31,40,15.0622734109967,55.9377265890033
"1960","gone gone gone",17.9198422966719,12,6,6,0.716679280714487,11.2833207192855
"1960","much fast",17.9198422966719,12,6,6,0.716679280714487,11.2833207192855
"1960","right said",17.9198422966719,12,6,6,0.716679280714487,11.2833207192855
"1960","save heart",17.9198422966719,12,6,6,0.716679280714487,11.2833207192855
"1960","shoot em",17.9198422966719,12,6,6,0.716679280714487,11.2833207192855
"1960","wanna go home",17.9198422966719,12,6,6,0.716679280714487,11.2833207192855
"1960","winters day",17.9198422966719,12,6,6,0.716679280714487,11.2833207192855
"2000","like know",17.8985889678328,109,50,59,29.3303399061584,79.6696600938416
"2000","girl just",17.8918943020424,66,34,32,17.7596553560225,48.2403446439775
"1980","hey now",17.8895907849032,46,20,26,7.73884347160458,38.2611565283954
"1960","kicks",17.8773456686338,56,13,43,3.34450331000094,52.6554966899991
"1980","perfect",17.8694309209273,219,62,157,36.8436243539436,182.156375646056
"1990","somebody tell",17.8621037903115,30,17,13,6.36434087788595,23.6356591221141
"1990","still believe",17.8621037903115,30,17,13,6.36434087788595,23.6356591221141
"1980","know wont",17.8521060621654,64,25,39,10.767086569189,53.232913430811
"1990","youre feelin",17.8443988518334,41,21,20,8.6979325331108,32.3020674668892
"1960","hangin",17.8261939752907,98,18,80,5.85288079250165,92.1471192074984
"1980","called love",17.805637958865,36,17,19,6.05648619516881,29.9435138048312
"1980","took long",17.805637958865,36,17,19,6.05648619516881,29.9435138048312
"1980","usa",17.805637958865,36,17,19,6.05648619516881,29.9435138048312
"1990","make make",17.796802320017,84,35,49,17.8201544580807,66.1798455419193
"1980","one can",17.7925244485018,103,35,68,17.3282799472885,85.6717200527115
"1980","go away",17.789323249233,91,32,59,15.3094512155656,75.6905487844344
"1960","girl dont",17.7860339302752,165,25,140,9.8543401098242,155.145659890176
"1970","better get",17.7539191929731,55,20,35,7.52663405137039,47.4733659486296
"1970","ending",17.7539191929731,55,20,35,7.52663405137039,47.4733659486296
"1990","boy mine",17.752960500353,20,13,7,4.24289391859063,15.7571060814094
"1990","dos",17.752960500353,20,13,7,4.24289391859063,15.7571060814094
"1990","genie",17.752960500353,20,13,7,4.24289391859063,15.7571060814094
"1990","ohohoh",17.752960500353,20,13,7,4.24289391859063,15.7571060814094
"1990","spice",17.752960500353,20,13,7,4.24289391859063,15.7571060814094
"1990","wed never",17.752960500353,20,13,7,4.24289391859063,15.7571060814094
"1980","disturb",17.7345028024372,18,11,7,3.0282430975844,14.9717569024156
"1980","might think",17.7345028024372,18,11,7,3.0282430975844,14.9717569024156
"1980","ooh say",17.7345028024372,18,11,7,3.0282430975844,14.9717569024156
"1980","say yeah yeah yeah",17.7345028024372,18,11,7,3.0282430975844,14.9717569024156
"1980","second hand",17.7345028024372,18,11,7,3.0282430975844,14.9717569024156
"1980","sentimental",17.7345028024372,18,11,7,3.0282430975844,14.9717569024156
"1980","shake just",17.7345028024372,18,11,7,3.0282430975844,14.9717569024156
"1980","strut",17.7345028024372,18,11,7,3.0282430975844,14.9717569024156
"1970","holding close",17.7231387233085,12,8,4,1.64217470211718,10.3578252978828
"1970","lost found",17.7231387233085,12,8,4,1.64217470211718,10.3578252978828
"1970","louisiana",17.7231387233085,12,8,4,1.64217470211718,10.3578252978828
"1970","morning theres",17.7231387233085,12,8,4,1.64217470211718,10.3578252978828
"1970","never believe",17.7231387233085,12,8,4,1.64217470211718,10.3578252978828
"1970","ooh ooh baby",17.7231387233085,12,8,4,1.64217470211718,10.3578252978828
"1970","running running",17.7231387233085,12,8,4,1.64217470211718,10.3578252978828
"1970","sound crazy",17.7231387233085,12,8,4,1.64217470211718,10.3578252978828
"1970","think can make",17.7231387233085,12,8,4,1.64217470211718,10.3578252978828
"1970","till day die",17.7231387233085,12,8,4,1.64217470211718,10.3578252978828
"1970","youve become",17.7231387233085,12,8,4,1.64217470211718,10.3578252978828
"2000","nose",17.7168684854548,56,30,26,15.0687984838979,40.9312015161021
"2000","rocks",17.7168684854548,56,30,26,15.0687984838979,40.9312015161021
"1990","still one",17.7158598451272,44,22,22,9.33436662089939,34.6656333791006
"2000","got going",17.6919862556184,32,20,12,8.61074199079879,23.3892580092012
"2000","maker",17.6919862556184,32,20,12,8.61074199079879,23.3892580092012
"2000","maybe well",17.6919862556184,32,20,12,8.61074199079879,23.3892580092012
"2010","sexy",17.6790872183391,401,94,307,61.739052315361,339.260947684639
"1990","got man",17.672536668676,62,28,34,13.152971147631,48.847028852369
"2000","wish",17.6623358320321,839,281,558,225.762891571256,613.237108428744
"1960","back arms",17.6492803260815,17,7,10,1.01529564767886,15.9847043523211
"1960","everybody look",17.6492803260815,17,7,10,1.01529564767886,15.9847043523211
"1960","fellow",17.6492803260815,17,7,10,1.01529564767886,15.9847043523211
"1960","na hey",17.6492803260815,17,7,10,1.01529564767886,15.9847043523211
"1960","na na hey",17.6492803260815,17,7,10,1.01529564767886,15.9847043523211
"1960","run baby",17.6492803260815,17,7,10,1.01529564767886,15.9847043523211
"1960","trains",17.6492803260815,17,7,10,1.01529564767886,15.9847043523211
"2010","dark",17.6385109665493,329,80,249,50.6537361889121,278.346263811088
"1970","come take hand",17.6342179102492,21,11,10,2.87380572870506,18.1261942712949
"1970","step right",17.6342179102492,21,11,10,2.87380572870506,18.1261942712949
"1980","dance lets",17.6333275468791,57,23,34,9.58943647568394,47.4105635243161
"1980","let rock",17.6333275468791,57,23,34,9.58943647568394,47.4105635243161
"1990","go say",17.6328345294711,25,15,10,5.30361739823829,19.6963826017617
"1990","im kind",17.6328345294711,25,15,10,5.30361739823829,19.6963826017617
"1970","youve got",17.6240589320537,391,84,307,53.5075257106513,337.492474289349
"1990","real",17.6236191246338,1354,352,1002,287.243918288586,1066.75608171141
"1990","release",17.5852322063484,56,26,30,11.8801029720538,44.1198970279462
"1980","mean thing",17.5820572704141,33,16,17,5.55177901223807,27.4482209877619
"1970","baby shes",17.5780680110289,47,18,29,6.4318509166256,40.5681490833744
"1960","let show",17.5745646193333,90,17,73,5.37509460535865,84.6249053946413
"1990","yeah come",17.5733229291762,53,25,28,11.2436688842652,41.7563311157348
"1990","yeah know",17.5703630652927,111,43,68,23.548061248178,87.451938751822
"1970","give us",17.5617082867644,43,17,26,5.88445934925321,37.1155406507468
"1970","hesitate",17.5617082867644,43,17,26,5.88445934925321,37.1155406507468
"1960","ive gotta",17.5608515602586,35,10,25,2.09031456875059,32.9096854312494
"2010","order",17.5492768076995,39,17,22,6.0045462351598,32.9954537648402
"1980","remember remember",17.5447403541516,43,19,24,7.23413628867385,35.7658637113261
"1990","love give",17.5293985243817,91,37,54,19.3051673295874,71.6948326704126
"1990","bye bye",17.5143437004153,78,33,45,16.5472862825035,61.4527137174965
"1960","crystal",17.5114171804328,42,11,31,2.50837748250071,39.4916225174993
"1960","thats way love",17.5114171804328,42,11,31,2.50837748250071,39.4916225174993
"1980","along came",17.5083681872693,13,9,4,2.18706445936651,10.8129355406335
"1980","around turn",17.5083681872693,13,9,4,2.18706445936651,10.8129355406335
"1980","give night",17.5083681872693,13,9,4,2.18706445936651,10.8129355406335
"1980","ill friend ill",17.5083681872693,13,9,4,2.18706445936651,10.8129355406335
"1980","let never",17.5083681872693,13,9,4,2.18706445936651,10.8129355406335
"1980","lonely youre",17.5083681872693,13,9,4,2.18706445936651,10.8129355406335
"1980","movin keep movin",17.5083681872693,13,9,4,2.18706445936651,10.8129355406335
"1990","change world",17.4961366980291,33,18,15,7.00077496567454,25.9992250343255
"1970","kept",17.4732207304435,125,35,90,17.1059864803872,107.894013519613
"1960","blue",17.4692623882137,471,52,419,28.1296617680436,442.870338231956
"1970","treat like",17.4628927216702,82,26,56,11.221527131134,70.778472868866
"1960","flash",17.4556803715047,65,14,51,3.88201277053681,61.1179872294632
"1970","ive got love",17.4526836676254,28,13,15,3.83174097160674,24.1682590283933
"1970","love baby",17.4287487297377,421,89,332,57.6129624659442,363.387037534056
"1960","come baby",17.4177463532536,177,26,151,10.5710193905387,166.428980609461
"1980","got perfect",17.4109107047922,21,12,9,3.53295028051514,17.4670497194849
"1980","reaction",17.4109107047922,21,12,9,3.53295028051514,17.4670497194849
"1980","really miss",17.4109107047922,21,12,9,3.53295028051514,17.4670497194849
"1980","typical",17.4109107047922,21,12,9,3.53295028051514,17.4670497194849
"1980","feel heart",17.4090295801694,30,15,15,5.04707182930734,24.9529281706927
"1980","ride like",17.4090295801694,30,15,15,5.04707182930734,24.9529281706927
"1980","two us",17.4090295801694,30,15,15,5.04707182930734,24.9529281706927
"1970","weve",17.3962039173356,427,90,337,58.4340498170028,368.565950182997
"1970","talkin",17.38863669477,335,74,261,45.8440437674378,289.155956232562
"1970","blue sea",17.3755566423743,15,9,6,2.05271837764647,12.9472816223535
"1970","climbed",17.3755566423743,15,9,6,2.05271837764647,12.9472816223535
"1970","get ready cause",17.3755566423743,15,9,6,2.05271837764647,12.9472816223535
"1970","lalala",17.3755566423743,15,9,6,2.05271837764647,12.9472816223535
"1970","love grow",17.3755566423743,15,9,6,2.05271837764647,12.9472816223535
"1970","woman youre",17.3755566423743,15,9,6,2.05271837764647,12.9472816223535
"2010","bet",17.3751617020361,225,59,166,34.6416128951527,190.358387104847
"2000","hypnotized",17.371498901265,44,25,19,11.8397702373483,32.1602297626517
"2000","now thats",17.371498901265,44,25,19,11.8397702373483,32.1602297626517
"1990","huh",17.3670975319612,618,175,443,131.105422084451,486.89457791555
"2000","dont wanna",17.3610548951762,771,260,511,207.465064840808,563.534935159191
"2000","ooh dont",17.3501988967848,30,19,11,8.07257061637387,21.9274293836261
"2000","peaches",17.3501988967848,30,19,11,8.07257061637387,21.9274293836261
"2000","bottle",17.3406631182807,124,55,69,33.3666252143453,90.6333747856547
"2010","pair",17.3349024419499,62,23,39,9.54568888666429,52.4543111133357
"2010","baby wrong",17.3286824637649,9,7,2,1.38566451580611,7.61433548419389
"2010","back think",17.3286824637649,9,7,2,1.38566451580611,7.61433548419389
"2010","blow kiss",17.3286824637649,9,7,2,1.38566451580611,7.61433548419389
"2010","can burn",17.3286824637649,9,7,2,1.38566451580611,7.61433548419389
"2010","es que",17.3286824637649,9,7,2,1.38566451580611,7.61433548419389
"2010","got million",17.3286824637649,9,7,2,1.38566451580611,7.61433548419389
"2010","ive good",17.3286824637649,9,7,2,1.38566451580611,7.61433548419389
"2010","like whoa",17.3286824637649,9,7,2,1.38566451580611,7.61433548419389
"2010","pretty please",17.3286824637649,9,7,2,1.38566451580611,7.61433548419389
"1980","wildest",17.3033550689082,27,14,13,4.5423646463766,22.4576353536234
"2000","aint even",17.2951436931801,88,42,46,23.6795404746967,64.3204595253033
"1980","dont live",17.2904496449261,24,13,11,4.03765746344587,19.9623425365541
"1980","got somebody",17.2904496449261,24,13,11,4.03765746344587,19.9623425365541
"2000","now",17.2819285010102,6525,1906,4619,1755.78410906132,4769.21589093868
"1960","gimme gimme",17.26980182876,100,18,82,5.97232733928739,94.0276726607126
"1960","get life",17.2640203949263,29,9,20,1.73197492839334,27.2680250716067
"1960","little piece",17.2640203949263,29,9,20,1.73197492839334,27.2680250716067
"1960","now dont know",17.2640203949263,29,9,20,1.73197492839334,27.2680250716067
"2000","rock boat",17.2620396442474,49,27,22,13.1851986734107,35.8148013265894
"2010","cant feel",17.2511688072043,43,18,25,6.62039713107362,36.3796028689264
"2010","im loving",17.2511688072043,43,18,25,6.62039713107362,36.3796028689264
"1980","time know",17.2397559863734,65,25,40,10.9353222968326,54.0646777031674
"2010","got magic",17.2369621115023,29,14,15,4.46491899537523,24.5350810046248
"2010","stay night",17.2369621115023,29,14,15,4.46491899537523,24.5350810046248
"2010","tonight im gonna",17.2369621115023,29,14,15,4.46491899537523,24.5350810046248
"1990","strike",17.2300545142438,36,19,17,7.63720905346314,28.3627909465369
"1970","know can",17.2214799012897,241,57,184,32.9803419341866,208.019658065813
"1980","time right",17.2199770378334,40,18,22,6.72942910574312,33.2705708942569
"1960","hold love",17.2158044058367,23,8,15,1.3736352880361,21.6263647119639
"1960","honky",17.2158044058367,23,8,15,1.3736352880361,21.6263647119639
"1960","little red",17.2158044058367,23,8,15,1.3736352880361,21.6263647119639
"1960","penny",17.2158044058367,23,8,15,1.3736352880361,21.6263647119639
"1960","pouring rain",17.2158044058367,23,8,15,1.3736352880361,21.6263647119639
"2000","lets just",17.2031378556408,37,22,15,9.9561704268611,27.0438295731389
"2000","praise",17.2031378556408,37,22,15,9.9561704268611,27.0438295731389
"2000","umbrella",17.2031378556408,37,22,15,9.9561704268611,27.0438295731389
"1980","feeling",17.1887465651019,922,204,718,155.113340887379,766.886659112621
"1980","mirror",17.1620899109441,142,44,98,23.8894733253881,118.110526674612
"1970","died",17.1598238361826,116,33,83,15.8743554537994,100.125644546201
"1990","come baby come",17.1584609242886,18,12,6,3.81860452673157,14.1813954732684
"1990","just call name",17.1584609242886,18,12,6,3.81860452673157,14.1813954732684
"1990","loot",17.1584609242886,18,12,6,3.81860452673157,14.1813954732684
"1990","love remember",17.1584609242886,18,12,6,3.81860452673157,14.1813954732684
"1990","love want love",17.1584609242886,18,12,6,3.81860452673157,14.1813954732684
"1990","rob",17.1584609242886,18,12,6,3.81860452673157,14.1813954732684
"1990","something believe",17.1584609242886,18,12,6,3.81860452673157,14.1813954732684
"1990","vibration",17.1584609242886,18,12,6,3.81860452673157,14.1813954732684
"1990","return",17.1505409732177,69,30,39,14.6379840191377,54.3620159808623
"1980","candle",17.1333078978714,47,20,27,7.90707919924816,39.0929208007518
"1970","behind",17.1220057431138,342,75,267,46.8019790103395,295.198020989661
"1990","little bit",17.1123921088519,419,125,294,88.8886275944737,330.111372405526
"2000","gangsta",17.1085304409299,91,43,48,24.4867975363341,66.5132024636659
"1980","ive waiting",17.1035013060746,69,26,43,11.6082652074069,57.3917347925931
"2010","ass nigga",17.101540518924,14,9,5,2.15547813569839,11.8445218643016
"2010","baby baby baby oh",17.101540518924,14,9,5,2.15547813569839,11.8445218643016
"2010","baby baby yeah",17.101540518924,14,9,5,2.15547813569839,11.8445218643016
"2010","blown away",17.101540518924,14,9,5,2.15547813569839,11.8445218643016
"2010","doin im",17.101540518924,14,9,5,2.15547813569839,11.8445218643016
"2010","everybody yeah",17.101540518924,14,9,5,2.15547813569839,11.8445218643016
"2010","im glad came",17.101540518924,14,9,5,2.15547813569839,11.8445218643016
"2010","last last",17.101540518924,14,9,5,2.15547813569839,11.8445218643016
"2010","loveyour",17.101540518924,14,9,5,2.15547813569839,11.8445218643016
"2010","name whats",17.101540518924,14,9,5,2.15547813569839,11.8445218643016
"2010","new thing",17.101540518924,14,9,5,2.15547813569839,11.8445218643016
"2010","rock girl",17.101540518924,14,9,5,2.15547813569839,11.8445218643016
"2010","stunt",17.101540518924,14,9,5,2.15547813569839,11.8445218643016
"2010","praying",17.0998730937942,36,16,20,5.54265806322443,30.4573419367756
"1990","describe",17.0953007560666,28,16,12,5.94005148602689,22.0599485139731
"1990","feel yeah",17.0953007560666,28,16,12,5.94005148602689,22.0599485139731
"2000","room",17.0907782017105,389,142,247,104.674332325648,284.325667674352
"1960","cant hear",17.0530427136659,83,16,67,4.95703169160854,78.0429683083915
"2010","yeah just",17.0521729707668,83,28,55,12.7789060902119,70.2210939097881
"1990","waste time",17.0495082978386,66,29,37,14.0015499313491,51.9984500686509
"2010","never never never",17.0407041156134,47,19,28,7.23624802698745,39.7637519730126
"2010","youre beautiful",17.0407041156134,47,19,28,7.23624802698745,39.7637519730126
"2000","deck",17.0289282498526,28,18,10,7.53439924194894,20.4656007580511
"2000","frustrated",17.0289282498526,28,18,10,7.53439924194894,20.4656007580511
"2000","got ya",17.0289282498526,28,18,10,7.53439924194894,20.4656007580511
"2000","hey know",17.0289282498526,28,18,10,7.53439924194894,20.4656007580511
"2000","lame",17.0289282498526,28,18,10,7.53439924194894,20.4656007580511
"2000","parking",17.0289282498526,28,18,10,7.53439924194894,20.4656007580511
"1990","round round",17.0238015578244,154,55,99,32.6702831731479,121.329716826852
"2000","spin",17.0215361003189,83,40,43,22.3341120386344,60.6658879613656
"1990","one",17.014606171535,5413,1274,4139,1148.33923906655,4264.66076093345
"1960","guy",17.0047184216037,243,32,211,14.5127554344684,228.487244565532
"2000","im tired",16.9674385951049,105,48,57,28.2539971573085,76.7460028426915
"1990","havin",16.9609551798169,63,28,35,13.3651158435605,49.6348841564395
"1990","just make",16.9609551798169,63,28,35,13.3651158435605,49.6348841564395
"2010","oh oh youre",16.9504986479739,26,13,13,4.00303082343986,21.9969691765601
"2010","will will will",16.9504986479739,26,13,13,4.00303082343986,21.9969691765601
"2010","yeah take",16.9504986479739,26,13,13,4.00303082343986,21.9969691765601
"2010","youre perfect",16.9504986479739,26,13,13,4.00303082343986,21.9969691765601
"1970","like first time",16.9455449328099,36,15,21,4.92652410635153,31.0734758936485
"1970","gone oh",16.9421706656045,25,12,13,3.42119729607745,21.5788027039226
"1970","song ill",16.9421706656045,25,12,13,3.42119729607745,21.5788027039226
"1970","well see",16.9421706656045,25,12,13,3.42119729607745,21.5788027039226
"2000","make life",16.9310645283936,42,24,18,11.3015988629234,30.6984011370766
"2000","thing like",16.9310645283936,42,24,18,11.3015988629234,30.6984011370766
"1980","just wait",16.9200981354675,37,17,20,6.22472192281238,30.7752780771876
"1990","bond",16.9164764896357,23,14,9,4.87932800637923,18.1206719936208
"1990","em say",16.9164764896357,23,14,9,4.87932800637923,18.1206719936208
"1990","heartbreak",16.9164764896357,23,14,9,4.87932800637923,18.1206719936208
"1990","ill remember",16.9164764896357,23,14,9,4.87932800637923,18.1206719936208
"1990","loca",16.9164764896357,23,14,9,4.87932800637923,18.1206719936208
"1990","underground",16.9164764896357,23,14,9,4.87932800637923,18.1206719936208
"1990","wednesday thursday",16.9164764896357,23,14,9,4.87932800637923,18.1206719936208
"1990","give something",16.9105934885305,42,21,21,8.91007722904033,33.0899227709597
"1990","ooo baby",16.9105934885305,42,21,21,8.91007722904033,33.0899227709597
"2000","just wanna",16.9043604681417,377,138,239,101.445304079098,275.554695920902
"1990","really really",16.9004260323928,79,33,46,16.759430978433,62.240569021567
"2010","album",16.8979686496242,51,20,31,7.85209892290127,43.1479010770987
"1970","go love",16.8672833103739,40,16,24,5.47391567372392,34.5260843262761
"1960","gonna make",16.8585080115876,266,34,232,15.8863907225045,250.113609277496
"1980","without love",16.8338107394869,85,30,55,14.3000368497041,70.6999631502959
"1990","just tell",16.8290224744188,57,26,31,12.0922476679833,44.9077523320167
"1990","con",16.828671196103,45,22,23,9.54651131682892,35.4534886831711
"1970","mornin",16.8225637918239,112,32,80,15.326963886427,96.673036113573
"2010","look back",16.821884443715,92,30,62,14.164570606018,77.835429393982
"2010","blessed",16.8087339190217,55,21,34,8.4679498188151,46.5320501811849
"2000","boy can",16.8040890367405,47,26,21,12.6470272989857,34.3529727010143
"1990","begun",16.7905759666862,54,25,29,11.4558135801947,42.5441864198053
"1970","come true",16.7638015370292,132,36,96,18.0639217232889,113.936078276711
"2000","tellin",16.7572629909962,151,64,87,40.6319387690818,110.368061230918
"2010","work work",16.7515223109215,63,23,40,9.69965161064275,53.3003483893573
"1960","id say",16.7503069954836,18,7,11,1.07501892107173,16.9249810789283
"1960","just stand",16.7503069954836,18,7,11,1.07501892107173,16.9249810789283
"1960","march",16.7503069954836,18,7,11,1.07501892107173,16.9249810789283
"1960","must go",16.7503069954836,18,7,11,1.07501892107173,16.9249810789283
"2010","stay cause",16.7420167494931,23,12,11,3.5411426515045,19.4588573484955
"2010","theres somethin",16.7420167494931,23,12,11,3.5411426515045,19.4588573484955
"2010","whenever call",16.7420167494931,23,12,11,3.5411426515045,19.4588573484955
"1960","care can",16.7337091676912,13,6,7,0.776402554107361,12.2235974458926
"1960","hide love",16.7337091676912,13,6,7,0.776402554107361,12.2235974458926
"1960","oh wish",16.7337091676912,13,6,7,0.776402554107361,12.2235974458926
"1960","purpose",16.7337091676912,13,6,7,0.776402554107361,12.2235974458926
"1960","ready yes im",16.7337091676912,13,6,7,0.776402554107361,12.2235974458926
"1960","ready yes im ready",16.7337091676912,13,6,7,0.776402554107361,12.2235974458926
"1960","theres man",16.7337091676912,13,6,7,0.776402554107361,12.2235974458926
"1960","took surprise",16.7337091676912,13,6,7,0.776402554107361,12.2235974458926
"1960","us boy",16.7337091676912,13,6,7,0.776402554107361,12.2235974458926
"1960","wait said",16.7337091676912,13,6,7,0.776402554107361,12.2235974458926
"2000","beautiful beautiful",16.7332028772634,26,17,9,6.99622786752402,19.003772132476
"2000","chrome",16.7332028772634,26,17,9,6.99622786752402,19.003772132476
"2000","photo",16.7332028772634,26,17,9,6.99622786752402,19.003772132476
"2000","time hear",16.7332028772634,26,17,9,6.99622786752402,19.003772132476
"2000","youre better",16.7332028772634,26,17,9,6.99622786752402,19.003772132476
"1980","can face",16.732505903329,11,8,3,1.85059300407936,9.14940699592064
"1980","dead end",16.732505903329,11,8,3,1.85059300407936,9.14940699592064
"1980","dont ask just",16.732505903329,11,8,3,1.85059300407936,9.14940699592064
"1980","drives crazy",16.732505903329,11,8,3,1.85059300407936,9.14940699592064
"1980","end world",16.732505903329,11,8,3,1.85059300407936,9.14940699592064
"1980","gonna party",16.732505903329,11,8,3,1.85059300407936,9.14940699592064
"1980","gotta feel",16.732505903329,11,8,3,1.85059300407936,9.14940699592064
"1980","honey now",16.732505903329,11,8,3,1.85059300407936,9.14940699592064
"1980","late late",16.732505903329,11,8,3,1.85059300407936,9.14940699592064
"1980","like dont like",16.732505903329,11,8,3,1.85059300407936,9.14940699592064
"1980","second best",16.732505903329,11,8,3,1.85059300407936,9.14940699592064
"1980","see true",16.732505903329,11,8,3,1.85059300407936,9.14940699592064
"1980","slow youre",16.732505903329,11,8,3,1.85059300407936,9.14940699592064
"1980","sounding",16.732505903329,11,8,3,1.85059300407936,9.14940699592064
"1980","take will",16.732505903329,11,8,3,1.85059300407936,9.14940699592064
"1980","walk along",16.732505903329,11,8,3,1.85059300407936,9.14940699592064
"1980","wanna like",16.732505903329,11,8,3,1.85059300407936,9.14940699592064
"1980","way lets",16.732505903329,11,8,3,1.85059300407936,9.14940699592064
"1980","will now",16.732505903329,11,8,3,1.85059300407936,9.14940699592064
"1980","wishing well",16.732505903329,11,8,3,1.85059300407936,9.14940699592064
"1980","woman world",16.732505903329,11,8,3,1.85059300407936,9.14940699592064
"2010","just good time",16.7267714318354,17,10,7,2.61736630763376,14.3826336923662
"2010","yeah ah",16.7267714318354,17,10,7,2.61736630763376,14.3826336923662
"2010","might",16.7249833681147,702,149,553,108.081832232876,593.918167767124
"1990","can oh",16.7085436077116,31,17,14,6.57648557381548,24.4235144261845
"1990","crazy crazy",16.7085436077116,31,17,14,6.57648557381548,24.4235144261845
"1990","strong enough",16.7085436077116,31,17,14,6.57648557381548,24.4235144261845
"1990","work work work",16.7085436077116,31,17,14,6.57648557381548,24.4235144261845
"1990","youve given",16.7085436077116,31,17,14,6.57648557381548,24.4235144261845
"2000","back ya",16.6948753738976,12,10,2,3.22902824654955,8.77097175345045
"2000","em right",16.6948753738976,12,10,2,3.22902824654955,8.77097175345045
"2000","fo sho",16.6948753738976,12,10,2,3.22902824654955,8.77097175345045
"2000","get someone",16.6948753738976,12,10,2,3.22902824654955,8.77097175345045
"2000","gon tell",16.6948753738976,12,10,2,3.22902824654955,8.77097175345045
"2000","got whatever",16.6948753738976,12,10,2,3.22902824654955,8.77097175345045
"2000","ice cream",16.6948753738976,12,10,2,3.22902824654955,8.77097175345045
"2000","lie know",16.6948753738976,12,10,2,3.22902824654955,8.77097175345045
"2000","necessary",16.6948753738976,12,10,2,3.22902824654955,8.77097175345045
"2000","real never",16.6948753738976,12,10,2,3.22902824654955,8.77097175345045
"2000","said give",16.6948753738976,12,10,2,3.22902824654955,8.77097175345045
"2000","shes mind",16.6948753738976,12,10,2,3.22902824654955,8.77097175345045
"2000","thanking",16.6948753738976,12,10,2,3.22902824654955,8.77097175345045
"2000","wants girl",16.6948753738976,12,10,2,3.22902824654955,8.77097175345045
"2000","whos back",16.6948753738976,12,10,2,3.22902824654955,8.77097175345045
"2000","ya hey",16.6948753738976,12,10,2,3.22902824654955,8.77097175345045
"1980","called say",16.6882336830541,16,10,6,2.69177164229725,13.3082283577028
"1980","dont rush",16.6882336830541,16,10,6,2.69177164229725,13.3082283577028
"1980","dont want let",16.6882336830541,16,10,6,2.69177164229725,13.3082283577028
"1980","gets rough",16.6882336830541,16,10,6,2.69177164229725,13.3082283577028
"1980","know crazy",16.6882336830541,16,10,6,2.69177164229725,13.3082283577028
"1980","never think",16.6882336830541,16,10,6,2.69177164229725,13.3082283577028
"1980","now im falling",16.6882336830541,16,10,6,2.69177164229725,13.3082283577028
"1980","pout",16.6882336830541,16,10,6,2.69177164229725,13.3082283577028
"1980","theres gonna",16.6882336830541,16,10,6,2.69177164229725,13.3082283577028
"1980","youre stuck",16.6882336830541,16,10,6,2.69177164229725,13.3082283577028
"1990","everyday",16.6865799251246,243,79,164,51.5511611108762,191.448838889124
"1970","folks",16.6794447793862,70,23,47,9.57935242901686,60.4206475709831
"1980","games",16.6792826258487,165,49,116,27.7588950611904,137.24110493881
"2010","swing",16.6787920428864,101,32,69,15.5502351218241,85.4497648781759
"1990","another day",16.6713846892663,106,41,65,22.4873377685304,83.5126622314696
"1990","want dont",16.6713846892663,106,41,65,22.4873377685304,83.5126622314696
"1990","house",16.664098577897,417,124,293,88.4643382026147,328.535661797385
"1980","cheek",16.6515826492537,34,16,18,5.72001473988165,28.2799852601184
"2010","dont pay",16.6468855858811,20,11,9,3.07925447956913,16.9207455204309
"2010","enough just",16.6468855858811,20,11,9,3.07925447956913,16.9207455204309
"2010","jar",16.6468855858811,20,11,9,3.07925447956913,16.9207455204309
"2010","take aim",16.6468855858811,20,11,9,3.07925447956913,16.9207455204309
"2000","know mean",16.6355629434567,100,46,54,26.9085687212462,73.0914312787538
"2000","dee da",16.6349334033163,89,42,47,23.9486261619091,65.0513738380909
"1990","time dont",16.6278782141754,86,35,51,18.2444438499397,67.7555561500603
"1990","dont know want",16.6203519182976,16,11,5,3.39431513487251,12.6056848651275
"1990","funky funky",16.6203519182976,16,11,5,3.39431513487251,12.6056848651275
"1990","got thinkin",16.6203519182976,16,11,5,3.39431513487251,12.6056848651275
"1990","ill turn",16.6203519182976,16,11,5,3.39431513487251,12.6056848651275
"1990","im listening",16.6203519182976,16,11,5,3.39431513487251,12.6056848651275
"1990","love power",16.6203519182976,16,11,5,3.39431513487251,12.6056848651275
"1990","ohoh oh oh",16.6203519182976,16,11,5,3.39431513487251,12.6056848651275
"1990","pops",16.6203519182976,16,11,5,3.39431513487251,12.6056848651275
"2010","take take",16.6025090101051,110,34,76,16.9358996376302,93.0641003623698
"1990","break heart",16.5864700316469,113,43,70,23.9723506400371,89.0276493599629
"1960","station",16.5755939382763,44,11,33,2.62782402928645,41.3721759707135
"1980","tell can",16.5514484081086,55,22,33,9.25296502039679,45.7470349796032
"1970","rose",16.5438594965351,103,30,73,14.0953328598391,88.9046671401609
"2000","need know",16.5425223226767,172,71,101,46.2827382005435,125.717261799456
"1980","believing",16.534755298347,70,26,44,11.7765009350505,58.2234990649496
"1980","give time",16.534755298347,70,26,44,11.7765009350505,58.2234990649496
"1960","gone",16.5307003925456,1359,119,1240,81.1639285409157,1277.83607145908
"1970","around oh",16.5286398734747,29,13,16,3.96858886344984,25.0314111365502
"1970","cold ice",16.5286398734747,29,13,16,3.96858886344984,25.0314111365502
"1970","know hard",16.5286398734747,29,13,16,3.96858886344984,25.0314111365502
"1970","love gone",16.5286398734747,29,13,16,3.96858886344984,25.0314111365502
"1970","woman take",16.5286398734747,29,13,16,3.96858886344984,25.0314111365502
"1990","think can",16.5108996506453,127,47,80,26.9423763830505,100.057623616949
"1970","fool around",16.5100935276648,10,7,3,1.36847891843098,8.63152108156902
"1970","got friend",16.5100935276648,10,7,3,1.36847891843098,8.63152108156902
"1970","home place",16.5100935276648,10,7,3,1.36847891843098,8.63152108156902
"1970","id better",16.5100935276648,10,7,3,1.36847891843098,8.63152108156902
"1970","ill around",16.5100935276648,10,7,3,1.36847891843098,8.63152108156902
"1970","junkie",16.5100935276648,10,7,3,1.36847891843098,8.63152108156902
"1970","leave way",16.5100935276648,10,7,3,1.36847891843098,8.63152108156902
"1970","live love",16.5100935276648,10,7,3,1.36847891843098,8.63152108156902
"1970","make stand",16.5100935276648,10,7,3,1.36847891843098,8.63152108156902
"1970","oh love oh",16.5100935276648,10,7,3,1.36847891843098,8.63152108156902
"1970","say anything dont",16.5100935276648,10,7,3,1.36847891843098,8.63152108156902
"1970","way tell",16.5100935276648,10,7,3,1.36847891843098,8.63152108156902
"1970","ya let",16.5100935276648,10,7,3,1.36847891843098,8.63152108156902
"1960","oh heaven",16.5064496745523,24,8,16,1.43335856142897,22.566641438571
"1990","see dont",16.4973343122544,70,30,40,14.8501287150672,55.1498712849328
"1970","can share",16.494615185197,22,11,11,3.01065362054815,18.9893463794518
"1970","get closer",16.494615185197,22,11,11,3.01065362054815,18.9893463794518
"1970","take oh",16.494615185197,22,11,11,3.01065362054815,18.9893463794518
"1970","wild thing",16.494615185197,22,11,11,3.01065362054815,18.9893463794518
"2000","wonderin",16.4946077136665,40,23,17,10.7634274884985,29.2365725115015
"1990","rose",16.4736416246224,103,40,63,21.8509036807418,81.1490963192582
"2010","moves",16.4707550474387,175,48,127,26.9434766962299,148.05652330377
"2000","better keep",16.4698777751621,24,16,8,6.45805649309909,17.5419435069009
"2000","eighteen",16.4698777751621,24,16,8,6.45805649309909,17.5419435069009
"2000","go somewhere",16.4698777751621,24,16,8,6.45805649309909,17.5419435069009
"2000","long going",16.4698777751621,24,16,8,6.45805649309909,17.5419435069009
"2000","lookin back",16.4698777751621,24,16,8,6.45805649309909,17.5419435069009
"2000","mommy",16.4698777751621,24,16,8,6.45805649309909,17.5419435069009
"2000","yeahcause",16.4698777751621,24,16,8,6.45805649309909,17.5419435069009
"1970","daddys",16.4415433709802,66,22,44,9.03196086164446,56.9680391383555
"1970","theyd",16.4415433709802,66,22,44,9.03196086164446,56.9680391383555
"1990","hello hello",16.4313348200472,34,18,16,7.21291966160408,26.7870803383959
"1970","knowing",16.424046757323,133,36,97,18.200769615132,114.799230384868
"1980","ba ba ba",16.4234112900266,31,15,16,5.21530755695092,25.7846924430491
"1980","home tonight",16.4234112900266,31,15,16,5.21530755695092,25.7846924430491
"1980","night let",16.4234112900266,31,15,16,5.21530755695092,25.7846924430491
"1980","see tonight",16.4234112900266,31,15,16,5.21530755695092,25.7846924430491
"1980","still can",16.4234112900266,31,15,16,5.21530755695092,25.7846924430491
"1970","just love",16.4150691742037,53,19,34,7.25293826768419,45.7470617323158
"1970","rainy",16.4107633079127,89,27,62,12.1794623740357,76.8205376259643
"1990","love like",16.4106251494857,301,94,207,63.855553474789,237.144446525211
"2000","girl now",16.4074267676451,33,20,13,8.87982767801125,24.1201723219887
"2000","loosen",16.4074267676451,33,20,13,8.87982767801125,24.1201723219887
"2000","love dance",16.4074267676451,33,20,13,8.87982767801125,24.1201723219887
"2000","salt",16.4074267676451,33,20,13,8.87982767801125,24.1201723219887
"2000","wanna fuck",16.4074267676451,33,20,13,8.87982767801125,24.1201723219887
"1980","lies",16.3822974650736,289,76,213,48.620125288994,240.379874711006
"2000","shut",16.3678228928496,146,62,84,39.2865103330195,106.71348966698
"2010","like youre",16.365366095651,76,26,50,11.7011670223627,64.2988329776373
"2000","got girl",16.3554718911458,55,29,26,14.7997127966854,40.2002872033146
"2010","youre gonna miss",16.3533709163162,48,19,29,7.3902107509659,40.6097892490341
"1970","come come",16.3349640051093,369,79,290,50.4968720901031,318.503127909897
"1990","everybody dance",16.3344815979699,26,15,11,5.51576209416782,20.4842379058322
"1990","real just",16.3344815979699,26,15,11,5.51576209416782,20.4842379058322
"1990","take every",16.3344815979699,26,15,11,5.51576209416782,20.4842379058322
"1990","universe",16.3344815979699,26,15,11,5.51576209416782,20.4842379058322
"1990","youre ever",16.3344815979699,26,15,11,5.51576209416782,20.4842379058322
"2010","rock",16.3191726285266,1320,258,1062,203.230795651562,1116.76920434844
"1980","ba ba ba ba",16.2959398680777,19,11,8,3.19647882522798,15.803521174772
"1980","bad oh",16.2959398680777,19,11,8,3.19647882522798,15.803521174772
"1980","better day",16.2959398680777,19,11,8,3.19647882522798,15.803521174772
"1980","feel power",16.2959398680777,19,11,8,3.19647882522798,15.803521174772
"1980","remember im",16.2959398680777,19,11,8,3.19647882522798,15.803521174772
"1970","dyin",16.2938195746961,33,14,19,4.51598043082223,28.4840195691778
"2010","dont know youre",16.2860172960412,72,25,47,11.0853161264489,60.9146838735512
"2000","awhile",16.2857521021995,76,37,39,20.4505122281471,55.5494877718529
"1960","rollin",16.2844645901075,183,26,157,10.9293590308959,172.070640969104
"2010","ripped",16.283994147306,30,14,16,4.61888171935369,25.3811182806463
"2010","cant remember",16.2803462868965,37,16,21,5.69662078720288,31.3033792127971
"2010","lasts",16.2803462868965,37,16,21,5.69662078720288,31.3033792127971
"2010","love songs",16.2803462868965,37,16,21,5.69662078720288,31.3033792127971
"1990","mood",16.2747769602156,64,28,36,13.57726053949,50.42273946051
"2000","tired",16.2587770840989,282,107,175,75.8821637939144,206.117836206086
"1990","free",16.2581693542043,710,196,514,150.622734109967,559.377265890033
"2010","everybody knows",16.2491112738512,52,20,32,8.00606164687973,43.9939383531203
"2000","aint thing",16.2485691142839,22,15,7,5.91988511867417,16.0801148813258
"2000","cant handle",16.2485691142839,22,15,7,5.91988511867417,16.0801148813258
"2000","center",16.2485691142839,22,15,7,5.91988511867417,16.0801148813258
"2000","give ill give",16.2485691142839,22,15,7,5.91988511867417,16.0801148813258
"2000","nigga get",16.2485691142839,22,15,7,5.91988511867417,16.0801148813258
"1980","de de",16.2484276081581,28,14,14,4.71060037402018,23.2893996259798
"1980","feel sad",16.2484276081581,28,14,14,4.71060037402018,23.2893996259798
"1980","world know",16.2484276081581,28,14,14,4.71060037402018,23.2893996259798
"1990","way like",16.2365037942844,37,19,18,7.84935374939267,29.1506462506073
"2010","wanna wanna",16.2252556987115,68,24,44,10.469465230535,57.530534769465
"1990","come talk",16.2175132987545,21,13,8,4.45503861452016,16.5449613854798
"1990","coming like",16.2175132987545,21,13,8,4.45503861452016,16.5449613854798
"1990","en la",16.2175132987545,21,13,8,4.45503861452016,16.5449613854798
"1990","justify",16.2175132987545,21,13,8,4.45503861452016,16.5449613854798
"1990","linger",16.2175132987545,21,13,8,4.45503861452016,16.5449613854798
"1990","ohoh oh",16.2175132987545,21,13,8,4.45503861452016,16.5449613854798
"1990","rabbit",16.2175132987545,21,13,8,4.45503861452016,16.5449613854798
"1990","thats ask",16.2175132987545,21,13,8,4.45503861452016,16.5449613854798
"2000","anywhere go",16.2124778021386,14,11,3,3.76719962097447,10.2328003790255
"2000","baby whatever",16.2124778021386,14,11,3,3.76719962097447,10.2328003790255
"2000","hold never",16.2124778021386,14,11,3,3.76719962097447,10.2328003790255
"2000","inches",16.2124778021386,14,11,3,3.76719962097447,10.2328003790255
"2000","move now",16.2124778021386,14,11,3,3.76719962097447,10.2328003790255
"2000","one world",16.2124778021386,14,11,3,3.76719962097447,10.2328003790255
"2000","pay got",16.2124778021386,14,11,3,3.76719962097447,10.2328003790255
"2000","see without",16.2124778021386,14,11,3,3.76719962097447,10.2328003790255
"2000","take want go",16.2124778021386,14,11,3,3.76719962097447,10.2328003790255
"2000","youre friend",16.2124778021386,14,11,3,3.76719962097447,10.2328003790255
"1960","within",16.2089588655165,104,18,86,6.21122043285889,97.7887795671411
"1970","wonder",16.1945740003657,493,100,393,67.4660106786473,425.533989321353
"2010","building",16.1922272803276,56,21,35,8.62191254279355,47.3780874572064
"2010","kicks",16.1922272803276,56,21,35,8.62191254279355,47.3780874572064
"1980","state",16.1921795355109,63,24,39,10.5988508415454,52.4011491584546
"1990","knockin",16.1813537612319,61,27,34,12.9408264517014,48.0591735482986
"1970","youre hot",16.181237226006,37,15,22,5.06337199819462,31.9366280018054
"1990","ah ah ah",16.1760645877545,107,41,66,22.6994824644599,84.3005175355401
"1990","anything anything",16.1657123448417,14,10,4,2.97002574301344,11.0299742569866
"1990","beforei",16.1657123448417,14,10,4,2.97002574301344,11.0299742569866
"1990","can get together",16.1657123448417,14,10,4,2.97002574301344,11.0299742569866
"1990","friend will",16.1657123448417,14,10,4,2.97002574301344,11.0299742569866
"1990","gonna im gonna",16.1657123448417,14,10,4,2.97002574301344,11.0299742569866
"1990","hear callin",16.1657123448417,14,10,4,2.97002574301344,11.0299742569866
"1990","heart yeah",16.1657123448417,14,10,4,2.97002574301344,11.0299742569866
"1990","oh can feel",16.1657123448417,14,10,4,2.97002574301344,11.0299742569866
"1990","still man",16.1657123448417,14,10,4,2.97002574301344,11.0299742569866
"1960","tired",16.1600014477596,282,35,247,16.8419630967905,265.15803690321
"1970","like bird",16.1562662530908,41,16,25,5.61076356556702,35.389236434433
"1980","alright let",16.1555612287182,9,7,2,1.5141215487922,7.4858784512078
"1980","blows mind",16.1555612287182,9,7,2,1.5141215487922,7.4858784512078
"1980","boys always",16.1555612287182,9,7,2,1.5141215487922,7.4858784512078
"1980","diane",16.1555612287182,9,7,2,1.5141215487922,7.4858784512078
"1980","fori",16.1555612287182,9,7,2,1.5141215487922,7.4858784512078
"1980","keep pushing",16.1555612287182,9,7,2,1.5141215487922,7.4858784512078
"1980","made mistake",16.1555612287182,9,7,2,1.5141215487922,7.4858784512078
"1980","night dance",16.1555612287182,9,7,2,1.5141215487922,7.4858784512078
"1980","see can see",16.1555612287182,9,7,2,1.5141215487922,7.4858784512078
"1980","talk good",16.1555612287182,9,7,2,1.5141215487922,7.4858784512078
"1980","tell whos",16.1555612287182,9,7,2,1.5141215487922,7.4858784512078
"1980","things im gonna",16.1555612287182,9,7,2,1.5141215487922,7.4858784512078
"1980","us never",16.1555612287182,9,7,2,1.5141215487922,7.4858784512078
"1980","watching watching",16.1555612287182,9,7,2,1.5141215487922,7.4858784512078
"1980","without know",16.1555612287182,9,7,2,1.5141215487922,7.4858784512078
"1980","yeah night",16.1555612287182,9,7,2,1.5141215487922,7.4858784512078
"1970","theyve",16.1536081336332,104,30,74,14.2321807516822,89.7678192483178
"1980","believin",16.1457182611656,25,13,12,4.20589319108945,20.7941068089106
"1980","gonna live",16.1457182611656,25,13,12,4.20589319108945,20.7941068089106
"1980","madness",16.1457182611656,25,13,12,4.20589319108945,20.7941068089106
"1980","think youve",16.1457182611656,25,13,12,4.20589319108945,20.7941068089106
"1980","can make feel",16.1450570188393,22,12,10,3.70118600815871,18.2988139918413
"1980","dove",16.1450570188393,22,12,10,3.70118600815871,18.2988139918413
"1980","get gonna",16.1450570188393,22,12,10,3.70118600815871,18.2988139918413
"1980","get weak",16.1450570188393,22,12,10,3.70118600815871,18.2988139918413
"1980","let things",16.1450570188393,22,12,10,3.70118600815871,18.2988139918413
"1980","look tell",16.1450570188393,22,12,10,3.70118600815871,18.2988139918413
"1980","look youve",16.1450570188393,22,12,10,3.70118600815871,18.2988139918413
"1980","time around",16.1450570188393,22,12,10,3.70118600815871,18.2988139918413
"1970","absolutely",16.1397262831747,19,10,9,2.60010994501886,16.3998900549811
"1970","devils",16.1397262831747,19,10,9,2.60010994501886,16.3998900549811
"1970","know use",16.1397262831747,19,10,9,2.60010994501886,16.3998900549811
"1970","love one another",16.1397262831747,19,10,9,2.60010994501886,16.3998900549811
"1980","ooooh",16.1289310052699,52,21,31,8.74825783746605,43.251742162534
"1980","puttin",16.1289310052699,52,21,31,8.74825783746605,43.251742162534
"2000","just gotta",16.1282159967134,63,32,31,16.9523982943851,46.0476017056149
"1980","remember",16.1239772803036,894,197,697,150.402740513359,743.597259486641
"2000","follow",16.1095536623288,218,86,132,58.6606798123168,159.339320187683
"1980","one one",16.0879056597815,158,47,111,26.5812449676853,131.418755032315
"2010","meaning",16.0840353948973,162,45,117,24.9419612845099,137.05803871549
"1980","small",16.0838248753984,111,36,75,18.6741657684371,92.3258342315629
"2000","amen",16.0832479489093,20,14,6,5.38171374424925,14.6182862557508
"2000","can run can hide",16.0832479489093,20,14,6,5.38171374424925,14.6182862557508
"2000","get wit",16.0832479489093,20,14,6,5.38171374424925,14.6182862557508
"2000","glock",16.0832479489093,20,14,6,5.38171374424925,14.6182862557508
"2000","gonna okay",16.0832479489093,20,14,6,5.38171374424925,14.6182862557508
"2000","pop champagne",16.0832479489093,20,14,6,5.38171374424925,14.6182862557508
"2000","run can hide",16.0832479489093,20,14,6,5.38171374424925,14.6182862557508
"2000","shaker",16.0832479489093,20,14,6,5.38171374424925,14.6182862557508
"2000","thangs",16.0832479489093,20,14,6,5.38171374424925,14.6182862557508
"2000","yeahif",16.0832479489093,20,14,6,5.38171374424925,14.6182862557508
"2010","safe",16.0812957184497,134,39,95,20.6310050131131,113.368994986887
"1980","nothings gonna",16.0805393837592,38,17,21,6.39295765045596,31.607042349544
"1960","youve gone",16.0724121174842,69,14,55,4.1209058641083,64.8790941358917
"1990","back now",16.067614378991,87,35,52,18.4565885458693,68.5434114541307
"2000","make say",16.0627664212587,38,22,16,10.2252561140736,27.7747438859264
"2000","meim",16.0627664212587,38,22,16,10.2252561140736,27.7747438859264
"2000","swinging",16.0627664212587,38,22,16,10.2252561140736,27.7747438859264
"2000","thing",16.0508912807401,1697,531,1166,456.638411199548,1240.36158880045
"2000","never meant",16.047015312417,71,35,36,19.1050837920848,51.8949162079152
"1980","long",16.0423490027945,1918,390,1528,322.676125620382,1595.32387437962
"1990","gonna see",16.0397690410925,55,25,30,11.6679582761242,43.3320417238758
"1990","got power",16.0397690410925,55,25,30,11.6679582761242,43.3320417238758
"2010","high",16.0376870116417,790,164,626,121.63055194298,668.36944805702
"1960","morning",16.0352268387332,509,54,455,30.3991461569728,478.600853843027
"2000","drugs",16.0258168023268,31,19,12,8.34165630358633,22.6583436964137
"2000","im already",16.0258168023268,31,19,12,8.34165630358633,22.6583436964137
"2000","porch",16.0258168023268,31,19,12,8.34165630358633,22.6583436964137
"2000","surrounded",16.0258168023268,31,19,12,8.34165630358633,22.6583436964137
"1980","heart heart",16.0195871640855,45,19,26,7.57060774396101,37.429392256039
"2000","better never",16.0183575810951,16,12,4,4.3053709953994,11.6946290046006
"2000","feeling good",16.0183575810951,16,12,4,4.3053709953994,11.6946290046006
"2000","friend youre",16.0183575810951,16,12,4,4.3053709953994,11.6946290046006
"2000","get right get",16.0183575810951,16,12,4,4.3053709953994,11.6946290046006
"2000","girl love girl",16.0183575810951,16,12,4,4.3053709953994,11.6946290046006
"2000","goddamn",16.0183575810951,16,12,4,4.3053709953994,11.6946290046006
"2000","issue",16.0183575810951,16,12,4,4.3053709953994,11.6946290046006
"2000","itshake",16.0183575810951,16,12,4,4.3053709953994,11.6946290046006
"2000","life hey",16.0183575810951,16,12,4,4.3053709953994,11.6946290046006
"2000","matter think",16.0183575810951,16,12,4,4.3053709953994,11.6946290046006
"2010","sadness",16.0036590804158,41,17,24,6.31247168311671,34.6875283168833
"2010","cover",16.0004172159985,116,35,81,17.8596759815009,98.1403240184991
"2010","alive just",15.9979109590604,12,8,4,1.84755268774148,10.1524473122585
"2010","bench",15.9979109590604,12,8,4,1.84755268774148,10.1524473122585
"2010","clear see",15.9979109590604,12,8,4,1.84755268774148,10.1524473122585
"2010","club like",15.9979109590604,12,8,4,1.84755268774148,10.1524473122585
"2010","cruising",15.9979109590604,12,8,4,1.84755268774148,10.1524473122585
"2010","different kind",15.9979109590604,12,8,4,1.84755268774148,10.1524473122585
"2010","going yeah",15.9979109590604,12,8,4,1.84755268774148,10.1524473122585
"2010","grams",15.9979109590604,12,8,4,1.84755268774148,10.1524473122585
"2010","itbut",15.9979109590604,12,8,4,1.84755268774148,10.1524473122585
"2010","ive never felt",15.9979109590604,12,8,4,1.84755268774148,10.1524473122585
"2010","love yeah baby",15.9979109590604,12,8,4,1.84755268774148,10.1524473122585
"2010","make place",15.9979109590604,12,8,4,1.84755268774148,10.1524473122585
"2010","oh shame",15.9979109590604,12,8,4,1.84755268774148,10.1524473122585
"2010","see lot",15.9979109590604,12,8,4,1.84755268774148,10.1524473122585
"2010","show show show",15.9979109590604,12,8,4,1.84755268774148,10.1524473122585
"2010","soda",15.9979109590604,12,8,4,1.84755268774148,10.1524473122585
"2010","sometimes get",15.9979109590604,12,8,4,1.84755268774148,10.1524473122585
"2010","thats kind",15.9979109590604,12,8,4,1.84755268774148,10.1524473122585
"2010","throw ya",15.9979109590604,12,8,4,1.84755268774148,10.1524473122585
"2010","times ill",15.9979109590604,12,8,4,1.84755268774148,10.1524473122585
"2010","yeah baby baby",15.9979109590604,12,8,4,1.84755268774148,10.1524473122585
"2010","youre singing",15.9979109590604,12,8,4,1.84755268774148,10.1524473122585
"1990","da la da",15.9967382282102,52,24,28,11.0315241883356,40.9684758116644
"2000","act like dont",15.9951302540801,18,13,5,4.84354236982432,13.1564576301757
"2000","away aint",15.9951302540801,18,13,5,4.84354236982432,13.1564576301757
"2000","daughters",15.9951302540801,18,13,5,4.84354236982432,13.1564576301757
"2000","go bed",15.9951302540801,18,13,5,4.84354236982432,13.1564576301757
"2000","let beat",15.9951302540801,18,13,5,4.84354236982432,13.1564576301757
"2000","one minute",15.9951302540801,18,13,5,4.84354236982432,13.1564576301757
"2000","terror",15.9951302540801,18,13,5,4.84354236982432,13.1564576301757
"2010","na na na",15.9881734386802,1049,210,839,161.506897453401,887.493102546599
"1960","silence",15.9780212696851,61,13,48,3.64311967696531,57.3568803230347
"2010","cant deny",15.9778424222368,81,27,54,12.470980642255,68.529019357745
"1970","come people",15.9705679562491,13,8,5,1.77902259396027,11.2209774060397
"1970","die love",15.9705679562491,13,8,5,1.77902259396027,11.2209774060397
"1970","heard love",15.9705679562491,13,8,5,1.77902259396027,11.2209774060397
"1970","home stay",15.9705679562491,13,8,5,1.77902259396027,11.2209774060397
"1970","like hear",15.9705679562491,13,8,5,1.77902259396027,11.2209774060397
"1970","love hurts",15.9705679562491,13,8,5,1.77902259396027,11.2209774060397
"1970","oh oh can",15.9705679562491,13,8,5,1.77902259396027,11.2209774060397
"1970","sun sun",15.9705679562491,13,8,5,1.77902259396027,11.2209774060397
"1970","walk mile",15.9705679562491,13,8,5,1.77902259396027,11.2209774060397
"1970","well youre",15.9705679562491,13,8,5,1.77902259396027,11.2209774060397
"1990","will never",15.9462742779512,253,81,172,53.6726080701715,199.327391929828
"1990","understand",15.9410140402354,585,165,420,124.104647118776,460.895352881224
"2010","actin like",15.9356335137953,27,13,14,4.15699354741832,22.8430064525817
"2010","feeling yeah",15.9356335137953,27,13,14,4.15699354741832,22.8430064525817
"2010","go wanna",15.9356335137953,27,13,14,4.15699354741832,22.8430064525817
"2010","yeah girl",15.9356335137953,27,13,14,4.15699354741832,22.8430064525817
"1960","glad",15.9303049092996,217,29,188,12.9599503262536,204.040049673746
"1970","abuse",15.930180716452,16,9,7,2.18956626948957,13.8104337305104
"1970","hard go",15.930180716452,16,9,7,2.18956626948957,13.8104337305104
"1970","living world",15.930180716452,16,9,7,2.18956626948957,13.8104337305104
"1970","ruby",15.930180716452,16,9,7,2.18956626948957,13.8104337305104
"1970","whats matter",15.930180716452,16,9,7,2.18956626948957,13.8104337305104
"1990","dont wanna fall",15.9234005462731,29,16,13,6.15219618195642,22.8478038180436
"1990","time day",15.9234005462731,29,16,13,6.15219618195642,22.8478038180436
"1960","cheer",15.9222347788381,19,7,12,1.13474219446461,17.8652578055354
"1960","come back baby",15.9222347788381,19,7,12,1.13474219446461,17.8652578055354
"1970","years",15.9210055893166,412,86,326,56.3813314393564,355.618668560644
"1990","will find",15.8946221294526,94,37,57,19.941601417376,74.058398582624
"2000","fantasies",15.8943185291568,43,24,19,11.5706845501359,31.4293154498641
"2000","im loving",15.8943185291568,43,24,19,11.5706845501359,31.4293154498641
"1970","ive got",15.8884449964626,579,114,465,79.2349293771537,499.765070622846
"1990","youll",15.8665129347746,1377,354,1023,292.123246294965,1084.87675370503
"1990","wanna tell",15.8655604604588,71,30,41,15.0622734109967,55.9377265890033
"1960","looks",15.8482160232343,196,27,169,11.7057615850033,184.294238414997
"1990","give give",15.8477632649353,125,46,79,26.5180869911915,98.4819130088085
"1990","believe still",15.8433622755411,12,9,3,2.54573635115438,9.45426364884562
"1990","day promise",15.8433622755411,12,9,3,2.54573635115438,9.45426364884562
"1990","heart say",15.8433622755411,12,9,3,2.54573635115438,9.45426364884562
"1990","hes real",15.8433622755411,12,9,3,2.54573635115438,9.45426364884562
"1990","im gonna im gonna",15.8433622755411,12,9,3,2.54573635115438,9.45426364884562
"1990","im ready love",15.8433622755411,12,9,3,2.54573635115438,9.45426364884562
"1990","know im ready",15.8433622755411,12,9,3,2.54573635115438,9.45426364884562
"1990","know love will",15.8433622755411,12,9,3,2.54573635115438,9.45426364884562
"1990","passenger side",15.8433622755411,12,9,3,2.54573635115438,9.45426364884562
"1990","shed tears",15.8433622755411,12,9,3,2.54573635115438,9.45426364884562
"1990","step take every",15.8433622755411,12,9,3,2.54573635115438,9.45426364884562
"1990","take man",15.8433622755411,12,9,3,2.54573635115438,9.45426364884562
"1990","tears cried",15.8433622755411,12,9,3,2.54573635115438,9.45426364884562
"1990","time fell love",15.8433622755411,12,9,3,2.54573635115438,9.45426364884562
"1960","ooo baby baby",15.8388189881515,25,8,17,1.49308183482185,23.5069181651781
"2000","cadillac",15.8327462325201,66,33,33,17.7596553560225,48.2403446439775
"1970","begun",15.8319123087936,54,19,35,7.38978615952729,46.6102138404727
"1990","many",15.825563279145,541,154,387,114.770280497877,426.229719502123
"1980","oh oh",15.8253246400646,3050,597,2453,513.118969312913,2536.88103068709
"2010","oooooo",15.8223049426712,34,15,19,5.23473261526751,28.7652673847325
"2010","plastic",15.8223049426712,34,15,19,5.23473261526751,28.7652673847325
"2010","shine",15.7923145012038,395,91,304,60.8152759714902,334.18472402851
"1990","brother",15.788665882545,201,67,134,42.6410838818359,158.358916118164
"1980","city",15.776735599309,545,128,417,91.68847156575,453.31152843425
"1980","time like",15.7734443525568,35,16,19,5.88825046752523,29.1117495324748
"1990","dont impress",15.7535021967922,10,8,2,2.12144695929532,7.87855304070468
"1990","end road",15.7535021967922,10,8,2,2.12144695929532,7.87855304070468
"1990","feedback",15.7535021967922,10,8,2,2.12144695929532,7.87855304070468
"1990","finally found someone",15.7535021967922,10,8,2,2.12144695929532,7.87855304070468
"1990","forever hey",15.7535021967922,10,8,2,2.12144695929532,7.87855304070468
"1990","get easier",15.7535021967922,10,8,2,2.12144695929532,7.87855304070468
"1990","gives love",15.7535021967922,10,8,2,2.12144695929532,7.87855304070468
"1990","go break",15.7535021967922,10,8,2,2.12144695929532,7.87855304070468
"1990","got confused",15.7535021967922,10,8,2,2.12144695929532,7.87855304070468
"1990","heaven oh heaven",15.7535021967922,10,8,2,2.12144695929532,7.87855304070468
"1990","ill freak",15.7535021967922,10,8,2,2.12144695929532,7.87855304070468
"1990","just want back",15.7535021967922,10,8,2,2.12144695929532,7.87855304070468
"1990","mean just",15.7535021967922,10,8,2,2.12144695929532,7.87855304070468
"1990","phone cause",15.7535021967922,10,8,2,2.12144695929532,7.87855304070468
"1990","somethin thats",15.7535021967922,10,8,2,2.12144695929532,7.87855304070468
"1990","source",15.7535021967922,10,8,2,2.12144695929532,7.87855304070468
"1990","want hear say",15.7535021967922,10,8,2,2.12144695929532,7.87855304070468
"1990","youre havin",15.7535021967922,10,8,2,2.12144695929532,7.87855304070468
"1990","youre yeah",15.7535021967922,10,8,2,2.12144695929532,7.87855304070468
"1990","youre yeah yeah",15.7535021967922,10,8,2,2.12144695929532,7.87855304070468
"1970","blues",15.7371393348371,110,31,79,15.0532681027408,94.9467318972592
"1970","love youre",15.7371393348371,110,31,79,15.0532681027408,94.9467318972592
"1970","hat",15.6942004904811,63,21,42,8.62141718611517,54.3785828138848
"1980","shes got",15.6930961862137,168,49,119,28.2636022441211,139.736397755879
"1960","fall love fall",15.6802719266364,14,6,8,0.836125827500235,13.1638741724998
"1960","found dont",15.6802719266364,14,6,8,0.836125827500235,13.1638741724998
"1960","know many",15.6802719266364,14,6,8,0.836125827500235,13.1638741724998
"1960","now go now go",15.6802719266364,14,6,8,0.836125827500235,13.1638741724998
"1960","ready yes",15.6802719266364,14,6,8,0.836125827500235,13.1638741724998
"1960","since gone",15.6802719266364,14,6,8,0.836125827500235,13.1638741724998
"1960","theres better",15.6802719266364,14,6,8,0.836125827500235,13.1638741724998
"1970","softly",15.6765677588668,50,18,32,6.8423945921549,43.1576054078451
"1980","baby night long",15.6758828970242,14,9,5,2.35530018701009,11.6446998129899
"1980","get wild",15.6758828970242,14,9,5,2.35530018701009,11.6446998129899
"1980","girl little",15.6758828970242,14,9,5,2.35530018701009,11.6446998129899
"1980","go talk",15.6758828970242,14,9,5,2.35530018701009,11.6446998129899
"1980","got let know",15.6758828970242,14,9,5,2.35530018701009,11.6446998129899
"1980","ive time",15.6758828970242,14,9,5,2.35530018701009,11.6446998129899
"1980","jojo",15.6758828970242,14,9,5,2.35530018701009,11.6446998129899
"1980","lovin oh",15.6758828970242,14,9,5,2.35530018701009,11.6446998129899
"1980","matter friends",15.6758828970242,14,9,5,2.35530018701009,11.6446998129899
"1980","now much",15.6758828970242,14,9,5,2.35530018701009,11.6446998129899
"1980","take piece",15.6758828970242,14,9,5,2.35530018701009,11.6446998129899
"2000","women",15.6701551431066,201,80,121,54.0862231297049,146.913776870295
"2000","feel way",15.6661282511244,180,73,107,48.4354236982432,131.564576301757
"1980","never let",15.655905885345,177,51,126,29.7777237929133,147.222276207087
"2010","exception",15.6466141365913,24,12,12,3.69510537548295,20.3048946245171
"2010","fourth",15.6466141365913,24,12,12,3.69510537548295,20.3048946245171
"2010","pretty girl",15.6466141365913,24,12,12,3.69510537548295,20.3048946245171
"2010","young lets",15.6466141365913,24,12,12,3.69510537548295,20.3048946245171
"2000","just like",15.6441178490236,618,211,407,166.294954697302,451.705045302698
"2010","baby now",15.6398689103441,86,28,58,13.2407942621472,72.7592057378528
"2010","deserve",15.6398689103441,86,28,58,13.2407942621472,72.7592057378528
"2010","highway",15.6398689103441,86,28,58,13.2407942621472,72.7592057378528
"2010","hook",15.6398689103441,86,28,58,13.2407942621472,72.7592057378528
"2000","cant leave",15.6363234385312,36,21,15,9.68708473964864,26.3129152603514
"1990","heart love",15.6334349709699,32,17,15,6.78863026974501,25.211369730255
"1990","night dont",15.6334349709699,32,17,15,6.78863026974501,25.211369730255
"1990","thank thank",15.6334349709699,32,17,15,6.78863026974501,25.211369730255
"1960","yes im",15.6256933877671,97,17,80,5.79315751910877,91.2068424808912
"2000","know want",15.6218745145682,253,97,156,68.078678864753,184.921321135247
"1960","marry",15.5973431840791,54,12,42,3.22505676321519,50.7749432367848
"1990","new world",15.5811676940268,24,14,10,5.09147270230876,18.9085272976912
"1990","start fire",15.5811676940268,24,14,10,5.09147270230876,18.9085272976912
"1990","things id",15.5811676940268,24,14,10,5.09147270230876,18.9085272976912
"1990","wrong cause",15.5811676940268,24,14,10,5.09147270230876,18.9085272976912
"1990","word",15.5757504583808,343,104,239,72.7656307038293,270.234369296171
"2010","rather",15.569490327788,178,48,130,27.4053648681652,150.594635131835
"1970","river",15.5642523650822,215,51,164,29.4222967462661,185.577703253734
"1980","lovers",15.557388323024,218,60,158,36.6753886263,181.3246113737
"2000","just want",15.5420040667927,244,94,150,65.6569076798408,178.343092320159
"1990","back see",15.5416731167862,19,12,7,4.0307492226611,14.9692507773389
"1990","cause still",15.5416731167862,19,12,7,4.0307492226611,14.9692507773389
"1990","dont know go",15.5416731167862,19,12,7,4.0307492226611,14.9692507773389
"1990","go party",15.5416731167862,19,12,7,4.0307492226611,14.9692507773389
"1990","im side",15.5416731167862,19,12,7,4.0307492226611,14.9692507773389
"1990","looked eyes",15.5416731167862,19,12,7,4.0307492226611,14.9692507773389
"1990","youre reason",15.5416731167862,19,12,7,4.0307492226611,14.9692507773389
"2010","clouds",15.5032057106095,95,30,65,14.6264587779533,80.3735412220467
"1980","dream dream",15.4983471847618,32,15,17,5.38354328459449,26.6164567154055
"2010","cause im one",15.4947579391914,15,9,6,2.30944085967684,12.6905591403232
"2010","magic got",15.4947579391914,15,9,6,2.30944085967684,12.6905591403232
"2010","recording",15.4947579391914,15,9,6,2.30944085967684,12.6905591403232
"2010","say hey hey hey",15.4947579391914,15,9,6,2.30944085967684,12.6905591403232
"2010","stay true",15.4947579391914,15,9,6,2.30944085967684,12.6905591403232
"2010","take shot",15.4947579391914,15,9,6,2.30944085967684,12.6905591403232
"1960","candy",15.4881386244738,146,22,124,8.71959791535959,137.28040208464
"1970","im lookin",15.47191006811,59,20,39,8.07402561874278,50.9259743812572
"1970","alligator",15.4579180612404,8,6,2,1.09478313474478,6.90521686525522
"1970","break make",15.4579180612404,8,6,2,1.09478313474478,6.90521686525522
"1970","far cause know",15.4579180612404,8,6,2,1.09478313474478,6.90521686525522
"1970","gone oh oh",15.4579180612404,8,6,2,1.09478313474478,6.90521686525522
"1970","gonna tell story",15.4579180612404,8,6,2,1.09478313474478,6.90521686525522
"1970","good tell",15.4579180612404,8,6,2,1.09478313474478,6.90521686525522
"1970","happiest",15.4579180612404,8,6,2,1.09478313474478,6.90521686525522
"1970","keep growin",15.4579180612404,8,6,2,1.09478313474478,6.90521686525522
"1970","know dont matter",15.4579180612404,8,6,2,1.09478313474478,6.90521686525522
"1970","know love know",15.4579180612404,8,6,2,1.09478313474478,6.90521686525522
"1970","know weve got",15.4579180612404,8,6,2,1.09478313474478,6.90521686525522
"1970","knowa",15.4579180612404,8,6,2,1.09478313474478,6.90521686525522
"1970","light couldnt",15.4579180612404,8,6,2,1.09478313474478,6.90521686525522
"1970","light couldnt see",15.4579180612404,8,6,2,1.09478313474478,6.90521686525522
"1970","liking",15.4579180612404,8,6,2,1.09478313474478,6.90521686525522
"1970","live world",15.4579180612404,8,6,2,1.09478313474478,6.90521686525522
"1970","love go love",15.4579180612404,8,6,2,1.09478313474478,6.90521686525522
"1970","love weve got",15.4579180612404,8,6,2,1.09478313474478,6.90521686525522
"1970","lover youre",15.4579180612404,8,6,2,1.09478313474478,6.90521686525522
"1970","loving know",15.4579180612404,8,6,2,1.09478313474478,6.90521686525522
"1970","music right",15.4579180612404,8,6,2,1.09478313474478,6.90521686525522
"1970","pick pieces",15.4579180612404,8,6,2,1.09478313474478,6.90521686525522
"1970","say goodbye now",15.4579180612404,8,6,2,1.09478313474478,6.90521686525522
"1970","swear im gonna",15.4579180612404,8,6,2,1.09478313474478,6.90521686525522
"1970","warn ya",15.4579180612404,8,6,2,1.09478313474478,6.90521686525522
"2000","park",15.453721105882,119,52,67,32.021196778283,86.978803221717
"1970","goin back",15.4461414902165,23,11,12,3.14750151239125,19.8524984876087
"1970","layin",15.4461414902165,23,11,12,3.14750151239125,19.8524984876087
"2000","dont act",15.4431022499226,41,23,18,11.032513175711,29.9674868242891
"2000","stoppin",15.4431022499226,41,23,18,11.032513175711,29.9674868242891
"2010","awake im",15.4422773291968,21,11,10,3.23321720354758,17.7667827964524
"2010","back together",15.4422773291968,21,11,10,3.23321720354758,17.7667827964524
"2010","like drum",15.4422773291968,21,11,10,3.23321720354758,17.7667827964524
"2010","sins",15.4422773291968,21,11,10,3.23321720354758,17.7667827964524
"1970","shinin",15.4378995000009,68,22,46,9.30565664533066,58.6943433546693
"1970","right right",15.4378794020053,136,36,100,18.6113132906613,117.388686709339
"1990","just begun",15.4327824364482,35,18,17,7.42506435753361,27.5749356424664
"1990","mind youre",15.4327824364482,35,18,17,7.42506435753361,27.5749356424664
"1990","wishes",15.4327824364482,35,18,17,7.42506435753361,27.5749356424664
"1980","tender",15.4060037399917,92,31,61,15.4776869432092,76.5223130567908
"2010","burnin burnin",15.3894286729054,31,14,17,4.77284444333215,26.2271555566679
"1980","ran",15.3832210712901,88,30,58,14.8047440326349,73.1952559673651
"2000","let hear say",15.3802755662221,46,25,21,12.3779416117733,33.6220583882267
"1980","children",15.3736125729239,134,41,93,22.5435875042394,111.456412495761
"1960","longer",15.3656610211747,98,17,81,5.85288079250165,92.1471192074984
"2010","fighter",15.3653481432986,18,10,8,2.77132903161221,15.2286709683878
"2010","gonna best",15.3653481432986,18,10,8,2.77132903161221,15.2286709683878
"2010","mama cause",15.3653481432986,18,10,8,2.77132903161221,15.2286709683878
"2010","memory byamandah",15.3653481432986,18,10,8,2.77132903161221,15.2286709683878
"2010","memory byamandah editor",15.3653481432986,18,10,8,2.77132903161221,15.2286709683878
"2010","real quick",15.3653481432986,18,10,8,2.77132903161221,15.2286709683878
"2010","run run run",15.3653481432986,18,10,8,2.77132903161221,15.2286709683878
"2010","waitin waitin",15.3653481432986,18,10,8,2.77132903161221,15.2286709683878
"2000","get ya",15.3529660436559,64,32,32,17.2214839815976,46.7785160184024
"1960","deep inside",15.3487662919215,117,19,98,6.98762298696625,110.012377013034
"2010","insane",15.3437781582463,91,29,62,14.0106078820395,76.9893921179605
"2000","alright alright alright alright",15.3076096485195,27,17,10,7.26531355473648,19.7346864452635
"2000","till see",15.3076096485195,27,17,10,7.26531355473648,19.7346864452635
"1980","got mind",15.3067859631345,46,19,27,7.73884347160458,38.2611565283954
"1990","west coast",15.3000607753371,38,19,19,8.0614984453222,29.9385015546778
"2010","drown",15.2839117187856,42,17,25,6.46643440709516,35.5335655929048
"2010","leads",15.2839117187856,42,17,25,6.46643440709516,35.5335655929048
"1960","grows",15.2837580165985,47,11,36,2.80699384946508,44.1930061505349
"1980","like crazy",15.2650352521934,29,14,15,4.87883610166376,24.1211638983362
"1980","snake",15.2650352521934,29,14,15,4.87883610166376,24.1211638983362
"1980","tell us",15.2650352521934,29,14,15,4.87883610166376,24.1211638983362
"2010","im feelin",15.2473154515,118,35,83,18.1676014294578,99.8323985705422
"2000","college",15.216250176305,34,20,14,9.14891336522372,24.8510866347763
"2000","im livin",15.216250176305,34,20,14,9.14891336522372,24.8510866347763
"2000","ooh whoa ooh whoa",15.216250176305,34,20,14,9.14891336522372,24.8510866347763
"2000","seein",15.216250176305,34,20,14,9.14891336522372,24.8510866347763
"2000","us together",15.216250176305,34,20,14,9.14891336522372,24.8510866347763
"1990","love im",15.2094815739074,267,84,183,56.6426338131849,210.357366186815
"1960","hurts bad",15.2088819548646,26,8,18,1.55280510821472,24.4471948917853
"1970","got love",15.2071680584946,168,42,126,22.9904458296404,145.00955417036
"2000","wife",15.2050104562415,131,56,75,35.2502250248326,95.7497749751674
"1970","higher",15.1949196946981,233,54,179,31.8855587994418,201.114441200558
"1980","dont turn around",15.1918599624538,17,10,7,2.86000736994083,14.1399926300592
"1980","eyes can see",15.1918599624538,17,10,7,2.86000736994083,14.1399926300592
"1980","found im",15.1918599624538,17,10,7,2.86000736994083,14.1399926300592
"1980","got together",15.1918599624538,17,10,7,2.86000736994083,14.1399926300592
"1980","ive ever known",15.1918599624538,17,10,7,2.86000736994083,14.1399926300592
"1980","love turn",15.1918599624538,17,10,7,2.86000736994083,14.1399926300592
"1980","sweet little",15.1918599624538,17,10,7,2.86000736994083,14.1399926300592
"1970","desert",15.1854320562663,64,21,43,8.75826507795827,55.2417349220417
"1990","chill",15.1840708027187,92,36,56,19.5173120255169,72.4826879744831
"2010","melody",15.1840578433631,70,24,46,10.7773906784919,59.2226093215081
"1990","rivers",15.1827085089288,44,21,23,9.33436662089939,34.6656333791006
"1990","things want",15.1792413464007,47,22,25,9.97080070868799,37.029199291312
"2000","girl aint",15.1697319006468,59,30,29,15.8760555455353,43.1239444544647
"1960","dont care dont",15.1557108581607,20,7,13,1.19446546785748,18.8055345321425
"1960","made mind",15.1557108581607,20,7,13,1.19446546785748,18.8055345321425
"1960","without come",15.1557108581607,20,7,13,1.19446546785748,18.8055345321425
"2010","yeah ooh",15.1421827593878,46,18,28,7.08228530300899,38.917714696991
"1990","enough know",15.1412560647237,27,15,12,5.72790679009735,21.2720932099026
"1990","hold baby",15.1412560647237,27,15,12,5.72790679009735,21.2720932099026
"1980","find",15.1306309612219,1686,345,1341,283.645436807072,1402.35456319293
"1970","gone",15.1218998252295,1359,237,1122,185.97628501477,1173.02371498523
"2000","acting",15.112195695148,97,44,53,26.1013116596088,70.8986883403912
"1970","spirit",15.089383738052,51,18,33,6.97924248399799,44.020757516002
"1970","fools",15.070525468378,78,24,54,10.6741355637616,67.3258644362384
"2010","ill stay",15.0591833949444,50,19,31,7.69813619892281,42.3018638010772
"2010","trying get",15.0528785897767,62,22,40,9.54568888666429,52.4543111133357
"2010","ooh oh",15.0225560861149,58,21,37,8.92983799075047,49.0701620092495
"2000","whats",15.0153835481846,847,279,568,227.915577068956,619.084422931045
"1970","sea",15.014855132314,174,43,131,23.811533180699,150.188466819301
"1960","man",15.0095282419556,2466,195,2271,147.277592186827,2318.72240781317
"1970","let die",14.9951047138155,20,10,10,2.73695783686196,17.263042163138
"1970","money can",14.9951047138155,20,10,10,2.73695783686196,17.263042163138
"1970","moon stars",14.9951047138155,20,10,10,2.73695783686196,17.263042163138
"2000","ooh whoa ooh",14.9948388391338,39,22,17,10.494341801286,28.505658198714
"2000","fine",14.9924628049253,608,207,401,163.604097825177,444.395902174823
"2010","tan",14.9896562297675,28,13,15,4.31095627139678,23.6890437286032
"2010","thing love",14.9896562297675,28,13,15,4.31095627139678,23.6890437286032
"1980","little red",14.9885975851478,23,12,11,3.86942173580229,19.1305782641977
"1980","took time",14.9885975851478,23,12,11,3.86942173580229,19.1305782641977
"2010","aint ever",14.9804917234156,10,7,3,1.53962723978456,8.46037276021544
"2010","around hey",14.9804917234156,10,7,3,1.53962723978456,8.46037276021544
"2010","can solve",14.9804917234156,10,7,3,1.53962723978456,8.46037276021544
"2010","care sees",14.9804917234156,10,7,3,1.53962723978456,8.46037276021544
"2010","cause make wanna",14.9804917234156,10,7,3,1.53962723978456,8.46037276021544
"2010","dont care sees",14.9804917234156,10,7,3,1.53962723978456,8.46037276021544
"2010","feel like youre",14.9804917234156,10,7,3,1.53962723978456,8.46037276021544
"2010","fuck got",14.9804917234156,10,7,3,1.53962723978456,8.46037276021544
"2010","full shit",14.9804917234156,10,7,3,1.53962723978456,8.46037276021544
"2010","get nasty",14.9804917234156,10,7,3,1.53962723978456,8.46037276021544
"2010","get whatever",14.9804917234156,10,7,3,1.53962723978456,8.46037276021544
"2010","girl fire",14.9804917234156,10,7,3,1.53962723978456,8.46037276021544
"2010","go tonight",14.9804917234156,10,7,3,1.53962723978456,8.46037276021544
"2010","im love love",14.9804917234156,10,7,3,1.53962723978456,8.46037276021544
"2010","im throwing",14.9804917234156,10,7,3,1.53962723978456,8.46037276021544
"2010","jason",14.9804917234156,10,7,3,1.53962723978456,8.46037276021544
"2010","nebraska",14.9804917234156,10,7,3,1.53962723978456,8.46037276021544
"2010","never im",14.9804917234156,10,7,3,1.53962723978456,8.46037276021544
"2010","nigga just",14.9804917234156,10,7,3,1.53962723978456,8.46037276021544
"2010","niggas just",14.9804917234156,10,7,3,1.53962723978456,8.46037276021544
"2010","perfect one",14.9804917234156,10,7,3,1.53962723978456,8.46037276021544
"2010","see sunlight",14.9804917234156,10,7,3,1.53962723978456,8.46037276021544
"2010","stay little",14.9804917234156,10,7,3,1.53962723978456,8.46037276021544
"2010","time money",14.9804917234156,10,7,3,1.53962723978456,8.46037276021544
"2010","way many",14.9804917234156,10,7,3,1.53962723978456,8.46037276021544
"2010","world fire",14.9804917234156,10,7,3,1.53962723978456,8.46037276021544
"2000","back go",14.9785662041719,25,16,9,6.72714218031156,18.2728578196884
"2000","can even",14.9785662041719,25,16,9,6.72714218031156,18.2728578196884
"2000","cause get",14.9785662041719,25,16,9,6.72714218031156,18.2728578196884
"2000","cutie",14.9785662041719,25,16,9,6.72714218031156,18.2728578196884
"2000","hey oh",14.9785662041719,25,16,9,6.72714218031156,18.2728578196884
"2000","matter fact",14.9785662041719,25,16,9,6.72714218031156,18.2728578196884
"2000","together dont",14.9785662041719,25,16,9,6.72714218031156,18.2728578196884
"1980","go dont",14.9653189284135,118,37,81,19.8518158619422,98.1481841380578
"1990","sex",14.955151079615,245,78,167,51.9754505027352,193.024549497265
"1980","every",14.9538135591436,2061,414,1647,346.733834673414,1714.26616532659
"1970","evening",14.9468576099819,60,20,40,8.21087351058588,51.7891264894141
"1980","can read",14.9434672314111,36,16,20,6.05648619516881,29.9435138048312
"1980","think gonna",14.9434672314111,36,16,20,6.05648619516881,29.9435138048312
"1970","grows",14.9391813848642,47,17,30,6.4318509166256,40.5681490833744
"1970","oh yeah oh yeah",14.9391813848642,47,17,30,6.4318509166256,40.5681490833744
"1980","fate",14.9274347823316,73,26,47,12.2812081179812,60.7187918820188
"1980","love baby",14.9204752230305,421,102,319,70.8272413379463,350.172758662054
"2000","girl thats",14.916368518375,44,24,20,11.8397702373483,32.1602297626517
"2000","best",14.9114300452297,908,297,611,244.329803988916,663.670196011084
"1980","weve got",14.9017484961379,131,40,91,22.0388803213087,108.961119678691
"1990","bad makes",14.8975534989775,17,11,6,3.60645983080204,13.393540169198
"1990","cant see love",14.8975534989775,17,11,6,3.60645983080204,13.393540169198
"1990","companion",14.8975534989775,17,11,6,3.60645983080204,13.393540169198
"1990","enough baby",14.8975534989775,17,11,6,3.60645983080204,13.393540169198
"1990","love yeah yeah yeah",14.8975534989775,17,11,6,3.60645983080204,13.393540169198
"1990","oh baby can",14.8975534989775,17,11,6,3.60645983080204,13.393540169198
"1990","opened door",14.8975534989775,17,11,6,3.60645983080204,13.393540169198
"1990","remember girl",14.8975534989775,17,11,6,3.60645983080204,13.393540169198
"1990","strong dont",14.8975534989775,17,11,6,3.60645983080204,13.393540169198
"1990","sun sky",14.8975534989775,17,11,6,3.60645983080204,13.393540169198
"1990","thing thing thing",14.8975534989775,17,11,6,3.60645983080204,13.393540169198
"2000","way",14.8898414876015,4483,1322,3161,1206.31113577347,3276.68886422653
"2000","goin",14.8853841978941,556,191,365,149.611642090129,406.388357909871
"1990","get love",14.8745256031702,96,37,59,20.365890809235,75.634109190765
"2000","champagne",14.8731858547916,62,31,31,16.6833126071727,45.3166873928273
"2000","forever ever",14.8731858547916,62,31,31,16.6833126071727,45.3166873928273
"1960","love never",14.8583517084277,100,17,83,5.97232733928739,94.0276726607126
"1990","can reach",14.8374471210696,22,13,9,4.6671833104497,17.3328166895503
"1990","girl youll",14.8374471210696,22,13,9,4.6671833104497,17.3328166895503
"1990","moms",14.8374471210696,22,13,9,4.6671833104497,17.3328166895503
"1990","took love",14.8374471210696,22,13,9,4.6671833104497,17.3328166895503
"1990","words cant",14.8374471210696,22,13,9,4.6671833104497,17.3328166895503
"1990","youll never know",14.8374471210696,22,13,9,4.6671833104497,17.3328166895503
"1990","conscience",14.8365193815092,30,16,14,6.36434087788595,23.6356591221141
"2000","going crazy",14.8037674908552,32,19,13,8.61074199079879,23.3892580092012
"2000","loaded",14.8037674908552,32,19,13,8.61074199079879,23.3892580092012
"1990","eight",14.7990610805335,103,39,64,21.8509036807418,81.1490963192582
"1980","know really",14.7900715431733,110,35,75,18.5059300407936,91.4940699592064
"2010","cause never",14.7620224082354,39,16,23,6.0045462351598,32.9954537648402
"2010","gonna play",14.7620224082354,39,16,23,6.0045462351598,32.9954537648402
"1970","im coming home",14.7588728965772,35,14,21,4.78967621450843,30.2103237854916
"1970","us now",14.7588728965772,35,14,21,4.78967621450843,30.2103237854916
"1990","inside",14.7501397897999,991,261,730,210.235393666166,780.764606333834
"1970","good time",14.743345966487,175,43,132,23.9483810725421,151.051618927458
"2010","come come",14.7427422593646,369,85,284,56.8122451480504,312.18775485195
"1960","blues",14.7369213184275,110,18,92,6.56956007321613,103.430439926784
"1970","together",14.7359986801417,954,173,781,130.552888818315,823.447111181685
"1960","baby dont care",14.7345109620414,15,6,9,0.895849100893109,14.1041508991069
"1960","dedicated",14.7345109620414,15,6,9,0.895849100893109,14.1041508991069
"1960","didnt make",14.7345109620414,15,6,9,0.895849100893109,14.1041508991069
"1960","lord mercy",14.7345109620414,15,6,9,0.895849100893109,14.1041508991069
"1960","many times ive",14.7345109620414,15,6,9,0.895849100893109,14.1041508991069
"1960","need loving",14.7345109620414,15,6,9,0.895849100893109,14.1041508991069
"1960","reachin",14.7345109620414,15,6,9,0.895849100893109,14.1041508991069
"1960","sweet thing",14.7345109620414,15,6,9,0.895849100893109,14.1041508991069
"1960","valley low",14.7345109620414,15,6,9,0.895849100893109,14.1041508991069
"1960","walk like",14.7345109620414,15,6,9,0.895849100893109,14.1041508991069
"1970","mans",14.719743317846,98,28,70,13.4110934006236,84.5889065993764
"1980","catch now",14.7155358765319,12,8,4,2.01882873172294,9.98117126827706
"1980","dont write",14.7155358765319,12,8,4,2.01882873172294,9.98117126827706
"1980","got find way",14.7155358765319,12,8,4,2.01882873172294,9.98117126827706
"1980","hard look",14.7155358765319,12,8,4,2.01882873172294,9.98117126827706
"1980","just use",14.7155358765319,12,8,4,2.01882873172294,9.98117126827706
"1980","love youyou",14.7155358765319,12,8,4,2.01882873172294,9.98117126827706
"1980","male",14.7155358765319,12,8,4,2.01882873172294,9.98117126827706
"1980","name across",14.7155358765319,12,8,4,2.01882873172294,9.98117126827706
"1980","oh swear",14.7155358765319,12,8,4,2.01882873172294,9.98117126827706
"1980","ooo ooo ooo",14.7155358765319,12,8,4,2.01882873172294,9.98117126827706
"1980","really love just",14.7155358765319,12,8,4,2.01882873172294,9.98117126827706
"1980","seems like yesterday",14.7155358765319,12,8,4,2.01882873172294,9.98117126827706
"1980","side gonna",14.7155358765319,12,8,4,2.01882873172294,9.98117126827706
"1980","special love",14.7155358765319,12,8,4,2.01882873172294,9.98117126827706
"1980","tellin lies",14.7155358765319,12,8,4,2.01882873172294,9.98117126827706
"1980","threw away",14.7155358765319,12,8,4,2.01882873172294,9.98117126827706
"1980","tick tick",14.7155358765319,12,8,4,2.01882873172294,9.98117126827706
"1980","true get",14.7155358765319,12,8,4,2.01882873172294,9.98117126827706
"1980","youre fine youre",14.7155358765319,12,8,4,2.01882873172294,9.98117126827706
"1980","youre turning",14.7155358765319,12,8,4,2.01882873172294,9.98117126827706
"1980","door",14.698444023921,597,137,460,100.436729403216,496.563270596784
"1970","drove",14.6919281716787,65,21,44,8.89511296980137,56.1048870301986
"2000","know game",14.6769437999558,23,15,8,6.18897080588663,16.8110291941134
"2000","know one thing",14.6769437999558,23,15,8,6.18897080588663,16.8110291941134
"2000","lap",14.6769437999558,23,15,8,6.18897080588663,16.8110291941134
"2000","rappers",14.6769437999558,23,15,8,6.18897080588663,16.8110291941134
"2000","snoop",14.6769437999558,23,15,8,6.18897080588663,16.8110291941134
"2000","til see",14.6769437999558,23,15,8,6.18897080588663,16.8110291941134
"1970","da da da",14.6616066124471,303,66,237,41.4649112284587,261.535088771541
"2010","wanna say",14.650903241412,106,32,74,16.3200487417164,89.6799512582836
"1970","far far",14.6464174069633,17,9,8,2.32641416133266,14.6735858386673
"1970","im takin",14.6464174069633,17,9,8,2.32641416133266,14.6735858386673
"1970","rainy day",14.6464174069633,17,9,8,2.32641416133266,14.6735858386673
"1970","wont leave",14.6464174069633,17,9,8,2.32641416133266,14.6735858386673
"1960","love now",14.6451866646621,130,20,110,7.76402554107361,122.235974458926
"1960","whole world",14.6451866646621,130,20,110,7.76402554107361,122.235974458926
"2010","glasses",14.6347141666814,25,12,13,3.84906809946141,21.1509319005386
"2010","nigga aint",14.6347141666814,25,12,13,3.84906809946141,21.1509319005386
"2010","time need",14.6347141666814,25,12,13,3.84906809946141,21.1509319005386
"2010","whatcha say",14.6347141666814,25,12,13,3.84906809946141,21.1509319005386
"1990","chuck",14.629248432494,33,17,16,7.00077496567454,25.9992250343255
"1990","like rain",14.629248432494,33,17,16,7.00077496567454,25.9992250343255
"1990","sweet dreams",14.629248432494,33,17,16,7.00077496567454,25.9992250343255
"1990","way used",14.629248432494,33,17,16,7.00077496567454,25.9992250343255
"1980","can dont",14.6284879031075,33,15,18,5.55177901223807,27.4482209877619
"1980","life without",14.6284879031075,33,15,18,5.55177901223807,27.4482209877619
"2010","everybody",14.6183229339904,1033,205,828,159.043493869745,873.956506130255
"1960","aint easy",14.6131712058802,27,8,19,1.6125283816076,25.3874716183924
"1960","baby good",14.6131712058802,27,8,19,1.6125283816076,25.3874716183924
"1960","im crying",14.6131712058802,27,8,19,1.6125283816076,25.3874716183924
"1960","long ive",14.6131712058802,27,8,19,1.6125283816076,25.3874716183924
"2000","wrap",14.6089749954101,65,32,33,17.49056966881,47.50943033119
"1970","back find",14.6011092395787,11,7,4,1.50532681027408,9.49467318972592
"1970","ben",14.6011092395787,11,7,4,1.50532681027408,9.49467318972592
"1970","can see face",14.6011092395787,11,7,4,1.50532681027408,9.49467318972592
"1970","darling love",14.6011092395787,11,7,4,1.50532681027408,9.49467318972592
"1970","fanny",14.6011092395787,11,7,4,1.50532681027408,9.49467318972592
"1970","far far away",14.6011092395787,11,7,4,1.50532681027408,9.49467318972592
"1970","gold gold",14.6011092395787,11,7,4,1.50532681027408,9.49467318972592
"1970","help make",14.6011092395787,11,7,4,1.50532681027408,9.49467318972592
"1970","hopelessly",14.6011092395787,11,7,4,1.50532681027408,9.49467318972592
"1970","id see",14.6011092395787,11,7,4,1.50532681027408,9.49467318972592
"1970","line give",14.6011092395787,11,7,4,1.50532681027408,9.49467318972592
"1970","old world",14.6011092395787,11,7,4,1.50532681027408,9.49467318972592
"1970","thats game",14.6011092395787,11,7,4,1.50532681027408,9.49467318972592
"1970","wanna sing",14.6011092395787,11,7,4,1.50532681027408,9.49467318972592
"1970","wants live",14.6011092395787,11,7,4,1.50532681027408,9.49467318972592
"1970","will soon",14.6011092395787,11,7,4,1.50532681027408,9.49467318972592
"1970","youre bound",14.6011092395787,11,7,4,1.50532681027408,9.49467318972592
"2010","ah yeah",14.59656215636,43,17,26,6.62039713107362,36.3796028689264
"2010","impossible",14.59656215636,43,17,26,6.62039713107362,36.3796028689264
"2000","move move",14.56047301906,115,50,65,30.9448540294332,84.0551459705668
"2000","leather",14.5500126408492,37,21,16,9.9561704268611,27.0438295731389
"2000","steppin",14.5497596938963,52,27,25,13.992455735048,38.007544264952
"1980","make everything",14.5263475614073,40,17,23,6.72942910574312,33.2705708942569
"1970","alone",14.5243252303496,975,176,799,133.42669454702,841.57330545298
"1990","step",14.5230490868117,552,155,397,117.103872153101,434.896127846899
"1960","river",14.504914256096,215,28,187,12.8405037794679,202.159496220532
"1970","baby ooo",14.4775439619906,24,11,13,3.28434940423435,20.7156505957656
"1970","cant get head",14.4775439619906,24,11,13,3.28434940423435,20.7156505957656
"1970","dont look back",14.4775439619906,24,11,13,3.28434940423435,20.7156505957656
"1970","good good good good",14.4775439619906,24,11,13,3.28434940423435,20.7156505957656
"1970","great big",14.4775439619906,24,11,13,3.28434940423435,20.7156505957656
"1970","heavenly",14.4775439619906,24,11,13,3.28434940423435,20.7156505957656
"1970","little late",14.4775439619906,24,11,13,3.28434940423435,20.7156505957656
"1970","many ways",14.4775439619906,24,11,13,3.28434940423435,20.7156505957656
"1970","temptation",14.4775439619906,24,11,13,3.28434940423435,20.7156505957656
"1970","across sky",14.4667092240641,14,8,6,1.91587048580337,12.0841295141966
"1970","can rely",14.4667092240641,14,8,6,1.91587048580337,12.0841295141966
"1970","dont hesitate",14.4667092240641,14,8,6,1.91587048580337,12.0841295141966
"1970","gonna long",14.4667092240641,14,8,6,1.91587048580337,12.0841295141966
"1970","hurry cause",14.4667092240641,14,8,6,1.91587048580337,12.0841295141966
"1970","im dreamin",14.4667092240641,14,8,6,1.91587048580337,12.0841295141966
"1970","love easy",14.4667092240641,14,8,6,1.91587048580337,12.0841295141966
"1970","name game",14.4667092240641,14,8,6,1.91587048580337,12.0841295141966
"1970","oh id",14.4667092240641,14,8,6,1.91587048580337,12.0841295141966
"1970","old mans",14.4667092240641,14,8,6,1.91587048580337,12.0841295141966
"1970","right will",14.4667092240641,14,8,6,1.91587048580337,12.0841295141966
"1970","show tell",14.4667092240641,14,8,6,1.91587048580337,12.0841295141966
"1970","thats time",14.4667092240641,14,8,6,1.91587048580337,12.0841295141966
"1980","just",14.4656042772802,9577,1752,7825,1611.19356364255,7965.80643635745
"2000","like got",14.4642531363994,47,25,22,12.6470272989857,34.3529727010143
"2000","aint just",14.4518286788564,11,9,2,2.95994255933709,8.04005744066292
"2000","babygirl",14.4518286788564,11,9,2,2.95994255933709,8.04005744066292
"2000","beshe",14.4518286788564,11,9,2,2.95994255933709,8.04005744066292
"2000","boy said",14.4518286788564,11,9,2,2.95994255933709,8.04005744066292
"2000","come back home",14.4518286788564,11,9,2,2.95994255933709,8.04005744066292
"2000","cupids",14.4518286788564,11,9,2,2.95994255933709,8.04005744066292
"2000","didnt tell",14.4518286788564,11,9,2,2.95994255933709,8.04005744066292
"2000","every time try",14.4518286788564,11,9,2,2.95994255933709,8.04005744066292
"2000","hes always",14.4518286788564,11,9,2,2.95994255933709,8.04005744066292
"2000","ill break",14.4518286788564,11,9,2,2.95994255933709,8.04005744066292
"2000","ill fly",14.4518286788564,11,9,2,2.95994255933709,8.04005744066292
"2000","ill treat",14.4518286788564,11,9,2,2.95994255933709,8.04005744066292
"2000","itdo",14.4518286788564,11,9,2,2.95994255933709,8.04005744066292
"2000","kissed girl",14.4518286788564,11,9,2,2.95994255933709,8.04005744066292
"2000","know aint got",14.4518286788564,11,9,2,2.95994255933709,8.04005744066292
"2000","like cause aint",14.4518286788564,11,9,2,2.95994255933709,8.04005744066292
"2000","lovers friends",14.4518286788564,11,9,2,2.95994255933709,8.04005744066292
"2000","midwest",14.4518286788564,11,9,2,2.95994255933709,8.04005744066292
"2000","na na na hey",14.4518286788564,11,9,2,2.95994255933709,8.04005744066292
"2000","roll around",14.4518286788564,11,9,2,2.95994255933709,8.04005744066292
"2000","song know",14.4518286788564,11,9,2,2.95994255933709,8.04005744066292
"2000","spotted",14.4518286788564,11,9,2,2.95994255933709,8.04005744066292
"2000","still call",14.4518286788564,11,9,2,2.95994255933709,8.04005744066292
"2000","though heart",14.4518286788564,11,9,2,2.95994255933709,8.04005744066292
"2000","thugged",14.4518286788564,11,9,2,2.95994255933709,8.04005744066292
"2000","trickin",14.4518286788564,11,9,2,2.95994255933709,8.04005744066292
"2000","wanna say goodbye",14.4518286788564,11,9,2,2.95994255933709,8.04005744066292
"2010","best thing",14.449544218692,51,19,32,7.85209892290127,43.1479010770987
"2010","gonna stay",14.449544218692,51,19,32,7.85209892290127,43.1479010770987
"1980","easy",14.4478429400585,503,118,385,84.6225710047197,418.37742899528
"1980","inside",14.4473564714016,991,213,778,166.721606094786,824.278393905214
"1960","kitty",14.4431434652333,21,7,14,1.25418874125035,19.7458112587496
"1960","man loves",14.4431434652333,21,7,14,1.25418874125035,19.7458112587496
"1960","potion",14.4431434652333,21,7,14,1.25418874125035,19.7458112587496
"2000","back back",14.4373690353954,101,45,56,27.1776544084587,73.8223455915413
"1980","want",14.4310943712144,6214,1159,5055,1045.41681157719,5168.58318842281
"1980","near",14.4237768739269,213,58,155,35.8342099880821,177.165790011918
"1980","thrill",14.4227142917919,74,26,48,12.4494438456248,61.5505561543752
"1980","time come",14.4128749137247,78,27,51,13.1223867561991,64.8776132438009
"1990","good enough",14.4119292542183,48,22,26,10.1829454046175,37.8170545953825
"2000","cause dont want",14.4111430532668,21,14,7,5.65079943146171,15.3492005685383
"2000","closet",14.4111430532668,21,14,7,5.65079943146171,15.3492005685383
"2000","im go",14.4111430532668,21,14,7,5.65079943146171,15.3492005685383
"2000","kelly",14.4111430532668,21,14,7,5.65079943146171,15.3492005685383
"2000","somebody can",14.4111430532668,21,14,7,5.65079943146171,15.3492005685383
"2000","yeahim",14.4111430532668,21,14,7,5.65079943146171,15.3492005685383
"1990","let know",14.4107244127918,297,91,206,63.0069746910709,233.993025308929
"1970","honey",14.4067214342822,421,86,335,57.6129624659442,363.387037534056
"1970","long time",14.4041246828463,155,39,116,21.2114232356802,133.78857676432
"2000","bump bump",14.4004318360536,30,18,12,8.07257061637387,21.9274293836261
"2000","long just",14.4004318360536,30,18,12,8.07257061637387,21.9274293836261
"2000","shit im",14.4004318360536,30,18,12,8.07257061637387,21.9274293836261
"2000","tone",14.4004318360536,30,18,12,8.07257061637387,21.9274293836261
"2000","wouldve",14.4004318360536,30,18,12,8.07257061637387,21.9274293836261
"1990","pony",14.3825037988902,45,21,24,9.54651131682892,35.4534886831711
"1990","feel something",14.3628361095241,25,14,11,5.30361739823829,19.6963826017617
"1970","blow mind",14.3474513734485,48,17,31,6.5686988084687,41.4313011915313
"1980","chocolate",14.3460959798865,30,14,16,5.04707182930734,24.9529281706927
"1980","healing",14.3460959798865,30,14,16,5.04707182930734,24.9529281706927
"1980","will say",14.3460959798865,30,14,16,5.04707182930734,24.9529281706927
"2010","nightmare",14.3427296252087,22,11,11,3.38717992752604,18.612820072474
"2010","one got",14.3427296252087,22,11,11,3.38717992752604,18.612820072474
"2010","say hey hey",14.3427296252087,22,11,11,3.38717992752604,18.612820072474
"2010","tonight night",14.3427296252087,22,11,11,3.38717992752604,18.612820072474
"2010","will stay",14.3427296252087,22,11,11,3.38717992752604,18.612820072474
"2010","wiser",14.3427296252087,22,11,11,3.38717992752604,18.612820072474
"1990","love want",14.3397879675078,125,45,80,26.5180869911915,98.4819130088085
"1970","darkness",14.3230648090208,104,29,75,14.2321807516822,89.7678192483178
"1960","pride",14.3096953588592,152,22,130,9.07793755571684,142.922062444283
"1990","ancient",14.2987174369072,15,10,5,3.18217043894297,11.817829561057
"1990","baby baby dont",14.2987174369072,15,10,5,3.18217043894297,11.817829561057
"1990","baby everything",14.2987174369072,15,10,5,3.18217043894297,11.817829561057
"1990","back come",14.2987174369072,15,10,5,3.18217043894297,11.817829561057
"1990","best things life",14.2987174369072,15,10,5,3.18217043894297,11.817829561057
"1990","can feel yeah",14.2987174369072,15,10,5,3.18217043894297,11.817829561057
"1990","eyes come",14.2987174369072,15,10,5,3.18217043894297,11.817829561057
"1990","im letting",14.2987174369072,15,10,5,3.18217043894297,11.817829561057
"1990","livin without",14.2987174369072,15,10,5,3.18217043894297,11.817829561057
"1990","love saw",14.2987174369072,15,10,5,3.18217043894297,11.817829561057
"1990","nobody know",14.2987174369072,15,10,5,3.18217043894297,11.817829561057
"1990","ready love",14.2987174369072,15,10,5,3.18217043894297,11.817829561057
"1990","something inside",14.2987174369072,15,10,5,3.18217043894297,11.817829561057
"1990","start cry",14.2987174369072,15,10,5,3.18217043894297,11.817829561057
"1990","talk night",14.2987174369072,15,10,5,3.18217043894297,11.817829561057
"2010","back right back",14.2853952130651,13,8,5,2.00151541171993,10.9984845882801
"2010","beat im",14.2853952130651,13,8,5,2.00151541171993,10.9984845882801
"2010","bitch dont",14.2853952130651,13,8,5,2.00151541171993,10.9984845882801
"2010","can shake",14.2853952130651,13,8,5,2.00151541171993,10.9984845882801
"2010","catchin",14.2853952130651,13,8,5,2.00151541171993,10.9984845882801
"2010","cross heart hope die",14.2853952130651,13,8,5,2.00151541171993,10.9984845882801
"2010","em cause",14.2853952130651,13,8,5,2.00151541171993,10.9984845882801
"2010","fall ill",14.2853952130651,13,8,5,2.00151541171993,10.9984845882801
"2010","heart hope die",14.2853952130651,13,8,5,2.00151541171993,10.9984845882801
"2010","hide can",14.2853952130651,13,8,5,2.00151541171993,10.9984845882801
"2010","just sing",14.2853952130651,13,8,5,2.00151541171993,10.9984845882801
"2010","just type",14.2853952130651,13,8,5,2.00151541171993,10.9984845882801
"2010","made made made",14.2853952130651,13,8,5,2.00151541171993,10.9984845882801
"2010","mean one",14.2853952130651,13,8,5,2.00151541171993,10.9984845882801
"2010","mistakes im",14.2853952130651,13,8,5,2.00151541171993,10.9984845882801
"2010","nigga want",14.2853952130651,13,8,5,2.00151541171993,10.9984845882801
"2010","now put hands",14.2853952130651,13,8,5,2.00151541171993,10.9984845882801
"2010","wasnt enough",14.2853952130651,13,8,5,2.00151541171993,10.9984845882801
"2010","wont fall",14.2853952130651,13,8,5,2.00151541171993,10.9984845882801
"2000","car",14.2607771223862,390,139,251,104.94341801286,285.05658198714
"2000","everyone",14.2526138454939,217,84,133,58.3915941251043,158.608405874896
"2010","sean",14.2514856592109,36,15,21,5.54265806322443,30.4573419367756
"1990","dream",14.2403845205822,789,212,577,167.3821650884,621.6178349116
"1960","sweeter",14.2148264594485,75,14,61,4.47924550446555,70.5207544955345
"1980","winner",14.2104472498937,44,18,26,7.40237201631743,36.5976279836826
"1970","cries",14.2031353543784,44,16,28,6.02130724109631,37.9786927589037
"1970","love well",14.2031353543784,44,16,28,6.02130724109631,37.9786927589037
"1970","still one",14.2031353543784,44,16,28,6.02130724109631,37.9786927589037
"1970","chicago",14.1996512468161,28,12,16,3.83174097160674,24.1682590283933
"1970","hot youre",14.1996512468161,28,12,16,3.83174097160674,24.1682590283933
"1970","keep makin",14.1996512468161,28,12,16,3.83174097160674,24.1682590283933
"1970","love really",14.1996512468161,28,12,16,3.83174097160674,24.1682590283933
"2000","alone know",14.1934849269568,19,13,6,5.11262805703678,13.8873719429632
"2000","fights",14.1934849269568,19,13,6,5.11262805703678,13.8873719429632
"2000","girl put",14.1934849269568,19,13,6,5.11262805703678,13.8873719429632
"2000","gonna happen",14.1934849269568,19,13,6,5.11262805703678,13.8873719429632
"2000","im calling",14.1934849269568,19,13,6,5.11262805703678,13.8873719429632
"2000","juicy",14.1934849269568,19,13,6,5.11262805703678,13.8873719429632
"2000","label",14.1934849269568,19,13,6,5.11262805703678,13.8873719429632
"2000","like ever",14.1934849269568,19,13,6,5.11262805703678,13.8873719429632
"2000","money aint",14.1934849269568,19,13,6,5.11262805703678,13.8873719429632
"2000","oh feel",14.1934849269568,19,13,6,5.11262805703678,13.8873719429632
"2000","say good",14.1934849269568,19,13,6,5.11262805703678,13.8873719429632
"2000","take pain",14.1934849269568,19,13,6,5.11262805703678,13.8873719429632
"2000","tell everything",14.1934849269568,19,13,6,5.11262805703678,13.8873719429632
"2000","thankful",14.1934849269568,19,13,6,5.11262805703678,13.8873719429632
"1980","middle",14.1836212883474,289,74,215,48.620125288994,240.379874711006
"2010","never never",14.1709200054861,121,35,86,18.6294896013932,102.370510398607
"2000","im always",14.1611959188735,71,34,37,19.1050837920848,51.8949162079152
"1980","just look",14.1579691164028,37,16,21,6.22472192281238,30.7752780771876
"1980","love can",14.1551972954577,182,51,131,30.6189024311312,151.381097568869
"2010","aint going",14.1434116621212,19,10,9,2.92529175559067,16.0747082444093
"2010","dynamite",14.1434116621212,19,10,9,2.92529175559067,16.0747082444093
"2010","em im",14.1434116621212,19,10,9,2.92529175559067,16.0747082444093
"2010","globe",14.1434116621212,19,10,9,2.92529175559067,16.0747082444093
"2010","im gonna hold",14.1434116621212,19,10,9,2.92529175559067,16.0747082444093
"2010","know babe",14.1434116621212,19,10,9,2.92529175559067,16.0747082444093
"2010","lay bed",14.1434116621212,19,10,9,2.92529175559067,16.0747082444093
"2010","pose",14.1434116621212,19,10,9,2.92529175559067,16.0747082444093
"2010","something special",14.1434116621212,19,10,9,2.92529175559067,16.0747082444093
"2010","away words",14.1239422169902,8,6,2,1.23170179182765,6.76829820817235
"2010","ball never",14.1239422169902,8,6,2,1.23170179182765,6.76829820817235
"2010","break walls",14.1239422169902,8,6,2,1.23170179182765,6.76829820817235
"2010","break yeah",14.1239422169902,8,6,2,1.23170179182765,6.76829820817235
"2010","cant save",14.1239422169902,8,6,2,1.23170179182765,6.76829820817235
"2010","city im",14.1239422169902,8,6,2,1.23170179182765,6.76829820817235
"2010","fat ass",14.1239422169902,8,6,2,1.23170179182765,6.76829820817235
"2010","fire can",14.1239422169902,8,6,2,1.23170179182765,6.76829820817235
"2010","get faded",14.1239422169902,8,6,2,1.23170179182765,6.76829820817235
"2010","going im",14.1239422169902,8,6,2,1.23170179182765,6.76829820817235
"2010","good life good",14.1239422169902,8,6,2,1.23170179182765,6.76829820817235
"2010","got running",14.1239422169902,8,6,2,1.23170179182765,6.76829820817235
"2010","home hard",14.1239422169902,8,6,2,1.23170179182765,6.76829820817235
"2010","id fly",14.1239422169902,8,6,2,1.23170179182765,6.76829820817235
"2010","keep like",14.1239422169902,8,6,2,1.23170179182765,6.76829820817235
"2010","kiss til",14.1239422169902,8,6,2,1.23170179182765,6.76829820817235
"2010","league",14.1239422169902,8,6,2,1.23170179182765,6.76829820817235
"2010","let go wanna",14.1239422169902,8,6,2,1.23170179182765,6.76829820817235
"2010","lights light",14.1239422169902,8,6,2,1.23170179182765,6.76829820817235
"2010","like room",14.1239422169902,8,6,2,1.23170179182765,6.76829820817235
"2010","made wanna",14.1239422169902,8,6,2,1.23170179182765,6.76829820817235
"2010","make easy",14.1239422169902,8,6,2,1.23170179182765,6.76829820817235
"2010","ohwhoa",14.1239422169902,8,6,2,1.23170179182765,6.76829820817235
"2010","okay now",14.1239422169902,8,6,2,1.23170179182765,6.76829820817235
"2010","pain ever",14.1239422169902,8,6,2,1.23170179182765,6.76829820817235
"2010","pretty sure",14.1239422169902,8,6,2,1.23170179182765,6.76829820817235
"2010","problems dont",14.1239422169902,8,6,2,1.23170179182765,6.76829820817235
"2010","right rock",14.1239422169902,8,6,2,1.23170179182765,6.76829820817235
"2010","see face theres",14.1239422169902,8,6,2,1.23170179182765,6.76829820817235
"2010","send away",14.1239422169902,8,6,2,1.23170179182765,6.76829820817235
"2010","shame now",14.1239422169902,8,6,2,1.23170179182765,6.76829820817235
"2010","someone lean",14.1239422169902,8,6,2,1.23170179182765,6.76829820817235
"2010","spend days",14.1239422169902,8,6,2,1.23170179182765,6.76829820817235
"2010","wanna hold hand",14.1239422169902,8,6,2,1.23170179182765,6.76829820817235
"2010","ways love",14.1239422169902,8,6,2,1.23170179182765,6.76829820817235
"2010","whoaim",14.1239422169902,8,6,2,1.23170179182765,6.76829820817235
"2010","will yeah",14.1239422169902,8,6,2,1.23170179182765,6.76829820817235
"2010","youre coming home",14.1239422169902,8,6,2,1.23170179182765,6.76829820817235
"1960","tide",14.1092632060103,50,11,39,2.9861636696437,47.0138363303563
"2000","bathroom",14.109220440328,35,20,15,9.41799905243618,25.5820009475638
"2000","just want know",14.109220440328,35,20,15,9.41799905243618,25.5820009475638
"2000","lonely lonely",14.109220440328,35,20,15,9.41799905243618,25.5820009475638
"1980","freeway",14.1069891938577,27,13,14,4.5423646463766,22.4576353536234
"1980","hunger",14.1069891938577,27,13,14,4.5423646463766,22.4576353536234
"1980","miss like",14.1069891938577,27,13,14,4.5423646463766,22.4576353536234
"1980","treat bad",14.1069891938577,27,13,14,4.5423646463766,22.4576353536234
"1990","another place",14.1062676235769,20,12,8,4.24289391859063,15.7571060814094
"1990","dont dont dont dont",14.1062676235769,20,12,8,4.24289391859063,15.7571060814094
"1990","friday saturday",14.1062676235769,20,12,8,4.24289391859063,15.7571060814094
"1990","go every",14.1062676235769,20,12,8,4.24289391859063,15.7571060814094
"1990","jeep",14.1062676235769,20,12,8,4.24289391859063,15.7571060814094
"1990","kiss goodnight",14.1062676235769,20,12,8,4.24289391859063,15.7571060814094
"1990","little crazy",14.1062676235769,20,12,8,4.24289391859063,15.7571060814094
"1990","never feel",14.1062676235769,20,12,8,4.24289391859063,15.7571060814094
"1990","never needed",14.1062676235769,20,12,8,4.24289391859063,15.7571060814094
"1990","thursday friday",14.1062676235769,20,12,8,4.24289391859063,15.7571060814094
"1990","thursday friday saturday",14.1062676235769,20,12,8,4.24289391859063,15.7571060814094
"1990","want something",14.1062676235769,20,12,8,4.24289391859063,15.7571060814094
"1990","wednesday thursday friday",14.1062676235769,20,12,8,4.24289391859063,15.7571060814094
"1990","wednesday thursday friday saturday",14.1062676235769,20,12,8,4.24289391859063,15.7571060814094
"1990","youre crazy",14.1062676235769,20,12,8,4.24289391859063,15.7571060814094
"2010","im gonna show",14.105667456681,29,13,16,4.46491899537523,24.5350810046248
"2010","july",14.105667456681,29,13,16,4.46491899537523,24.5350810046248
"2010","mean im",14.105667456681,29,13,16,4.46491899537523,24.5350810046248
"2010","one thats",14.105667456681,29,13,16,4.46491899537523,24.5350810046248
"2010","speakers",14.105667456681,29,13,16,4.46491899537523,24.5350810046248
"1980","come save",14.1031290091811,15,9,6,2.52353591465367,12.4764640853463
"1980","dont know wont",14.1031290091811,15,9,6,2.52353591465367,12.4764640853463
"1980","hand oh",14.1031290091811,15,9,6,2.52353591465367,12.4764640853463
"1980","ill friend",14.1031290091811,15,9,6,2.52353591465367,12.4764640853463
"1980","notorious",14.1031290091811,15,9,6,2.52353591465367,12.4764640853463
"1980","want hurt",14.1031290091811,15,9,6,2.52353591465367,12.4764640853463
"1980","want little",14.1031290091811,15,9,6,2.52353591465367,12.4764640853463
"1980","warning",14.1031290091811,15,9,6,2.52353591465367,12.4764640853463
"1980","wont wait",14.1031290091811,15,9,6,2.52353591465367,12.4764640853463
"1970","ride ride ride",14.0997158181478,40,15,25,5.47391567372392,34.5260843262761
"1970","southern",14.0997158181478,40,15,25,5.47391567372392,34.5260843262761
"1970","tell just",14.0997158181478,40,15,25,5.47391567372392,34.5260843262761
"2010","want want",14.0987993080874,193,50,143,29.7148057278421,163.285194272158
"2010","til",14.0915930213868,594,126,468,91.453858043203,502.546141956797
"1990","crush",14.0908925027301,74,30,44,15.6987074987853,58.3012925012147
"2000","act fool",14.0899547751225,13,10,3,3.49811393376201,9.50188606623799
"2000","always thinking",14.0899547751225,13,10,3,3.49811393376201,9.50188606623799
"2000","angel youre",14.0899547751225,13,10,3,3.49811393376201,9.50188606623799
"2000","balling",14.0899547751225,13,10,3,3.49811393376201,9.50188606623799
"2000","beverly hills",14.0899547751225,13,10,3,3.49811393376201,9.50188606623799
"2000","call lover",14.0899547751225,13,10,3,3.49811393376201,9.50188606623799
"2000","crazyi",14.0899547751225,13,10,3,3.49811393376201,9.50188606623799
"2000","dance gonna",14.0899547751225,13,10,3,3.49811393376201,9.50188606623799
"2000","done im",14.0899547751225,13,10,3,3.49811393376201,9.50188606623799
"2000","game want",14.0899547751225,13,10,3,3.49811393376201,9.50188606623799
"2000","girl girl girl",14.0899547751225,13,10,3,3.49811393376201,9.50188606623799
"2000","good morning",14.0899547751225,13,10,3,3.49811393376201,9.50188606623799
"2000","got something say",14.0899547751225,13,10,3,3.49811393376201,9.50188606623799
"2000","groupie",14.0899547751225,13,10,3,3.49811393376201,9.50188606623799
"2000","handful",14.0899547751225,13,10,3,3.49811393376201,9.50188606623799
"2000","hes never",14.0899547751225,13,10,3,3.49811393376201,9.50188606623799
"2000","just want love",14.0899547751225,13,10,3,3.49811393376201,9.50188606623799
"2000","make will",14.0899547751225,13,10,3,3.49811393376201,9.50188606623799
"2000","needin",14.0899547751225,13,10,3,3.49811393376201,9.50188606623799
"2000","now everything",14.0899547751225,13,10,3,3.49811393376201,9.50188606623799
"2000","right man",14.0899547751225,13,10,3,3.49811393376201,9.50188606623799
"2000","start fight",14.0899547751225,13,10,3,3.49811393376201,9.50188606623799
"2000","tee",14.0899547751225,13,10,3,3.49811393376201,9.50188606623799
"2000","thought wed",14.0899547751225,13,10,3,3.49811393376201,9.50188606623799
"2000","tried best",14.0899547751225,13,10,3,3.49811393376201,9.50188606623799
"2010","barefoot",14.0894370343332,16,9,7,2.4634035836553,13.5365964163447
"2010","beating like",14.0894370343332,16,9,7,2.4634035836553,13.5365964163447
"2010","beating like drum",14.0894370343332,16,9,7,2.4634035836553,13.5365964163447
"2010","behave",14.0894370343332,16,9,7,2.4634035836553,13.5365964163447
"2010","breathless",14.0894370343332,16,9,7,2.4634035836553,13.5365964163447
"2010","every heart",14.0894370343332,16,9,7,2.4634035836553,13.5365964163447
"2010","im club",14.0894370343332,16,9,7,2.4634035836553,13.5365964163447
"2010","used used",14.0894370343332,16,9,7,2.4634035836553,13.5365964163447
"1990","believe love",14.084939846684,61,26,35,12.9408264517014,48.0591735482986
"1990","see get",14.084939846684,61,26,35,12.9408264517014,48.0591735482986
"2010","single",14.0806227107737,198,51,147,30.4846193477343,167.515380652266
"2000","im looking",14.080344107259,96,43,53,25.8322259723964,70.1677740276036
"1970","im fire",14.0735284200993,32,13,19,4.37913253897913,27.6208674610209
"1970","sleeps",14.0735284200993,32,13,19,4.37913253897913,27.6208674610209
"2000","knowin",14.0730587986207,50,26,24,13.4542843606231,36.5457156393769
"2000","pouring",14.0730587986207,50,26,24,13.4542843606231,36.5457156393769
"2010","dive",14.0577081189042,40,16,24,6.15850895913825,33.8414910408617
"2010","flames",14.0577081189042,40,16,24,6.15850895913825,33.8414910408617
"2010","wanna leave",14.0577081189042,40,16,24,6.15850895913825,33.8414910408617
"1960","life let",14.0486812482069,28,8,20,1.67225165500047,26.3277483449995
"1960","nananana",14.0486812482069,28,8,20,1.67225165500047,26.3277483449995
"1960","old song",14.0486812482069,28,8,20,1.67225165500047,26.3277483449995
"1960","youre lookin",14.0486812482069,28,8,20,1.67225165500047,26.3277483449995
"2000","bra",14.0428853207826,17,12,5,4.57445668261186,12.4255433173881
"2000","def",14.0428853207826,17,12,5,4.57445668261186,12.4255433173881
"2000","drift away",14.0428853207826,17,12,5,4.57445668261186,12.4255433173881
"2000","girl didnt",14.0428853207826,17,12,5,4.57445668261186,12.4255433173881
"2000","girl know need",14.0428853207826,17,12,5,4.57445668261186,12.4255433173881
"2000","guts",14.0428853207826,17,12,5,4.57445668261186,12.4255433173881
"2000","people yeah",14.0428853207826,17,12,5,4.57445668261186,12.4255433173881
"2000","sometimes wish",14.0428853207826,17,12,5,4.57445668261186,12.4255433173881
"1970","ill take",14.0421060561961,151,38,113,20.6640316683078,130.335968331692
"1990","hows",14.0407996187566,28,15,13,5.94005148602689,22.0599485139731
"1990","mmm mmm mmm",14.0407996187566,28,15,13,5.94005148602689,22.0599485139731
"1960","mess",14.0370659609755,207,27,180,12.3627175923249,194.637282407675
"2000","keep running",14.0082600751691,28,17,11,7.53439924194894,20.4656007580511
"2000","like get",14.0082600751691,28,17,11,7.53439924194894,20.4656007580511
"2000","ya see",14.0082600751691,28,17,11,7.53439924194894,20.4656007580511
"1970","gonna let",14.0057840543699,95,27,68,13.0005497250943,81.9994502749057
"2000","boom",13.997659734574,305,112,193,82.071134599801,222.928865400199
"2000","always call",13.9901762457939,15,11,4,4.03628530818693,10.9637146918131
"2000","back hit",13.9901762457939,15,11,4,4.03628530818693,10.9637146918131
"2000","den",13.9901762457939,15,11,4,4.03628530818693,10.9637146918131
"2000","eyes can feel",13.9901762457939,15,11,4,4.03628530818693,10.9637146918131
"2000","friends cause",13.9901762457939,15,11,4,4.03628530818693,10.9637146918131
"2000","fur",13.9901762457939,15,11,4,4.03628530818693,10.9637146918131
"2000","goin baby",13.9901762457939,15,11,4,4.03628530818693,10.9637146918131
"2000","gon stop",13.9901762457939,15,11,4,4.03628530818693,10.9637146918131
"2000","love girls",13.9901762457939,15,11,4,4.03628530818693,10.9637146918131
"2000","matches",13.9901762457939,15,11,4,4.03628530818693,10.9637146918131
"2000","nothing comes",13.9901762457939,15,11,4,4.03628530818693,10.9637146918131
"2000","now ya",13.9901762457939,15,11,4,4.03628530818693,10.9637146918131
"2000","put thing",13.9901762457939,15,11,4,4.03628530818693,10.9637146918131
"2000","shield",13.9901762457939,15,11,4,4.03628530818693,10.9637146918131
"2000","show got cause",13.9901762457939,15,11,4,4.03628530818693,10.9637146918131
"2000","slack",13.9901762457939,15,11,4,4.03628530818693,10.9637146918131
"2000","waiting call",13.9901762457939,15,11,4,4.03628530818693,10.9637146918131
"1990","love ill",13.9767661107807,91,35,56,19.3051673295874,71.6948326704126
"2010","sound",13.9733342893019,405,91,314,62.3549032112748,342.645096788725
"2000","dont matter",13.9711231589709,74,35,39,19.9123408537222,54.0876591462778
"1970","begin",13.969834614191,110,30,80,15.0532681027408,94.9467318972592
"1970","nana",13.9672776870689,105,29,76,14.3690286435253,90.6309713564747
"2010","sky",13.9562198814359,562,120,442,86.5270508758924,475.472949124108
"1980","may",13.9512505567311,476,112,364,80.0802063583431,395.919793641657
"1970","flyin",13.9507761099212,21,10,11,2.87380572870506,18.1261942712949
"1970","oh darling",13.9507761099212,21,10,11,2.87380572870506,18.1261942712949
"1970","thats much",13.9507761099212,21,10,11,2.87380572870506,18.1261942712949
"1970","wrong can",13.9507761099212,21,10,11,2.87380572870506,18.1261942712949
"1980","hungry",13.944685138423,71,25,46,11.944736662694,59.055263337306
"2010","throwing",13.9396388260269,44,17,27,6.77435985505208,37.2256401449479
"1970","love love love love",13.9291994986153,162,40,122,22.1693584785819,139.830641521418
"1980","known better",13.9272236641355,24,12,12,4.03765746344587,19.9623425365541
"1980","youre arms",13.9272236641355,24,12,12,4.03765746344587,19.9623425365541
"1980","little thing",13.9187843978329,108,34,74,18.1694585855064,89.8305414144936
"1980","much love",13.9187843978329,108,34,74,18.1694585855064,89.8305414144936
"1960","well",13.918560852266,2420,190,2230,144.530321610755,2275.46967838925
"2010","awake",13.9126725995496,90,28,62,13.8566451580611,76.1433548419389
"2010","go oh",13.9126725995496,90,28,62,13.8566451580611,76.1433548419389
"2000","locked",13.8926327886844,102,45,57,27.4467400956712,74.5532599043289
"2010","baby like",13.8828693044837,56,20,36,8.62191254279355,47.3780874572064
"2010","im right",13.8828693044837,56,20,36,8.62191254279355,47.3780874572064
"1960","empty without",13.8779994653331,16,6,10,0.955572374285983,15.044427625714
"1960","getting better",13.8779994653331,16,6,10,0.955572374285983,15.044427625714
"1960","god must",13.8779994653331,16,6,10,0.955572374285983,15.044427625714
"1960","need love love",13.8779994653331,16,6,10,0.955572374285983,15.044427625714
"1960","outta sight",13.8779994653331,16,6,10,0.955572374285983,15.044427625714
"1960","say little",13.8779994653331,16,6,10,0.955572374285983,15.044427625714
"1990","love cant",13.868212887493,112,41,71,23.7602059441075,88.2397940558925
"1980","give never",13.8644653658065,18,10,8,3.0282430975844,14.9717569024156
"1980","got secret",13.8644653658065,18,10,8,3.0282430975844,14.9717569024156
"1980","ticking",13.8644653658065,18,10,8,3.0282430975844,14.9717569024156
"2000","hey",13.8475403934435,2216,675,1541,596.293882862816,1619.70611713718
"1980","across heart",13.8413991802585,10,7,3,1.68235727643578,8.31764272356422
"1980","avoid",13.8413991802585,10,7,3,1.68235727643578,8.31764272356422
"1980","away theres",13.8413991802585,10,7,3,1.68235727643578,8.31764272356422
"1980","bizarre",13.8413991802585,10,7,3,1.68235727643578,8.31764272356422
"1980","cold dark",13.8413991802585,10,7,3,1.68235727643578,8.31764272356422
"1980","everybodys looking",13.8413991802585,10,7,3,1.68235727643578,8.31764272356422
"1980","feel rhythm",13.8413991802585,10,7,3,1.68235727643578,8.31764272356422
"1980","forevermore",13.8413991802585,10,7,3,1.68235727643578,8.31764272356422
"1980","hot summer",13.8413991802585,10,7,3,1.68235727643578,8.31764272356422
"1980","im saving",13.8413991802585,10,7,3,1.68235727643578,8.31764272356422
"1980","ive got let know",13.8413991802585,10,7,3,1.68235727643578,8.31764272356422
"1980","just will",13.8413991802585,10,7,3,1.68235727643578,8.31764272356422
"1980","know may",13.8413991802585,10,7,3,1.68235727643578,8.31764272356422
"1980","know maybe",13.8413991802585,10,7,3,1.68235727643578,8.31764272356422
"1980","les",13.8413991802585,10,7,3,1.68235727643578,8.31764272356422
"1980","like glove",13.8413991802585,10,7,3,1.68235727643578,8.31764272356422
"1980","lonely can",13.8413991802585,10,7,3,1.68235727643578,8.31764272356422
"1980","method",13.8413991802585,10,7,3,1.68235727643578,8.31764272356422
"1980","need im gonna",13.8413991802585,10,7,3,1.68235727643578,8.31764272356422
"1980","opening",13.8413991802585,10,7,3,1.68235727643578,8.31764272356422
"1980","said theres",13.8413991802585,10,7,3,1.68235727643578,8.31764272356422
"1980","step step step step",13.8413991802585,10,7,3,1.68235727643578,8.31764272356422
"1980","tonight sweet",13.8413991802585,10,7,3,1.68235727643578,8.31764272356422
"1980","touch ground",13.8413991802585,10,7,3,1.68235727643578,8.31764272356422
"1980","youyes",13.8413991802585,10,7,3,1.68235727643578,8.31764272356422
"1980","change love",13.8321407042228,21,11,10,3.53295028051514,17.4670497194849
"1980","easy see",13.8321407042228,21,11,10,3.53295028051514,17.4670497194849
"1980","love dont want",13.8321407042228,21,11,10,3.53295028051514,17.4670497194849
"1980","oh baby oh",13.8321407042228,21,11,10,3.53295028051514,17.4670497194849
"1980","one man",13.8321407042228,21,11,10,3.53295028051514,17.4670497194849
"1980","stride",13.8321407042228,21,11,10,3.53295028051514,17.4670497194849
"1980","yeah shes",13.8321407042228,21,11,10,3.53295028051514,17.4670497194849
"1980","youre every",13.8321407042228,21,11,10,3.53295028051514,17.4670497194849
"1990","bam",13.8259380675211,31,16,15,6.57648557381548,24.4235144261845
"1990","something wrong",13.8259380675211,31,16,15,6.57648557381548,24.4235144261845
"1990","wanna fall",13.8259380675211,31,16,15,6.57648557381548,24.4235144261845
"2010","id rather",13.8257585329878,122,35,87,18.7834523253717,103.216547674628
"1980","let love",13.8116783877163,248,65,183,41.7224604556073,206.277539544393
"1980","alone now",13.8091816196593,34,15,19,5.72001473988165,28.2799852601184
"1980","mercedes",13.8091816196593,34,15,19,5.72001473988165,28.2799852601184
"1980","teacher",13.8091816196593,34,15,19,5.72001473988165,28.2799852601184
"1980","thats true",13.8091816196593,34,15,19,5.72001473988165,28.2799852601184
"1980","vacation",13.8091816196593,34,15,19,5.72001473988165,28.2799852601184
"1980","oh wont",13.8060567543298,41,17,24,6.8976648333867,34.1023351666133
"1980","willing",13.8060567543298,41,17,24,6.8976648333867,34.1023351666133
"1980","best can",13.7918047890987,52,20,32,8.74825783746605,43.251742162534
"1980","saving",13.7918047890987,52,20,32,8.74825783746605,43.251742162534
"1960","cry",13.7902820251919,899,82,817,53.6912227801937,845.308777219806
"1970","right wrong",13.7785790035147,49,17,32,6.7055467003118,42.2944532996882
"1960","can sure",13.7782808197597,22,7,15,1.31391201464323,20.6860879853568
"1960","can want",13.7782808197597,22,7,15,1.31391201464323,20.6860879853568
"1960","deepest",13.7782808197597,22,7,15,1.31391201464323,20.6860879853568
"1960","ready ready",13.7782808197597,22,7,15,1.31391201464323,20.6860879853568
"1960","rope",13.7782808197597,22,7,15,1.31391201464323,20.6860879853568
"1960","wild thing",13.7782808197597,22,7,15,1.31391201464323,20.6860879853568
"1960","winters",13.7782808197597,22,7,15,1.31391201464323,20.6860879853568
"1960","wished",13.7782808197597,22,7,15,1.31391201464323,20.6860879853568
"1990","always baby",13.7680013939262,13,9,4,2.75788104708391,10.2421189529161
"1990","baby set",13.7680013939262,13,9,4,2.75788104708391,10.2421189529161
"1990","dance now",13.7680013939262,13,9,4,2.75788104708391,10.2421189529161
"1990","ever dreamed",13.7680013939262,13,9,4,2.75788104708391,10.2421189529161
"1990","girl swear",13.7680013939262,13,9,4,2.75788104708391,10.2421189529161
"1990","go flow",13.7680013939262,13,9,4,2.75788104708391,10.2421189529161
"1990","ill never forget",13.7680013939262,13,9,4,2.75788104708391,10.2421189529161
"1990","im letting go",13.7680013939262,13,9,4,2.75788104708391,10.2421189529161
"1990","move music",13.7680013939262,13,9,4,2.75788104708391,10.2421189529161
"1990","rump",13.7680013939262,13,9,4,2.75788104708391,10.2421189529161
"1990","want spend",13.7680013939262,13,9,4,2.75788104708391,10.2421189529161
"1990","washes",13.7680013939262,13,9,4,2.75788104708391,10.2421189529161
"1990","whyi",13.7680013939262,13,9,4,2.75788104708391,10.2421189529161
"2010","got like",13.7553312400318,33,14,19,5.08076989128906,27.9192301087109
"2000","paul",13.7323104140907,53,27,26,14.2615414222605,38.7384585777395
"2000","thing thats",13.7323104140907,53,27,26,14.2615414222605,38.7384585777395
"1990","one im",13.7181182875409,78,31,47,16.5472862825035,61.4527137174965
"2000","outta",13.7047250475558,188,74,114,50.5881091959429,137.411890804057
"2010","need need",13.6908960129503,95,29,66,14.6264587779533,80.3735412220467
"1990","flows",13.6895280621437,34,17,17,7.21291966160408,26.7870803383959
"1990","need can",13.6895280621437,34,17,17,7.21291966160408,26.7870803383959
"1970","cause love",13.6869694618335,121,32,89,16.5585949130148,104.441405086985
"1960","change mind",13.6850729217792,68,13,55,4.06118259071543,63.9388174092846
"1960","look around",13.6850729217792,68,13,55,4.06118259071543,63.9388174092846
"2000","system",13.6732062390212,33,19,14,8.87982767801125,24.1201723219887
"2000","scream",13.6621534827174,155,63,92,41.7082815179316,113.291718482068
"1960","can can",13.6602643972426,105,17,88,6.27094370625176,98.7290562937482
"1990","rap",13.6565450686263,102,38,64,21.6387589848122,80.3612410151878
"1990","im never",13.6469869461984,109,40,69,23.1237718563189,85.8762281436811
"2000","attention",13.6460321916104,80,37,43,21.526854976997,58.473145023003
"2000","biz",13.6299150288378,26,16,10,6.99622786752402,19.003772132476
"2000","far away far",13.6299150288378,26,16,10,6.99622786752402,19.003772132476
"2000","next thing",13.6299150288378,26,16,10,6.99622786752402,19.003772132476
"2000","whats love",13.6299150288378,26,16,10,6.99622786752402,19.003772132476
"1990","knew love",13.6212084484535,46,21,25,9.75865601275846,36.2413439872415
"1990","play funky",13.6212084484535,46,21,25,9.75865601275846,36.2413439872415
"1990","put hand",13.6212084484535,46,21,25,9.75865601275846,36.2413439872415
"2000","one",13.6208445488586,5413,1578,3835,1456.56082488106,3956.43917511894
"1960","shed",13.6088544921918,115,18,97,6.8681764401805,108.131823559819
"1970","stop now",13.6062333259074,45,16,29,6.15815513293941,38.8418448670606
"2000","get im",13.5966147255062,48,25,23,12.9161129861982,35.0838870138018
"1970","tell tell",13.5956331180439,72,22,50,9.85304821270305,62.146951787297
"1990","im every",13.5891222644462,23,13,10,4.87932800637923,18.1206719936208
"1990","love real",13.5865614835515,43,20,23,9.12222192496986,33.8777780750301
"1990","love come get",13.5812770825318,40,19,21,8.48578783718126,31.5142121628187
"1990","nigga like",13.5812770825318,40,19,21,8.48578783718126,31.5142121628187
"1990","shoo",13.5812770825318,40,19,21,8.48578783718126,31.5142121628187
"1970","god im",13.5795872071559,25,11,14,3.42119729607745,21.5788027039226
"1970","love best",13.5795872071559,25,11,14,3.42119729607745,21.5788027039226
"2010","woah",13.5782683936228,82,26,56,12.6249433662334,69.3750566337666
"1980","reasons",13.5658624474475,60,22,38,10.0941436586147,49.9058563413853
"1990","givin",13.5514609482126,193,63,130,40.9439263143996,152.0560736856
"2000","dogg",13.5347227140987,38,21,17,10.2252561140736,27.7747438859264
"2010","now im gonna",13.5272329734711,37,15,22,5.69662078720288,31.3033792127971
"2000","like child",13.522545609015,43,23,20,11.5706845501359,31.4293154498641
"2000","lost without",13.522545609015,43,23,20,11.5706845501359,31.4293154498641
"1980","make feel",13.5213288140021,404,97,307,67.9672339680055,336.032766031995
"1960","days gone",13.5127892350964,29,8,21,1.73197492839334,27.2680250716067
"1960","everlasting",13.5127892350964,29,8,21,1.73197492839334,27.2680250716067
"1960","one like",13.5127892350964,29,8,21,1.73197492839334,27.2680250716067
"1960","swim",13.5127892350964,29,8,21,1.73197492839334,27.2680250716067
"2000","couple",13.5102340007078,120,51,69,32.2902824654955,87.7097175345045
"2010","want can",13.5032020225991,65,22,43,10.0075770585997,54.9924229414003
"1960","gray",13.4962945421401,60,12,48,3.58339640357244,56.4166035964276
"1970","dancing dancing",13.4955942424339,18,9,9,2.46326205317576,15.5367379468242
"1970","doin doin",13.4955942424339,18,9,9,2.46326205317576,15.5367379468242
"1970","heaven must",13.4955942424339,18,9,9,2.46326205317576,15.5367379468242
"1970","jim",13.4955942424339,18,9,9,2.46326205317576,15.5367379468242
"1970","just cant help",13.4955942424339,18,9,9,2.46326205317576,15.5367379468242
"1970","people can",13.4955942424339,18,9,9,2.46326205317576,15.5367379468242
"1970","sally",13.4955942424339,18,9,9,2.46326205317576,15.5367379468242
"1970","way ive",13.4955942424339,18,9,9,2.46326205317576,15.5367379468242
"2000","used",13.4894332451203,732,242,490,196.970723039522,535.029276960478
"1980","lets start",13.4855591973754,31,14,17,5.21530755695092,25.7846924430491
"1980","love youi",13.4855591973754,31,14,17,5.21530755695092,25.7846924430491
"1980","now hey",13.4855591973754,31,14,17,5.21530755695092,25.7846924430491
"1980","always",13.4686283709601,1781,359,1422,299.627830933212,1481.37216906679
"1980","list",13.4670485915895,68,24,44,11.4400294797633,56.5599705202367
"2010","wish",13.4585538432437,839,169,670,129.174725417925,709.825274582075
"1970","couldnt see",13.4521718489838,54,18,36,7.38978615952729,46.6102138404727
"1970","someones",13.4521718489838,54,18,36,7.38978615952729,46.6102138404727
"2010","just feel",13.4227320528212,78,25,53,12.0090924703196,65.9909075296804
"2010","stars",13.4151912458253,313,73,240,48.1903326052568,264.809667394743
"1980","please let",13.4136844858525,38,16,22,6.39295765045596,31.607042349544
"2010","lose mind",13.4129158269303,61,21,40,9.39172616268583,51.6082738373142
"1970","im fine",13.400688960297,29,12,17,3.96858886344984,25.0314111365502
"1970","love see",13.400688960297,29,12,17,3.96858886344984,25.0314111365502
"1990","change cant",13.3919340291873,18,11,7,3.81860452673157,14.1813954732684
"1990","low let",13.3919340291873,18,11,7,3.81860452673157,14.1813954732684
"1990","much dont",13.3919340291873,18,11,7,3.81860452673157,14.1813954732684
"1990","night ill",13.3919340291873,18,11,7,3.81860452673157,14.1813954732684
"1990","pay bills",13.3919340291873,18,11,7,3.81860452673157,14.1813954732684
"1990","sky ill",13.3919340291873,18,11,7,3.81860452673157,14.1813954732684
"1960","therell",13.3873242921424,69,13,56,4.1209058641083,64.8790941358917
"1960","pie",13.3837115368249,44,10,34,2.62782402928645,41.3721759707135
"1980","called",13.382682760912,231,61,170,38.8624530856665,192.137546914333
"2010","blood",13.3812387846529,128,36,92,19.7072286692424,108.292771330758
"1970","lightning",13.3767606068139,37,14,23,5.06337199819462,31.9366280018054
"1970","love baby baby",13.3767606068139,37,14,23,5.06337199819462,31.9366280018054
"1990","ask ill",13.3474747254005,11,8,3,2.33359165522485,8.66640834477515
"1990","baby baby baby dont",13.3474747254005,11,8,3,2.33359165522485,8.66640834477515
"1990","baby dont say",13.3474747254005,11,8,3,2.33359165522485,8.66640834477515
"1990","baby just wanna",13.3474747254005,11,8,3,2.33359165522485,8.66640834477515
"1990","boys boys",13.3474747254005,11,8,3,2.33359165522485,8.66640834477515
"1990","changed world",13.3474747254005,11,8,3,2.33359165522485,8.66640834477515
"1990","even wanna",13.3474747254005,11,8,3,2.33359165522485,8.66640834477515
"1990","ever fall",13.3474747254005,11,8,3,2.33359165522485,8.66640834477515
"1990","ever really",13.3474747254005,11,8,3,2.33359165522485,8.66640834477515
"1990","girl bet",13.3474747254005,11,8,3,2.33359165522485,8.66640834477515
"1990","huh say",13.3474747254005,11,8,3,2.33359165522485,8.66640834477515
"1990","ill kiss",13.3474747254005,11,8,3,2.33359165522485,8.66640834477515
"1990","im losing mind",13.3474747254005,11,8,3,2.33359165522485,8.66640834477515
"1990","im missin",13.3474747254005,11,8,3,2.33359165522485,8.66640834477515
"1990","inside cause",13.3474747254005,11,8,3,2.33359165522485,8.66640834477515
"1990","jesse",13.3474747254005,11,8,3,2.33359165522485,8.66640834477515
"1990","just dont feel",13.3474747254005,11,8,3,2.33359165522485,8.66640834477515
"1990","left youre",13.3474747254005,11,8,3,2.33359165522485,8.66640834477515
"1990","like vision",13.3474747254005,11,8,3,2.33359165522485,8.66640834477515
"1990","look just like",13.3474747254005,11,8,3,2.33359165522485,8.66640834477515
"1990","love can feel",13.3474747254005,11,8,3,2.33359165522485,8.66640834477515
"1990","love somethin",13.3474747254005,11,8,3,2.33359165522485,8.66640834477515
"1990","missing now",13.3474747254005,11,8,3,2.33359165522485,8.66640834477515
"1990","nothin better",13.3474747254005,11,8,3,2.33359165522485,8.66640834477515
"1990","oh run",13.3474747254005,11,8,3,2.33359165522485,8.66640834477515
"1990","one hand",13.3474747254005,11,8,3,2.33359165522485,8.66640834477515
"1990","opposites attract",13.3474747254005,11,8,3,2.33359165522485,8.66640834477515
"1990","put one",13.3474747254005,11,8,3,2.33359165522485,8.66640834477515
"1990","ready know",13.3474747254005,11,8,3,2.33359165522485,8.66640834477515
"1990","realize need",13.3474747254005,11,8,3,2.33359165522485,8.66640834477515
"1990","seduce",13.3474747254005,11,8,3,2.33359165522485,8.66640834477515
"1990","side best",13.3474747254005,11,8,3,2.33359165522485,8.66640834477515
"1990","sure im",13.3474747254005,11,8,3,2.33359165522485,8.66640834477515
"1990","yeah yeah hey",13.3474747254005,11,8,3,2.33359165522485,8.66640834477515
"1990","youre mood",13.3474747254005,11,8,3,2.33359165522485,8.66640834477515
"1970","need friend",13.3460655729757,33,13,20,4.51598043082223,28.4840195691778
"1970","sisters",13.3460655729757,33,13,20,4.51598043082223,28.4840195691778
"1980","well take",13.3452945895863,49,19,30,8.24355065453532,40.7564493454647
"2010","bang bang bang",13.3343109512924,23,11,12,3.5411426515045,19.4588573484955
"2010","december",13.3343109512924,23,11,12,3.5411426515045,19.4588573484955
"2010","keep hands",13.3343109512924,23,11,12,3.5411426515045,19.4588573484955
"2010","know said",13.3343109512924,23,11,12,3.5411426515045,19.4588573484955
"2010","traveled",13.3343109512924,23,11,12,3.5411426515045,19.4588573484955
"2010","want shit",13.3343109512924,23,11,12,3.5411426515045,19.4588573484955
"2000","right time",13.3290059442878,75,35,40,20.1814265409347,54.8185734590653
"2010","tongue",13.3279655772496,87,27,60,13.3947569861257,73.6052430138743
"2010","nana",13.3263370430753,105,31,74,16.1660860177379,88.8339139822621
"2010","baby ive",13.3113480547936,45,17,28,6.92832257903053,38.0716774209695
"2010","bad im",13.3113480547936,45,17,28,6.92832257903053,38.0716774209695
"2010","owe",13.3113480547936,45,17,28,6.92832257903053,38.0716774209695
"2010","roads",13.3113480547936,45,17,28,6.92832257903053,38.0716774209695
"2010","without cant",13.2990012501864,53,19,34,8.16002437085818,44.8399756291418
"1970","drivin",13.2973982200395,68,21,47,9.30565664533066,58.6943433546693
"1970","baby shake shake",13.2923540424814,9,6,3,1.23163102658788,7.76836897341212
"1970","back old",13.2923540424814,9,6,3,1.23163102658788,7.76836897341212
"1970","become part",13.2923540424814,9,6,3,1.23163102658788,7.76836897341212
"1970","cant find way",13.2923540424814,9,6,3,1.23163102658788,7.76836897341212
"1970","cause rain",13.2923540424814,9,6,3,1.23163102658788,7.76836897341212
"1970","come sugar",13.2923540424814,9,6,3,1.23163102658788,7.76836897341212
"1970","criticize",13.2923540424814,9,6,3,1.23163102658788,7.76836897341212
"1970","feel home",13.2923540424814,9,6,3,1.23163102658788,7.76836897341212
"1970","find friend",13.2923540424814,9,6,3,1.23163102658788,7.76836897341212
"1970","friend know",13.2923540424814,9,6,3,1.23163102658788,7.76836897341212
"1970","frightening",13.2923540424814,9,6,3,1.23163102658788,7.76836897341212
"1970","got chance",13.2923540424814,9,6,3,1.23163102658788,7.76836897341212
"1970","got women",13.2923540424814,9,6,3,1.23163102658788,7.76836897341212
"1970","gross",13.2923540424814,9,6,3,1.23163102658788,7.76836897341212
"1970","hide feelings",13.2923540424814,9,6,3,1.23163102658788,7.76836897341212
"1970","king kong",13.2923540424814,9,6,3,1.23163102658788,7.76836897341212
"1970","like sleep",13.2923540424814,9,6,3,1.23163102658788,7.76836897341212
"1970","little dance",13.2923540424814,9,6,3,1.23163102658788,7.76836897341212
"1970","lonely people",13.2923540424814,9,6,3,1.23163102658788,7.76836897341212
"1970","love gets",13.2923540424814,9,6,3,1.23163102658788,7.76836897341212
"1970","love many",13.2923540424814,9,6,3,1.23163102658788,7.76836897341212
"1970","man back",13.2923540424814,9,6,3,1.23163102658788,7.76836897341212
"1970","meaner",13.2923540424814,9,6,3,1.23163102658788,7.76836897341212
"1970","money people",13.2923540424814,9,6,3,1.23163102658788,7.76836897341212
"1970","much ever",13.2923540424814,9,6,3,1.23163102658788,7.76836897341212
"1970","much harder",13.2923540424814,9,6,3,1.23163102658788,7.76836897341212
"1970","much strong",13.2923540424814,9,6,3,1.23163102658788,7.76836897341212
"1970","now baby baby",13.2923540424814,9,6,3,1.23163102658788,7.76836897341212
"1970","ring ring",13.2923540424814,9,6,3,1.23163102658788,7.76836897341212
"1970","rock roll rock",13.2923540424814,9,6,3,1.23163102658788,7.76836897341212
"1970","said hello",13.2923540424814,9,6,3,1.23163102658788,7.76836897341212
"1970","said wanted",13.2923540424814,9,6,3,1.23163102658788,7.76836897341212
"1970","spain",13.2923540424814,9,6,3,1.23163102658788,7.76836897341212
"1970","start dance",13.2923540424814,9,6,3,1.23163102658788,7.76836897341212
"1970","time oh oh",13.2923540424814,9,6,3,1.23163102658788,7.76836897341212
"1970","touch come",13.2923540424814,9,6,3,1.23163102658788,7.76836897341212
"1980","strong",13.2859288642774,470,110,360,79.0707919924816,390.929208007518
"2010","im living",13.2857072829432,49,18,31,7.54417347494436,41.4558265250556
"1960","leaves",13.2828754337633,97,16,81,5.79315751910877,91.2068424808912
"2010","keep mind",13.2777810001163,30,13,17,4.61888171935369,25.3811182806463
"2010","living life",13.2777810001163,30,13,17,4.61888171935369,25.3811182806463
"2010","rewind",13.2777810001163,30,13,17,4.61888171935369,25.3811182806463
"2010","staying",13.2777810001163,30,13,17,4.61888171935369,25.3811182806463
"1980","key",13.2734803872725,149,43,106,25.0671234188931,123.932876581107
"1980","love know",13.2734803872725,149,43,106,25.0671234188931,123.932876581107
"2000","help girl",13.2689896917138,24,15,9,6.45805649309909,17.5419435069009
"2000","just follow",13.2689896917138,24,15,9,6.45805649309909,17.5419435069009
"2000","mon",13.2689896917138,24,15,9,6.45805649309909,17.5419435069009
"2000","youre cold",13.2689896917138,24,15,9,6.45805649309909,17.5419435069009
"2000","boat",13.2684909906918,89,40,49,23.9486261619091,65.0513738380909
"2010","space",13.2654974631215,119,34,85,18.3215641534363,100.678435846564
"2000","strip",13.2532702808067,51,26,25,13.7233700478356,37.2766299521644
"1990","thieves",13.2465526296875,26,14,12,5.51576209416782,20.4842379058322
"1990","will lead",13.2465526296875,26,14,12,5.51576209416782,20.4842379058322
"2000","girl get",13.2429098473357,31,18,13,8.34165630358633,22.6583436964137
"1970","give little",13.2313976497934,50,17,33,6.8423945921549,43.1576054078451
"2010","king",13.2063416091563,138,38,100,21.246855909027,116.753144090973
"1980","ooh love",13.2010223722477,53,20,33,8.91649356510963,44.0835064348904
"1970","mister",13.2004064649496,59,19,40,8.07402561874278,50.9259743812572
"1970","tease",13.2004064649496,59,19,40,8.07402561874278,50.9259743812572
"1980","day now",13.1950406017194,28,13,15,4.71060037402018,23.2893996259798
"1980","ive got love",13.1950406017194,28,13,15,4.71060037402018,23.2893996259798
"1980","one will",13.1950406017194,28,13,15,4.71060037402018,23.2893996259798
"1980","dont like",13.1818028783927,136,40,96,22.8800589595266,113.119941040473
"1990","blame",13.1774853259241,263,81,182,55.7940550294668,207.205944970533
"1960","hes",13.1674581895673,841,77,764,50.227272923407,790.772727076593
"1960","loves",13.1621694335328,514,52,462,30.6977625239372,483.302237476063
"1970","rain",13.1576045808271,767,141,626,104.962333043656,662.037666956344
"1960","wastin",13.1559100274609,23,7,16,1.3736352880361,21.6263647119639
"1970","away left",13.1547655729094,15,8,7,2.05271837764647,12.9472816223535
"1970","hear ya",13.1547655729094,15,8,7,2.05271837764647,12.9472816223535
"1970","jill",13.1547655729094,15,8,7,2.05271837764647,12.9472816223535
"1970","one bad",13.1547655729094,15,8,7,2.05271837764647,12.9472816223535
"1970","whole bunch",13.1547655729094,15,8,7,2.05271837764647,12.9472816223535
"1980","darlin",13.1490137934649,181,50,131,30.4506667034876,150.549333296512
"2010","never get",13.1413682049506,70,23,47,10.7773906784919,59.2226093215081
"1980","baby wish",13.1281322132043,8,6,2,1.34588582114862,6.65411417885138
"1980","can feel heart",13.1281322132043,8,6,2,1.34588582114862,6.65411417885138
"1980","care think",13.1281322132043,8,6,2,1.34588582114862,6.65411417885138
"1980","chameleon",13.1281322132043,8,6,2,1.34588582114862,6.65411417885138
"1980","dont want money",13.1281322132043,8,6,2,1.34588582114862,6.65411417885138
"1980","dying day",13.1281322132043,8,6,2,1.34588582114862,6.65411417885138
"1980","eyes give",13.1281322132043,8,6,2,1.34588582114862,6.65411417885138
"1980","fading fast",13.1281322132043,8,6,2,1.34588582114862,6.65411417885138
"1980","fine day",13.1281322132043,8,6,2,1.34588582114862,6.65411417885138
"1980","goes long",13.1281322132043,8,6,2,1.34588582114862,6.65411417885138
"1980","got keep moving",13.1281322132043,8,6,2,1.34588582114862,6.65411417885138
"1980","hear baby",13.1281322132043,8,6,2,1.34588582114862,6.65411417885138
"1980","ive wanting",13.1281322132043,8,6,2,1.34588582114862,6.65411417885138
"1980","laugh dont",13.1281322132043,8,6,2,1.34588582114862,6.65411417885138
"1980","makes sound",13.1281322132043,8,6,2,1.34588582114862,6.65411417885138
"1980","mistake oh",13.1281322132043,8,6,2,1.34588582114862,6.65411417885138
"1980","name across heart",13.1281322132043,8,6,2,1.34588582114862,6.65411417885138
"1980","now ive gone",13.1281322132043,8,6,2,1.34588582114862,6.65411417885138
"1980","right im gonna",13.1281322132043,8,6,2,1.34588582114862,6.65411417885138
"1980","right waiting",13.1281322132043,8,6,2,1.34588582114862,6.65411417885138
"1980","scenes",13.1281322132043,8,6,2,1.34588582114862,6.65411417885138
"1980","stand now",13.1281322132043,8,6,2,1.34588582114862,6.65411417885138
"1980","standing line",13.1281322132043,8,6,2,1.34588582114862,6.65411417885138
"1980","still can hear",13.1281322132043,8,6,2,1.34588582114862,6.65411417885138
"1980","true ooh",13.1281322132043,8,6,2,1.34588582114862,6.65411417885138
"1980","use love",13.1281322132043,8,6,2,1.34588582114862,6.65411417885138
"1980","want ill give",13.1281322132043,8,6,2,1.34588582114862,6.65411417885138
"1980","yes boy",13.1281322132043,8,6,2,1.34588582114862,6.65411417885138
"1990","adrift",13.1258656662044,9,7,2,1.90930226336578,7.09069773663422
"1990","away youll",13.1258656662044,9,7,2,1.90930226336578,7.09069773663422
"1990","babyi dont",13.1258656662044,9,7,2,1.90930226336578,7.09069773663422
"1990","come move",13.1258656662044,9,7,2,1.90930226336578,7.09069773663422
"1990","communicate",13.1258656662044,9,7,2,1.90930226336578,7.09069773663422
"1990","crush lot",13.1258656662044,9,7,2,1.90930226336578,7.09069773663422
"1990","dissin",13.1258656662044,9,7,2,1.90930226336578,7.09069773663422
"1990","dobaby",13.1258656662044,9,7,2,1.90930226336578,7.09069773663422
"1990","eyes saw",13.1258656662044,9,7,2,1.90930226336578,7.09069773663422
"1990","feel fire",13.1258656662044,9,7,2,1.90930226336578,7.09069773663422
"1990","give love oh",13.1258656662044,9,7,2,1.90930226336578,7.09069773663422
"1990","go distance",13.1258656662044,9,7,2,1.90930226336578,7.09069773663422
"1990","good wont",13.1258656662044,9,7,2,1.90930226336578,7.09069773663422
"1990","im kickin",13.1258656662044,9,7,2,1.90930226336578,7.09069773663422
"1990","im know",13.1258656662044,9,7,2,1.90930226336578,7.09069773663422
"1990","inside baby",13.1258656662044,9,7,2,1.90930226336578,7.09069773663422
"1990","isall",13.1258656662044,9,7,2,1.90930226336578,7.09069773663422
"1990","make forget",13.1258656662044,9,7,2,1.90930226336578,7.09069773663422
"1990","mean world",13.1258656662044,9,7,2,1.90930226336578,7.09069773663422
"1990","morning can",13.1258656662044,9,7,2,1.90930226336578,7.09069773663422
"1990","oh oh theres",13.1258656662044,9,7,2,1.90930226336578,7.09069773663422
"1990","people people",13.1258656662044,9,7,2,1.90930226336578,7.09069773663422
"1990","play go",13.1258656662044,9,7,2,1.90930226336578,7.09069773663422
"1990","staring phone",13.1258656662044,9,7,2,1.90930226336578,7.09069773663422
"1990","supreme",13.1258656662044,9,7,2,1.90930226336578,7.09069773663422
"1990","sweet sensation",13.1258656662044,9,7,2,1.90930226336578,7.09069773663422
"1990","want drive",13.1258656662044,9,7,2,1.90930226336578,7.09069773663422
"1990","way find",13.1258656662044,9,7,2,1.90930226336578,7.09069773663422
"1990","whats man",13.1258656662044,9,7,2,1.90930226336578,7.09069773663422
"1990","wish turn",13.1258656662044,9,7,2,1.90930226336578,7.09069773663422
"1990","ya know love",13.1258656662044,9,7,2,1.90930226336578,7.09069773663422
"1990","youre hurting",13.1258656662044,9,7,2,1.90930226336578,7.09069773663422
"1990","youre know",13.1258656662044,9,7,2,1.90930226336578,7.09069773663422
"2000","right now",13.1252428131101,502,172,330,135.081014980656,366.918985019344
"2000","body",13.1233943134687,1089,347,742,293.034313374371,795.965686625629
"2000","keep waiting",13.1204610128794,46,24,22,12.3779416117733,33.6220583882267
"1960","open heart",13.1187115386769,37,9,28,2.20976111553634,34.7902388844637
"1960","see nothing",13.1187115386769,37,9,28,2.20976111553634,34.7902388844637
"1960","theres many",13.1187115386769,37,9,28,2.20976111553634,34.7902388844637
"2010","baby dont stop",13.1115624563936,11,7,4,1.69358996376302,9.30641003623698
"2010","come thats",13.1115624563936,11,7,4,1.69358996376302,9.30641003623698
"2010","get shit",13.1115624563936,11,7,4,1.69358996376302,9.30641003623698
"2010","gotta good",13.1115624563936,11,7,4,1.69358996376302,9.30641003623698
"2010","hate see",13.1115624563936,11,7,4,1.69358996376302,9.30641003623698
"2010","heart breaks",13.1115624563936,11,7,4,1.69358996376302,9.30641003623698
"2010","know caught",13.1115624563936,11,7,4,1.69358996376302,9.30641003623698
"2010","oh oh come",13.1115624563936,11,7,4,1.69358996376302,9.30641003623698
"2010","ooh yeah ooh yeah",13.1115624563936,11,7,4,1.69358996376302,9.30641003623698
"2010","outro",13.1115624563936,11,7,4,1.69358996376302,9.30641003623698
"2010","stop make",13.1115624563936,11,7,4,1.69358996376302,9.30641003623698
"2010","tell go",13.1115624563936,11,7,4,1.69358996376302,9.30641003623698
"2010","theres place id",13.1115624563936,11,7,4,1.69358996376302,9.30641003623698
"2010","theres place id rather",13.1115624563936,11,7,4,1.69358996376302,9.30641003623698
"2010","touch make",13.1115624563936,11,7,4,1.69358996376302,9.30641003623698
"2010","tryina",13.1115624563936,11,7,4,1.69358996376302,9.30641003623698
"2010","wanna hide",13.1115624563936,11,7,4,1.69358996376302,9.30641003623698
"2010","wont look",13.1115624563936,11,7,4,1.69358996376302,9.30641003623698
"2010","wooh",13.1115624563936,11,7,4,1.69358996376302,9.30641003623698
"2010","youve ever",13.1115624563936,11,7,4,1.69358996376302,9.30641003623698
"1980","everybody wants",13.0986521433619,57,21,36,9.58943647568394,47.4105635243161
"1960","girl better",13.0967411348475,17,6,11,1.01529564767886,15.9847043523211
"1960","got rhythm",13.0967411348475,17,6,11,1.01529564767886,15.9847043523211
"1960","knowing love",13.0967411348475,17,6,11,1.01529564767886,15.9847043523211
"1960","say youve",13.0967411348475,17,6,11,1.01529564767886,15.9847043523211
"1990","say know",13.0824724328425,53,23,30,11.2436688842652,41.7563311157348
"2000","got cause",13.0784723448976,36,20,16,9.68708473964864,26.3129152603514
"2000","sean",13.0784723448976,36,20,16,9.68708473964864,26.3129152603514
"1970","filled",13.0696070907196,78,23,55,10.6741355637616,67.3258644362384
"2000","one else can",13.0530014589942,41,22,19,11.032513175711,29.9674868242891
"1960","brown",13.0433144918462,138,20,118,8.2418117282166,129.758188271783
"2010","booth",13.0388451138261,20,10,10,3.07925447956913,16.9207455204309
"2010","can break",13.0388451138261,20,10,10,3.07925447956913,16.9207455204309
"2010","chew",13.0388451138261,20,10,10,3.07925447956913,16.9207455204309
"2010","crown",13.0388451138261,20,10,10,3.07925447956913,16.9207455204309
"2010","got hands",13.0388451138261,20,10,10,3.07925447956913,16.9207455204309
"2010","im without",13.0388451138261,20,10,10,3.07925447956913,16.9207455204309
"2010","makeup",13.0388451138261,20,10,10,3.07925447956913,16.9207455204309
"2010","pedal",13.0388451138261,20,10,10,3.07925447956913,16.9207455204309
"2010","real loud",13.0388451138261,20,10,10,3.07925447956913,16.9207455204309
"2010","regrets",13.0388451138261,20,10,10,3.07925447956913,16.9207455204309
"2010","tshirt",13.0388451138261,20,10,10,3.07925447956913,16.9207455204309
"2010","youre real",13.0388451138261,20,10,10,3.07925447956913,16.9207455204309
"1980","borderline",13.0370488224261,13,8,5,2.18706445936651,10.8129355406335
"1980","come life",13.0370488224261,13,8,5,2.18706445936651,10.8129355406335
"1980","cry love",13.0370488224261,13,8,5,2.18706445936651,10.8129355406335
"1980","eyes shes",13.0370488224261,13,8,5,2.18706445936651,10.8129355406335
"1980","fight feeling",13.0370488224261,13,8,5,2.18706445936651,10.8129355406335
"1980","find woman",13.0370488224261,13,8,5,2.18706445936651,10.8129355406335
"1980","got number",13.0370488224261,13,8,5,2.18706445936651,10.8129355406335
"1980","morning comes",13.0370488224261,13,8,5,2.18706445936651,10.8129355406335
"1980","need tell",13.0370488224261,13,8,5,2.18706445936651,10.8129355406335
"1980","shes dancing",13.0370488224261,13,8,5,2.18706445936651,10.8129355406335
"1980","stay let",13.0370488224261,13,8,5,2.18706445936651,10.8129355406335
"1980","love affair",13.0363551327345,35,15,20,5.88825046752523,29.1117495324748
"2000","jumpin",13.0239371341586,70,33,37,18.8359981048724,51.1640018951276
"1990","better days",13.0228976451025,29,15,14,6.15219618195642,22.8478038180436
"1990","takes time",13.0228976451025,29,15,14,6.15219618195642,22.8478038180436
"1990","love come",13.0190130124928,114,41,73,24.1844953359666,89.8155046640334
"1970","alone oh",13.0153985782594,12,7,5,1.64217470211718,10.3578252978828
"1970","dont say dont",13.0153985782594,12,7,5,1.64217470211718,10.3578252978828
"1970","duck",13.0153985782594,12,7,5,1.64217470211718,10.3578252978828
"1970","grow give",13.0153985782594,12,7,5,1.64217470211718,10.3578252978828
"1970","im back love",13.0153985782594,12,7,5,1.64217470211718,10.3578252978828
"1970","just needed",13.0153985782594,12,7,5,1.64217470211718,10.3578252978828
"1970","love special",13.0153985782594,12,7,5,1.64217470211718,10.3578252978828
"1970","much give",13.0153985782594,12,7,5,1.64217470211718,10.3578252978828
"1970","ooh make",13.0153985782594,12,7,5,1.64217470211718,10.3578252978828
"1970","right gotta",13.0153985782594,12,7,5,1.64217470211718,10.3578252978828
"1960","kind",13.0106404424619,554,55,499,33.0866934596522,520.913306540348
"2000","bed",13.0083301215377,350,125,225,94.1799905243618,255.820009475638
"2010","marvin",13.0073080744662,34,14,20,5.23473261526751,28.7652673847325
"1960","yes will",13.0031921520342,30,8,22,1.79169820178622,28.2083017982138
"1960","stop stop",12.9977859867326,45,10,35,2.68754730267933,42.3124526973207
"1980","never felt",12.9944678400663,77,26,51,12.9541510285555,64.0458489714445
"1970","frown",12.9932428365336,22,10,12,3.01065362054815,18.9893463794518
"1970","la da da da",12.9932428365336,22,10,12,3.01065362054815,18.9893463794518
"1970","one kind",12.9932428365336,22,10,12,3.01065362054815,18.9893463794518
"1970","waters",12.9932428365336,22,10,12,3.01065362054815,18.9893463794518
"1970","way hold",12.9932428365336,22,10,12,3.01065362054815,18.9893463794518
"2000","diamonds",12.991521713248,193,75,118,51.9335376320052,141.066462367995
"1990","youre around",12.9811216723009,50,22,28,10.6072347964766,39.3927652035234
"1970","sister",12.9544577336846,88,25,63,12.0426144821926,75.9573855178074
"2000","work hard",12.9540650993346,54,27,27,14.530627109473,39.469372890527
"2010","love way",12.9523772772092,248,60,188,38.1827555466572,209.817244453343
"1980","cant stop loving",12.9493523861151,25,12,13,4.20589319108945,20.7941068089106
"1980","ive made",12.9493523861151,25,12,13,4.20589319108945,20.7941068089106
"1980","oh tell",12.9493523861151,25,12,13,4.20589319108945,20.7941068089106
"1980","shattered",12.9493523861151,25,12,13,4.20589319108945,20.7941068089106
"1980","shining star",12.9493523861151,25,12,13,4.20589319108945,20.7941068089106
"1980","take just",12.9493523861151,25,12,13,4.20589319108945,20.7941068089106
"1970","got power",12.9446891658329,55,18,37,7.52663405137039,47.4733659486296
"1970","get",12.943311992556,8265,1245,7020,1131.0478260832,7133.9521739168
"2000","girl cant",12.9391804475291,62,30,32,16.6833126071727,45.3166873928273
"1980","gonna make",12.9373362442339,266,68,198,44.7507035531917,221.249296446808
"2000","say",12.9312658662819,4757,1391,3366,1280.04061406968,3476.95938593032
"2000","ask questions",12.9304581605316,22,14,8,5.91988511867417,16.0801148813258
"2000","find hard",12.9304581605316,22,14,8,5.91988511867417,16.0801148813258
"2000","like damn",12.9304581605316,22,14,8,5.91988511867417,16.0801148813258
"2000","time long",12.9304581605316,22,14,8,5.91988511867417,16.0801148813258
"1970","come take",12.9192483648968,98,27,71,13.4110934006236,84.5889065993764
"2010","sunlight",12.9118003688321,62,21,41,9.54568888666429,52.4543111133357
"1970","today",12.8895856844326,377,77,300,51.5916552248479,325.408344775152
"1990","holding hands",12.884261705547,32,16,16,6.78863026974501,25.211369730255
"1990","puts",12.884261705547,32,16,16,6.78863026974501,25.211369730255
"2000","sweat",12.8840278706713,139,57,82,37.4029105225323,101.597089477468
"1970","dreams come true",12.8658811255768,42,15,27,5.74761145741011,36.2523885425899
"1970","please please",12.8658811255768,42,15,27,5.74761145741011,36.2523885425899
"1990","babyi",12.8639003029537,63,26,37,13.3651158435605,49.6348841564395
"1980","can feel",12.8500767375897,300,75,225,50.4707182930734,249.529281706927
"2000","let get",12.8491897060942,104,45,59,27.9849114700961,76.0150885299039
"1990","say love",12.846547940231,184,60,124,39.0346240510338,144.965375948966
"2010","bitch got",12.8457287459087,17,9,8,2.61736630763376,14.3826336923662
"2010","day one",12.8457287459087,17,9,8,2.61736630763376,14.3826336923662
"2010","girls around",12.8457287459087,17,9,8,2.61736630763376,14.3826336923662
"2010","headlights",12.8457287459087,17,9,8,2.61736630763376,14.3826336923662
"2010","im hanging",12.8457287459087,17,9,8,2.61736630763376,14.3826336923662
"2010","leg",12.8457287459087,17,9,8,2.61736630763376,14.3826336923662
"2010","life wont",12.8457287459087,17,9,8,2.61736630763376,14.3826336923662
"2010","like nothing",12.8457287459087,17,9,8,2.61736630763376,14.3826336923662
"2010","name like",12.8457287459087,17,9,8,2.61736630763376,14.3826336923662
"2010","one understands",12.8457287459087,17,9,8,2.61736630763376,14.3826336923662
"2010","theres life",12.8457287459087,17,9,8,2.61736630763376,14.3826336923662
"1970","grow",12.8455794726547,210,48,162,28.7380572870506,181.261942712949
"2000","getting",12.8406258386309,609,204,405,163.87318351239,445.12681648761
"2010","em like",12.8398600726242,38,15,23,5.85058351118134,32.1494164888187
"2010","mas",12.8398600726242,38,15,23,5.85058351118134,32.1494164888187
"2010","see sun",12.8398600726242,38,15,23,5.85058351118134,32.1494164888187
"2010","treasure",12.8398600726242,38,15,23,5.85058351118134,32.1494164888187
"1990","say cant",12.831815232874,44,20,24,9.33436662089939,34.6656333791006
"2010","girl know",12.8270145969713,188,48,140,28.9449921079498,159.05500789205
"1990","dick",12.826751458593,158,53,105,33.518861956866,124.481138043134
"2010","say hey baby",12.8249048203457,27,12,15,4.15699354741832,22.8430064525817
"2010","air youre",12.8215915019443,14,8,6,2.15547813569839,11.8445218643016
"2010","baby even",12.8215915019443,14,8,6,2.15547813569839,11.8445218643016
"2010","back bring back",12.8215915019443,14,8,6,2.15547813569839,11.8445218643016
"2010","big old",12.8215915019443,14,8,6,2.15547813569839,11.8445218643016
"2010","cross heart",12.8215915019443,14,8,6,2.15547813569839,11.8445218643016
"2010","cross heart hope",12.8215915019443,14,8,6,2.15547813569839,11.8445218643016
"2010","feel close",12.8215915019443,14,8,6,2.15547813569839,11.8445218643016
"2010","fun dont",12.8215915019443,14,8,6,2.15547813569839,11.8445218643016
"2010","good come",12.8215915019443,14,8,6,2.15547813569839,11.8445218643016
"2010","hear heart",12.8215915019443,14,8,6,2.15547813569839,11.8445218643016
"2010","hey lets",12.8215915019443,14,8,6,2.15547813569839,11.8445218643016
"2010","im going make",12.8215915019443,14,8,6,2.15547813569839,11.8445218643016
"2010","mean youre",12.8215915019443,14,8,6,2.15547813569839,11.8445218643016
"2010","million times",12.8215915019443,14,8,6,2.15547813569839,11.8445218643016
"2010","never never never never",12.8215915019443,14,8,6,2.15547813569839,11.8445218643016
"2010","pull back",12.8215915019443,14,8,6,2.15547813569839,11.8445218643016
"2010","ready come",12.8215915019443,14,8,6,2.15547813569839,11.8445218643016
"2010","sky now",12.8215915019443,14,8,6,2.15547813569839,11.8445218643016
"1990","bloom",12.82147556705,21,12,9,4.45503861452016,16.5449613854798
"1990","mind money",12.82147556705,21,12,9,4.45503861452016,16.5449613854798
"1990","try hard",12.82147556705,21,12,9,4.45503861452016,16.5449613854798
"1990","will give",12.82147556705,21,12,9,4.45503861452016,16.5449613854798
"2000","inch",12.8195361896568,29,17,12,7.80348492916141,21.1965150708386
"2000","run can",12.8195361896568,29,17,12,7.80348492916141,21.1965150708386
"2000","running back",12.8195361896568,29,17,12,7.80348492916141,21.1965150708386
"2000","said got",12.8195361896568,29,17,12,7.80348492916141,21.1965150708386
"2000","seconds",12.8195361896568,29,17,12,7.80348492916141,21.1965150708386
"1960","golden",12.8161770022099,99,16,83,5.91260406589452,93.0873959341055
"1960","baby aint",12.8118034758843,71,13,58,4.24035241089405,66.759647589106
"1990","around love",12.808690678657,35,17,18,7.42506435753361,27.5749356424664
"1990","day dont",12.808690678657,35,17,18,7.42506435753361,27.5749356424664
"1990","get little bit",12.808690678657,35,17,18,7.42506435753361,27.5749356424664
"1990","know need know",12.808690678657,35,17,18,7.42506435753361,27.5749356424664
"1970","thank",12.7833897063397,244,54,190,33.3908856097159,210.609114390284
"1990","used love",12.781280827318,38,18,20,8.0614984453222,29.9385015546778
"2000","chose",12.7742905723268,49,25,24,13.1851986734107,35.8148013265894
"2000","make smile",12.7742905723268,49,25,24,13.1851986734107,35.8148013265894
"1980","decisions",12.7666216921242,22,11,11,3.70118600815871,18.2988139918413
"1980","ever known",12.7666216921242,22,11,11,3.70118600815871,18.2988139918413
"1980","get real",12.7666216921242,22,11,11,3.70118600815871,18.2988139918413
"1980","u s",12.7666216921242,22,11,11,3.70118600815871,18.2988139918413
"1980","venus",12.7666216921242,22,11,11,3.70118600815871,18.2988139918413
"1980","way ooh",12.7666216921242,22,11,11,3.70118600815871,18.2988139918413
"2010","marry",12.7558994058405,54,19,35,8.31398709483664,45.6860129051634
"2010","pool",12.7470200680535,42,16,26,6.46643440709516,35.5335655929048
"1980","youre around",12.7451594495631,50,19,31,8.4117863821789,41.5882136178211
"1970","dance can",12.7445879739346,26,11,15,3.55804518792055,22.4419548120795
"1980","africa",12.7318367962124,16,9,7,2.69177164229725,13.3082283577028
"1980","around round",12.7318367962124,16,9,7,2.69177164229725,13.3082283577028
"1980","away much",12.7318367962124,16,9,7,2.69177164229725,13.3082283577028
"1980","better ever",12.7318367962124,16,9,7,2.69177164229725,13.3082283577028
"1980","gotta run",12.7318367962124,16,9,7,2.69177164229725,13.3082283577028
"1980","one hundred",12.7318367962124,16,9,7,2.69177164229725,13.3082283577028
"1970","ahh",12.7253592164574,60,19,41,8.21087351058588,51.7891264894141
"1970","winter",12.7253592164574,60,19,41,8.21087351058588,51.7891264894141
"2010","come now",12.7237400264656,93,28,65,14.3185333299964,78.6814666700036
"1970","round",12.7206889704787,727,134,593,99.4884173699322,627.511582630068
"2010","girl got",12.7160707737842,50,18,32,7.69813619892281,42.3018638010772
"1980","just one",12.7150458167062,215,57,158,36.1706814433693,178.829318556631
"1990","babys",12.712001657155,60,25,35,12.7286817557719,47.2713182442281
"2010","blown",12.7100529442405,46,17,29,7.08228530300899,38.917714696991
"1980","againi",12.7077026215207,39,16,23,6.56119337809954,32.4388066219005
"1980","wanna just",12.7077026215207,39,16,23,6.56119337809954,32.4388066219005
"1990","curse",12.7010005252188,16,10,6,3.39431513487251,12.6056848651275
"1990","go want know",12.7010005252188,16,10,6,3.39431513487251,12.6056848651275
"1990","hardest thing",12.7010005252188,16,10,6,3.39431513487251,12.6056848651275
"1990","itif",12.7010005252188,16,10,6,3.39431513487251,12.6056848651275
"1990","like trying",12.7010005252188,16,10,6,3.39431513487251,12.6056848651275
"1990","love body",12.7010005252188,16,10,6,3.39431513487251,12.6056848651275
"1990","made sweet",12.7010005252188,16,10,6,3.39431513487251,12.6056848651275
"1990","make thing",12.7010005252188,16,10,6,3.39431513487251,12.6056848651275
"1990","never without",12.7010005252188,16,10,6,3.39431513487251,12.6056848651275
"1990","philly",12.7010005252188,16,10,6,3.39431513487251,12.6056848651275
"1990","stop get get",12.7010005252188,16,10,6,3.39431513487251,12.6056848651275
"1990","wanna can",12.7010005252188,16,10,6,3.39431513487251,12.6056848651275
"1990","way show",12.7010005252188,16,10,6,3.39431513487251,12.6056848651275
"1960","laughed",12.6929566186177,38,9,29,2.26948438892921,35.7305156110708
"1960","love little",12.6929566186177,38,9,29,2.26948438892921,35.7305156110708
"1960","pretty baby",12.6929566186177,38,9,29,2.26948438892921,35.7305156110708
"1960","time wont",12.6929566186177,38,9,29,2.26948438892921,35.7305156110708
"2000","cute",12.6920137773449,57,28,29,15.3378841711103,41.6621158288897
"1980","will keep",12.6782100922229,32,14,18,5.38354328459449,26.6164567154055
"1960","color",12.6771458235108,90,15,75,5.37509460535865,84.6249053946413
"1980","davis",12.6765575765186,19,10,9,3.19647882522798,15.803521174772
"1980","dreamer",12.6765575765186,19,10,9,3.19647882522798,15.803521174772
"1980","friend ill",12.6765575765186,19,10,9,3.19647882522798,15.803521174772
"1980","gone now",12.6765575765186,19,10,9,3.19647882522798,15.803521174772
"1980","hearti",12.6765575765186,19,10,9,3.19647882522798,15.803521174772
"1980","huh oh",12.6765575765186,19,10,9,3.19647882522798,15.803521174772
"1980","kinda girl",12.6765575765186,19,10,9,3.19647882522798,15.803521174772
"1980","mine mine mine",12.6765575765186,19,10,9,3.19647882522798,15.803521174772
"1980","much really",12.6765575765186,19,10,9,3.19647882522798,15.803521174772
"1970","get good",12.6580290947352,34,13,21,4.65282832266533,29.3471716773347
"1970","major",12.6580290947352,34,13,21,4.65282832266533,29.3471716773347
"1970","love come",12.6525442990198,114,30,84,15.6006596701132,98.3993403298868
"1970","home oh",12.6504624827804,30,12,18,4.10543675529294,25.8945632447071
"1980","steady",12.6488185646316,86,28,58,14.4682725773477,71.5317274226523
"1960","never gonna",12.6487299094015,239,29,210,14.2738623408969,224.726137659103
"2000","like thats",12.6250085162929,34,19,15,9.14891336522372,24.8510866347763
"2000","really like",12.6250085162929,34,19,15,9.14891336522372,24.8510866347763
"2000","time try",12.6250085162929,34,19,15,9.14891336522372,24.8510866347763
"2000","wasting time",12.6250085162929,34,19,15,9.14891336522372,24.8510866347763
"2000","wrist",12.6250085162929,34,19,15,9.14891336522372,24.8510866347763
"1960","loneliness",12.624562967715,46,10,36,2.7472705760722,43.2527294239278
"2000","dont want one",12.6214217397036,20,13,7,5.38171374424925,14.6182862557508
"2000","leading",12.6214217397036,20,13,7,5.38171374424925,14.6182862557508
"2000","move slow",12.6214217397036,20,13,7,5.38171374424925,14.6182862557508
"2000","now keep",12.6214217397036,20,13,7,5.38171374424925,14.6182862557508
"2000","say time",12.6214217397036,20,13,7,5.38171374424925,14.6182862557508
"2000","show everything",12.6214217397036,20,13,7,5.38171374424925,14.6182862557508
"2000","stop stare",12.6214217397036,20,13,7,5.38171374424925,14.6182862557508
"1970","comin",12.6169746227223,355,73,282,48.5810016042998,306.4189983957
"1970","whoa whoa",12.6145072955124,167,40,127,22.8535979377974,144.146402062203
"1960","go now",12.5887135567513,100,16,84,5.97232733928739,94.0276726607126
"1970","long long",12.5881681323645,104,28,76,14.2321807516822,89.7678192483178
"1970","count",12.5864965689074,178,42,136,24.3589247480714,153.641075251929
"1970","boat",12.5848511108796,89,25,64,12.1794623740357,76.8205376259643
"1970","can say",12.5806642748786,189,44,145,25.8642515583455,163.135748441654
"2000","really really",12.5775202622493,79,36,43,21.2577692897845,57.7422307102155
"1970","cake",12.5710331076206,94,26,68,12.8637018332512,81.1362981667488
"1990","thats love",12.5686952171293,57,24,33,12.0922476679833,44.9077523320167
"1980","go can",12.558081829549,58,21,37,9.75767220332752,48.2423277966725
"1980","likes",12.558081829549,58,21,37,9.75767220332752,48.2423277966725
"1980","right can",12.558081829549,58,21,37,9.75767220332752,48.2423277966725
"1990","keeping",12.5544512301927,94,35,59,19.941601417376,74.058398582624
"2010","youre good",12.5499176757465,67,22,45,10.3155025065566,56.6844974934434
"1980","suddenly",12.5454704461448,78,26,52,13.1223867561991,64.8776132438009
"2010","baby youre",12.5402762458018,145,39,106,22.3245949768762,122.675405023124
"2000","lose",12.527931927716,684,226,458,184.054610053324,499.945389946676
"1960","girl get",12.5178564727289,31,8,23,1.85142147517909,29.1485785248209
"1980","call call",12.5131791776184,62,22,40,10.4306151139018,51.5693848860982
"1980","feel right",12.5122118507182,74,25,49,12.4494438456248,61.5505561543752
"2010","im young",12.500930525828,31,13,18,4.77284444333215,26.2271555566679
"1980","moon",12.4983782456579,268,68,200,45.0871750084789,222.912824991521
"1980","read",12.4950028231567,188,51,137,31.6283167969926,156.371683203007
"1980","make cry",12.4939081200201,70,24,46,11.7765009350505,58.2234990649496
"1980","always love",12.4931520946797,66,23,43,11.1035580244761,54.8964419755239
"1980","arms",12.4833768105928,556,126,430,93.5390645698293,462.460935430171
"1960","lord",12.4762599207865,359,39,320,21.4406551480417,337.559344851958
"2000","like dont",12.4706673398784,99,43,56,26.6394830340338,72.3605169659662
"1980","lost without",12.4670172140529,43,17,26,7.23413628867385,35.7658637113261
"2000","naked",12.4615519537471,60,29,31,16.1451412327477,43.8548587672523
"1970","captain",12.4562844828467,19,9,10,2.60010994501886,16.3998900549811
"1970","changin",12.4562844828467,19,9,10,2.60010994501886,16.3998900549811
"1970","come back baby",12.4562844828467,19,9,10,2.60010994501886,16.3998900549811
"1970","elses",12.4562844828467,19,9,10,2.60010994501886,16.3998900549811
"1970","like eagle",12.4562844828467,19,9,10,2.60010994501886,16.3998900549811
"1970","love answer",12.4562844828467,19,9,10,2.60010994501886,16.3998900549811
"1970","mend broken",12.4562844828467,19,9,10,2.60010994501886,16.3998900549811
"1970","thing yeah",12.4562844828467,19,9,10,2.60010994501886,16.3998900549811
"1990","click",12.4541481426916,24,13,11,5.09147270230876,18.9085272976912
"2000","cause got",12.4453813992413,149,60,89,40.0937673946569,108.906232605343
"1960","love baby",12.4437777659915,421,44,377,25.1434980983999,395.8565019016
"1970","believing",12.4342842844689,70,21,49,9.57935242901686,60.4206475709831
"1970","love song",12.4342842844689,70,21,49,9.57935242901686,60.4206475709831
"1970","long",12.4311166451137,1918,317,1601,262.474256555062,1655.52574344494
"2010","yeah im",12.4152367930374,160,42,118,24.634035836553,135.365964163447
"2000","fingers",12.4067084543923,102,44,58,27.4467400956712,74.5532599043289
"2010","back life",12.4057684441306,24,11,13,3.69510537548295,20.3048946245171
"2010","got nothin",12.4057684441306,24,11,13,3.69510537548295,20.3048946245171
"2010","husband",12.4057684441306,24,11,13,3.69510537548295,20.3048946245171
"1990","close",12.4051171118925,764,203,561,162.078547690162,601.921452309838
"2000","aint goin",12.4046564739482,27,16,11,7.26531355473648,19.7346864452635
"2000","alabama",12.4046564739482,27,16,11,7.26531355473648,19.7346864452635
"2000","always together",12.4046564739482,27,16,11,7.26531355473648,19.7346864452635
"2000","fifteen",12.4046564739482,27,16,11,7.26531355473648,19.7346864452635
"2000","hurtin",12.4046564739482,27,16,11,7.26531355473648,19.7346864452635
"2000","im alright",12.4046564739482,27,16,11,7.26531355473648,19.7346864452635
"2000","lookin like",12.4046564739482,27,16,11,7.26531355473648,19.7346864452635
"2000","try hide",12.4046564739482,27,16,11,7.26531355473648,19.7346864452635
"2000","want night",12.4046564739482,27,16,11,7.26531355473648,19.7346864452635
"2000","yup",12.4046564739482,27,16,11,7.26531355473648,19.7346864452635
"1980","midnight",12.3988834287793,134,39,95,22.5435875042394,111.456412495761
"1980","givin",12.3958434573081,193,52,141,32.4694954352105,160.530504564789
"2000","thought",12.3831063822657,799,260,539,214.999464082757,584.000535917243
"1960","can cause",12.3798372559143,18,6,12,1.07501892107173,16.9249810789283
"1960","candy girl",12.3798372559143,18,6,12,1.07501892107173,16.9249810789283
"1960","capture",12.3798372559143,18,6,12,1.07501892107173,16.9249810789283
"1960","free dont",12.3798372559143,18,6,12,1.07501892107173,16.9249810789283
"1960","get dance",12.3798372559143,18,6,12,1.07501892107173,16.9249810789283
"1960","know please",12.3798372559143,18,6,12,1.07501892107173,16.9249810789283
"1960","much long",12.3798372559143,18,6,12,1.07501892107173,16.9249810789283
"1960","oh dont know",12.3798372559143,18,6,12,1.07501892107173,16.9249810789283
"1960","pickin",12.3798372559143,18,6,12,1.07501892107173,16.9249810789283
"1960","roll let",12.3798372559143,18,6,12,1.07501892107173,16.9249810789283
"1960","sally",12.3798372559143,18,6,12,1.07501892107173,16.9249810789283
"2000","face dont",12.3524083313716,18,12,6,4.84354236982432,13.1564576301757
"2000","hard gotta",12.3524083313716,18,12,6,4.84354236982432,13.1564576301757
"2000","havent seen",12.3524083313716,18,12,6,4.84354236982432,13.1564576301757
"2000","love girl love",12.3524083313716,18,12,6,4.84354236982432,13.1564576301757
"2000","ounce",12.3524083313716,18,12,6,4.84354236982432,13.1564576301757
"1960","child",12.3452203183141,288,33,255,17.2003027371477,270.799697262852
"1980","cant come",12.3450805205223,29,13,16,4.87883610166376,24.1211638983362
"1980","thered",12.3450805205223,29,13,16,4.87883610166376,24.1211638983362
"1960","week",12.3433456419976,111,17,94,6.62928334660901,104.370716653391
"1980","yeah yeah",12.3417514464723,1719,345,1374,289.19721581931,1429.80278418069
"1990","doo doo",12.3261075067005,98,36,62,20.7901802010941,77.2098197989059
"2000","hang",12.3171278923272,198,76,122,53.2789660680675,144.721033931932
"2000","somewhere",12.3146790980445,229,86,143,61.6206223716539,167.379377628346
"1990","take place",12.3137949071609,51,22,29,10.8193794924061,40.1806205075939
"2000","look like",12.2989865232445,108,46,62,29.0612542189459,78.9387457810541
"2000","pop pop",12.2953790046495,47,24,23,12.6470272989857,34.3529727010143
"1980","theres much",12.2926358648545,47,18,29,7.90707919924816,39.0929208007518
"1970","way walk",12.2895096139577,43,15,28,5.88445934925321,37.1155406507468
"1970","yeah well",12.2895096139577,43,15,28,5.88445934925321,37.1155406507468
"1970","gotta keep",12.2817740573351,80,23,57,10.9478313474478,69.0521686525522
"1970","take chance",12.2817740573351,80,23,57,10.9478313474478,69.0521686525522
"1970","love get",12.2657624166618,61,19,42,8.34772140242897,52.652278597571
"1970","named",12.2657624166618,61,19,42,8.34772140242897,52.652278597571
"1960","says",12.2639311897544,361,39,322,21.5601016948275,339.439898305173
"2010","last",12.2514281285735,827,165,662,127.327172730183,699.672827269817
"2000","altar",12.249394274805,10,8,2,2.69085687212462,7.30914312787538
"2000","anywhere go im",12.249394274805,10,8,2,2.69085687212462,7.30914312787538
"2000","believe come",12.249394274805,10,8,2,2.69085687212462,7.30914312787538
"2000","cant help feel",12.249394274805,10,8,2,2.69085687212462,7.30914312787538
"2000","cause im getting",12.249394274805,10,8,2,2.69085687212462,7.30914312787538
"2000","chandon",12.249394274805,10,8,2,2.69085687212462,7.30914312787538
"2000","dance see",12.249394274805,10,8,2,2.69085687212462,7.30914312787538
"2000","every time kiss",12.249394274805,10,8,2,2.69085687212462,7.30914312787538
"2000","get thinking",12.249394274805,10,8,2,2.69085687212462,7.30914312787538
"2000","gets weak",12.249394274805,10,8,2,2.69085687212462,7.30914312787538
"2000","goes must",12.249394274805,10,8,2,2.69085687212462,7.30914312787538
"2000","goes must come",12.249394274805,10,8,2,2.69085687212462,7.30914312787538
"2000","gotta roll",12.249394274805,10,8,2,2.69085687212462,7.30914312787538
"2000","hold never let",12.249394274805,10,8,2,2.69085687212462,7.30914312787538
"2000","im going crazy",12.249394274805,10,8,2,2.69085687212462,7.30914312787538
"2000","just line",12.249394274805,10,8,2,2.69085687212462,7.30914312787538
"2000","know hope",12.249394274805,10,8,2,2.69085687212462,7.30914312787538
"2000","know think im",12.249394274805,10,8,2,2.69085687212462,7.30914312787538
"2000","lead right",12.249394274805,10,8,2,2.69085687212462,7.30914312787538
"2000","lightand",12.249394274805,10,8,2,2.69085687212462,7.30914312787538
"2000","like let",12.249394274805,10,8,2,2.69085687212462,7.30914312787538
"2000","mine time",12.249394274805,10,8,2,2.69085687212462,7.30914312787538
"2000","moreno",12.249394274805,10,8,2,2.69085687212462,7.30914312787538
"2000","need know im",12.249394274805,10,8,2,2.69085687212462,7.30914312787538
"2000","night gotta",12.249394274805,10,8,2,2.69085687212462,7.30914312787538
"2000","night long oh",12.249394274805,10,8,2,2.69085687212462,7.30914312787538
"2000","now throw",12.249394274805,10,8,2,2.69085687212462,7.30914312787538
"2000","open mouth",12.249394274805,10,8,2,2.69085687212462,7.30914312787538
"2000","pac",12.249394274805,10,8,2,2.69085687212462,7.30914312787538
"2000","partying",12.249394274805,10,8,2,2.69085687212462,7.30914312787538
"2000","pourin rain",12.249394274805,10,8,2,2.69085687212462,7.30914312787538
"2000","shorty dont",12.249394274805,10,8,2,2.69085687212462,7.30914312787538
"2000","slippers",12.249394274805,10,8,2,2.69085687212462,7.30914312787538
"2000","summer long",12.249394274805,10,8,2,2.69085687212462,7.30914312787538
"2000","throwed",12.249394274805,10,8,2,2.69085687212462,7.30914312787538
"2000","try leave",12.249394274805,10,8,2,2.69085687212462,7.30914312787538
"2000","wanna ill",12.249394274805,10,8,2,2.69085687212462,7.30914312787538
"2000","wants see",12.249394274805,10,8,2,2.69085687212462,7.30914312787538
"2000","whoa love",12.249394274805,10,8,2,2.69085687212462,7.30914312787538
"2000","woman knows",12.249394274805,10,8,2,2.69085687212462,7.30914312787538
"2000","wonder take",12.249394274805,10,8,2,2.69085687212462,7.30914312787538
"2000","ya go",12.249394274805,10,8,2,2.69085687212462,7.30914312787538
"2000","years now well",12.249394274805,10,8,2,2.69085687212462,7.30914312787538
"1970","jack",12.2240233767942,90,25,65,12.3163102658788,77.6836897341212
"1990","put put",12.2060827201617,48,21,27,10.1829454046175,37.8170545953825
"1990","something like",12.2060827201617,48,21,27,10.1829454046175,37.8170545953825
"2010","baby ill",12.1963776071002,127,35,92,19.5532659452639,107.446734054736
"2010","oh well",12.1868334553884,39,15,24,6.0045462351598,32.9954537648402
"2010","ooh whoa ooh",12.1868334553884,39,15,24,6.0045462351598,32.9954537648402
"2010","even know",12.1862179006696,99,29,70,15.2423096738672,83.7576903261328
"1990","know feel",12.1830031578192,81,31,50,17.1837203702921,63.8162796297079
"2000","waiting",12.1802918524343,686,226,460,184.592781427749,501.407218572251
"2000","eh eh",12.1802567405487,117,49,68,31.4830254038581,85.5169745961419
"2000","cause like",12.1748587720035,32,18,14,8.61074199079879,23.3892580092012
"1980","got nothing",12.1695489652002,51,19,32,8.58002210982247,42.4199778901775
"2010","bodies",12.1689417740336,51,18,33,7.85209892290127,43.1479010770987
"1960","days",12.1587887049358,682,64,618,40.73127245394,641.26872754606
"2000","blastin",12.139785493113,16,11,5,4.3053709953994,11.6946290046006
"2000","cmon get",12.139785493113,16,11,5,4.3053709953994,11.6946290046006
"2000","fast lane",12.139785493113,16,11,5,4.3053709953994,11.6946290046006
"2000","like touch",12.139785493113,16,11,5,4.3053709953994,11.6946290046006
"2000","limousine",12.139785493113,16,11,5,4.3053709953994,11.6946290046006
"2000","runnin game",12.139785493113,16,11,5,4.3053709953994,11.6946290046006
"2000","stop music",12.139785493113,16,11,5,4.3053709953994,11.6946290046006
"2000","take picture",12.139785493113,16,11,5,4.3053709953994,11.6946290046006
"2000","thought told",12.139785493113,16,11,5,4.3053709953994,11.6946290046006
"2000","tool",12.139785493113,16,11,5,4.3053709953994,11.6946290046006
"2000","tore",12.139785493113,16,11,5,4.3053709953994,11.6946290046006
"2000","yall niggas",12.139785493113,16,11,5,4.3053709953994,11.6946290046006
"2000","youre wondering",12.139785493113,16,11,5,4.3053709953994,11.6946290046006
"2010","oh god",12.1366125590376,43,16,27,6.62039713107362,36.3796028689264
"2010","remember remember",12.1366125590376,43,16,27,6.62039713107362,36.3796028689264
"1960","true love",12.1356556146461,112,17,95,6.68900662000188,105.310993379998
"2010","yeah cause",12.1342553387164,47,17,30,7.23624802698745,39.7637519730126
"2010","know know know",12.1245682409174,132,36,96,20.3230795651562,111.676920434844
"1970","love baby love",12.1244034569076,66,20,46,9.03196086164446,56.9680391383555
"1970","silver",12.1244034569076,66,20,46,9.03196086164446,56.9680391383555
"1970","can feel can",12.1116292472932,23,10,13,3.14750151239125,19.8524984876087
"2000","feels like",12.1023821704312,168,66,102,45.2063954516937,122.793604548306
"1990","test",12.0992870948516,71,28,43,15.0622734109967,55.9377265890033
"2010","like yeah",12.0954488855642,68,22,46,10.469465230535,57.530534769465
"1980","colors",12.0870048998727,55,20,35,9.25296502039679,45.7470349796032
"1990","easily",12.0789953489503,30,15,15,6.36434087788595,23.6356591221141
"1990","way thats",12.0789953489503,30,15,15,6.36434087788595,23.6356591221141
"1990","will hold",12.0789953489503,30,15,15,6.36434087788595,23.6356591221141
"2000","two",12.0751156712237,967,309,658,260.205859534451,706.794140465549
"2000","hey hey hey hey",12.065830368627,159,63,96,42.7846242667815,116.215375733218
"1980","change",12.0642308887786,823,177,646,138.458003850665,684.541996149335
"1990","away ill",12.0618403457501,19,11,8,4.0307492226611,14.9692507773389
"1990","baby always",12.0618403457501,19,11,8,4.0307492226611,14.9692507773389
"1990","cause youll",12.0618403457501,19,11,8,4.0307492226611,14.9692507773389
"1990","friends can",12.0618403457501,19,11,8,4.0307492226611,14.9692507773389
"1990","home ill",12.0618403457501,19,11,8,4.0307492226611,14.9692507773389
"1990","monica",12.0618403457501,19,11,8,4.0307492226611,14.9692507773389
"1990","positive",12.0618403457501,19,11,8,4.0307492226611,14.9692507773389
"1990","stop cant stop",12.0618403457501,19,11,8,4.0307492226611,14.9692507773389
"1990","want cry",12.0618403457501,19,11,8,4.0307492226611,14.9692507773389
"1960","trap",12.0549774096555,32,8,24,1.91114474857197,30.088855251428
"1980","around town",12.0454579972356,26,12,14,4.37412891873303,21.625871081267
"1980","crazy love",12.0454579972356,26,12,14,4.37412891873303,21.625871081267
"1980","love everything",12.0454579972356,26,12,14,4.37412891873303,21.625871081267
"1980","sweet baby",12.0454579972356,26,12,14,4.37412891873303,21.625871081267
"1990","alley",12.0439853546034,14,9,5,2.97002574301344,11.0299742569866
"1990","bet can",12.0439853546034,14,9,5,2.97002574301344,11.0299742569866
"1990","bills pay",12.0439853546034,14,9,5,2.97002574301344,11.0299742569866
"1990","body yeah",12.0439853546034,14,9,5,2.97002574301344,11.0299742569866
"1990","can lean",12.0439853546034,14,9,5,2.97002574301344,11.0299742569866
"1990","keep faith",12.0439853546034,14,9,5,2.97002574301344,11.0299742569866
"1990","love back",12.0439853546034,14,9,5,2.97002574301344,11.0299742569866
"1990","make ends",12.0439853546034,14,9,5,2.97002574301344,11.0299742569866
"1990","mei got",12.0439853546034,14,9,5,2.97002574301344,11.0299742569866
"1990","power oh",12.0439853546034,14,9,5,2.97002574301344,11.0299742569866
"1990","tell shes",12.0439853546034,14,9,5,2.97002574301344,11.0299742569866
"1990","thank lord",12.0439853546034,14,9,5,2.97002574301344,11.0299742569866
"1990","understand love",12.0439853546034,14,9,5,2.97002574301344,11.0299742569866
"1980","take long",12.037417024079,40,16,24,6.72942910574312,33.2705708942569
"1980","want let",12.037417024079,40,16,24,6.72942910574312,33.2705708942569
"2010","dont know cause",12.034571530996,21,10,11,3.23321720354758,17.7667827964524
"2010","goose",12.034571530996,21,10,11,3.23321720354758,17.7667827964524
"2010","holes",12.034571530996,21,10,11,3.23321720354758,17.7667827964524
"2010","oh oh dont",12.034571530996,21,10,11,3.23321720354758,17.7667827964524
"2010","told dont",12.034571530996,21,10,11,3.23321720354758,17.7667827964524
"1960","denied",12.0217211175197,25,7,18,1.49308183482185,23.5069181651781
"2000","around got",12.0137681858214,12,9,3,3.22902824654955,8.77097175345045
"2000","career",12.0137681858214,12,9,3,3.22902824654955,8.77097175345045
"2000","caviar",12.0137681858214,12,9,3,3.22902824654955,8.77097175345045
"2000","complicated",12.0137681858214,12,9,3,3.22902824654955,8.77097175345045
"2000","crazy will",12.0137681858214,12,9,3,3.22902824654955,8.77097175345045
"2000","dessert",12.0137681858214,12,9,3,3.22902824654955,8.77097175345045
"2000","gets low",12.0137681858214,12,9,3,3.22902824654955,8.77097175345045
"2000","girl bad",12.0137681858214,12,9,3,3.22902824654955,8.77097175345045
"2000","gonna lie",12.0137681858214,12,9,3,3.22902824654955,8.77097175345045
"2000","got crazy",12.0137681858214,12,9,3,3.22902824654955,8.77097175345045
"2000","japan",12.0137681858214,12,9,3,3.22902824654955,8.77097175345045
"2000","keep side",12.0137681858214,12,9,3,3.22902824654955,8.77097175345045
"2000","kiss make",12.0137681858214,12,9,3,3.22902824654955,8.77097175345045
"2000","name girl",12.0137681858214,12,9,3,3.22902824654955,8.77097175345045
"2000","need two",12.0137681858214,12,9,3,3.22902824654955,8.77097175345045
"2000","right now know",12.0137681858214,12,9,3,3.22902824654955,8.77097175345045
"2000","similar",12.0137681858214,12,9,3,3.22902824654955,8.77097175345045
"2000","thing keeps",12.0137681858214,12,9,3,3.22902824654955,8.77097175345045
"2000","time say goodbye",12.0137681858214,12,9,3,3.22902824654955,8.77097175345045
"2000","tres",12.0137681858214,12,9,3,3.22902824654955,8.77097175345045
"2000","way seems",12.0137681858214,12,9,3,3.22902824654955,8.77097175345045
"2000","youll probably",12.0137681858214,12,9,3,3.22902824654955,8.77097175345045
"2010","already gone",12.0123598110855,28,12,16,4.31095627139678,23.6890437286032
"2010","fox",12.0123598110855,28,12,16,4.31095627139678,23.6890437286032
"2010","really got",12.0123598110855,28,12,16,4.31095627139678,23.6890437286032
"2000","aint know",12.0106320873896,14,10,4,3.76719962097447,10.2328003790255
"2000","better put",12.0106320873896,14,10,4,3.76719962097447,10.2328003790255
"2000","broads",12.0106320873896,14,10,4,3.76719962097447,10.2328003790255
"2000","feel got",12.0106320873896,14,10,4,3.76719962097447,10.2328003790255
"2000","get yo",12.0106320873896,14,10,4,3.76719962097447,10.2328003790255
"2000","good wanna",12.0106320873896,14,10,4,3.76719962097447,10.2328003790255
"2000","got ass",12.0106320873896,14,10,4,3.76719962097447,10.2328003790255
"2000","help oh",12.0106320873896,14,10,4,3.76719962097447,10.2328003790255
"2000","holding hand",12.0106320873896,14,10,4,3.76719962097447,10.2328003790255
"2000","im callin",12.0106320873896,14,10,4,3.76719962097447,10.2328003790255
"2000","im fed",12.0106320873896,14,10,4,3.76719962097447,10.2328003790255
"2000","kick like",12.0106320873896,14,10,4,3.76719962097447,10.2328003790255
"2000","lonely baby",12.0106320873896,14,10,4,3.76719962097447,10.2328003790255
"2000","now cause im",12.0106320873896,14,10,4,3.76719962097447,10.2328003790255
"2000","party started",12.0106320873896,14,10,4,3.76719962097447,10.2328003790255
"2000","secret place",12.0106320873896,14,10,4,3.76719962097447,10.2328003790255
"2000","someone call",12.0106320873896,14,10,4,3.76719962097447,10.2328003790255
"2000","tonight cant",12.0106320873896,14,10,4,3.76719962097447,10.2328003790255
"1980","climb mountain",12.006498605126,11,7,4,1.85059300407936,9.14940699592064
"1980","dreams never",12.006498605126,11,7,4,1.85059300407936,9.14940699592064
"1980","everythings alright",12.006498605126,11,7,4,1.85059300407936,9.14940699592064
"1980","feel get",12.006498605126,11,7,4,1.85059300407936,9.14940699592064
"1980","girls need",12.006498605126,11,7,4,1.85059300407936,9.14940699592064
"1980","holding ill",12.006498605126,11,7,4,1.85059300407936,9.14940699592064
"1980","honey dont",12.006498605126,11,7,4,1.85059300407936,9.14940699592064
"1980","ive got something",12.006498605126,11,7,4,1.85059300407936,9.14940699592064
"1980","make feel alive",12.006498605126,11,7,4,1.85059300407936,9.14940699592064
"1980","might think im",12.006498605126,11,7,4,1.85059300407936,9.14940699592064
"1980","ooh wanna",12.006498605126,11,7,4,1.85059300407936,9.14940699592064
"1980","phone im",12.006498605126,11,7,4,1.85059300407936,9.14940699592064
"1980","secret rendezvous",12.006498605126,11,7,4,1.85059300407936,9.14940699592064
"1980","thats life",12.006498605126,11,7,4,1.85059300407936,9.14940699592064
"1980","true blue",12.006498605126,11,7,4,1.85059300407936,9.14940699592064
"1980","turn em",12.006498605126,11,7,4,1.85059300407936,9.14940699592064
"1970","around love",12.006434724404,35,13,22,4.78967621450843,30.2103237854916
"1970","growin",12.006434724404,35,13,22,4.78967621450843,30.2103237854916
"1970","love affair",12.006434724404,35,13,22,4.78967621450843,30.2103237854916
"1970","said hey",12.006434724404,35,13,22,4.78967621450843,30.2103237854916
"1990","cant just",12.0051566747028,33,16,17,7.00077496567454,25.9992250343255
"2000","creeping",12.000359863378,25,15,10,6.72714218031156,18.2728578196884
"2000","get party",12.000359863378,25,15,10,6.72714218031156,18.2728578196884
"2000","gone just",12.000359863378,25,15,10,6.72714218031156,18.2728578196884
"2000","good im",12.000359863378,25,15,10,6.72714218031156,18.2728578196884
"2000","man cant",12.000359863378,25,15,10,6.72714218031156,18.2728578196884
"2000","wrong cant",12.000359863378,25,15,10,6.72714218031156,18.2728578196884
"2010","ahead get",11.9984332192953,9,6,3,1.38566451580611,7.61433548419389
"2010","along know",11.9984332192953,9,6,3,1.38566451580611,7.61433548419389
"2010","baby lets go",11.9984332192953,9,6,3,1.38566451580611,7.61433548419389
"2010","back car",11.9984332192953,9,6,3,1.38566451580611,7.61433548419389
"2010","bucket",11.9984332192953,9,6,3,1.38566451580611,7.61433548419389
"2010","cant let get",11.9984332192953,9,6,3,1.38566451580611,7.61433548419389
"2010","catfish",11.9984332192953,9,6,3,1.38566451580611,7.61433548419389
"2010","cheerleader",11.9984332192953,9,6,3,1.38566451580611,7.61433548419389
"2010","dont come back",11.9984332192953,9,6,3,1.38566451580611,7.61433548419389
"2010","dont know happened",11.9984332192953,9,6,3,1.38566451580611,7.61433548419389
"2010","every day im",11.9984332192953,9,6,3,1.38566451580611,7.61433548419389
"2010","feel heartbeat",11.9984332192953,9,6,3,1.38566451580611,7.61433548419389
"2010","find youll",11.9984332192953,9,6,3,1.38566451580611,7.61433548419389
"2010","fucker",11.9984332192953,9,6,3,1.38566451580611,7.61433548419389
"2010","half past",11.9984332192953,9,6,3,1.38566451580611,7.61433548419389
"2010","just havent",11.9984332192953,9,6,3,1.38566451580611,7.61433548419389
"2010","keep beat",11.9984332192953,9,6,3,1.38566451580611,7.61433548419389
"2010","know kiss",11.9984332192953,9,6,3,1.38566451580611,7.61433548419389
"2010","lets one",11.9984332192953,9,6,3,1.38566451580611,7.61433548419389
"2010","life right",11.9984332192953,9,6,3,1.38566451580611,7.61433548419389
"2010","like love like",11.9984332192953,9,6,3,1.38566451580611,7.61433548419389
"2010","lose baby",11.9984332192953,9,6,3,1.38566451580611,7.61433548419389
"2010","love gonna love",11.9984332192953,9,6,3,1.38566451580611,7.61433548419389
"2010","man looking",11.9984332192953,9,6,3,1.38566451580611,7.61433548419389
"2010","moment life",11.9984332192953,9,6,3,1.38566451580611,7.61433548419389
"2010","move better",11.9984332192953,9,6,3,1.38566451580611,7.61433548419389
"2010","sky im",11.9984332192953,9,6,3,1.38566451580611,7.61433548419389
"2010","snappin",11.9984332192953,9,6,3,1.38566451580611,7.61433548419389
"2010","song see",11.9984332192953,9,6,3,1.38566451580611,7.61433548419389
"2010","though got",11.9984332192953,9,6,3,1.38566451580611,7.61433548419389
"2010","told now",11.9984332192953,9,6,3,1.38566451580611,7.61433548419389
"2010","tonight ooh",11.9984332192953,9,6,3,1.38566451580611,7.61433548419389
"2010","tonightoh oh",11.9984332192953,9,6,3,1.38566451580611,7.61433548419389
"2010","trouble dont",11.9984332192953,9,6,3,1.38566451580611,7.61433548419389
"2010","try control",11.9984332192953,9,6,3,1.38566451580611,7.61433548419389
"2010","wanna girl",11.9984332192953,9,6,3,1.38566451580611,7.61433548419389
"2010","wild like",11.9984332192953,9,6,3,1.38566451580611,7.61433548419389
"2010","wouldnt wouldnt",11.9984332192953,9,6,3,1.38566451580611,7.61433548419389
"1990","bye",11.9980722962867,183,59,124,38.8224793551043,144.177520644896
"1990","understood",11.9975536711576,39,18,21,8.27364314125173,30.7263568587483
"1970","left just",11.9960837710524,16,8,8,2.18956626948957,13.8104337305104
"1970","outta sight",11.9960837710524,16,8,8,2.18956626948957,13.8104337305104
"1970","people got",11.9960837710524,16,8,8,2.18956626948957,13.8104337305104
"1970","say goodnight",11.9960837710524,16,8,8,2.18956626948957,13.8104337305104
"1970","since met",11.9960837710524,16,8,8,2.18956626948957,13.8104337305104
"1970","tell story",11.9960837710524,16,8,8,2.18956626948957,13.8104337305104
"1970","want thank",11.9960837710524,16,8,8,2.18956626948957,13.8104337305104
"1990","know ill",11.9855659713842,168,55,113,35.6403089161613,132.359691083839
"2010","heartbeat",11.9839771483099,77,24,53,11.8551297463411,65.1448702536589
"1970","groovin",11.9820352639991,57,18,39,7.80032983505658,49.1996701649434
"2000","lips",11.9810825030001,338,120,218,90.9509622778123,247.049037722188
"1990","love forever",11.980085237812,78,30,48,16.5472862825035,61.4527137174965
"1970","love thats",11.9797075365057,111,29,82,15.1901159945839,95.8098840054161
"1970","youve",11.9757769061859,1117,194,923,152.85909518874,964.14090481126
"1960","come now",11.972227031791,93,15,78,5.55426442553728,87.4457355744627
"1980","dead",11.9677965805643,204,54,150,34.3200884392899,169.67991156071
"1970","rainbow",11.9660789620712,27,11,16,3.69489307976364,23.3051069202364
"1970","want live",11.9660789620712,27,11,16,3.69489307976364,23.3051069202364
"2000","bill",11.9657337302548,100,43,57,26.9085687212462,73.0914312787538
"1990","da la",11.9650488045173,58,24,34,12.3043923639128,45.6956076360872
"1990","everything will",11.9650488045173,58,24,34,12.3043923639128,45.6956076360872
"1990","gonna gonna",11.9650488045173,58,24,34,12.3043923639128,45.6956076360872
"2000","party",11.9581539060522,694,228,466,186.745466925449,507.254533074551
"2010","thinkin bout",11.9519829645156,86,26,60,13.2407942621472,72.7592057378528
"1980","far away",11.9311628012983,158,44,114,26.5812449676853,131.418755032315
"1960","downtown",11.928855961494,103,16,87,6.15149715946602,96.848502840534
"1990","dont want",11.9286348984079,818,215,603,173.534361270357,644.465638729643
"1980","broken",11.9267567461665,329,80,249,55.3495543947371,273.650445605263
"1980","cant hide",11.9195191482808,33,14,19,5.55177901223807,27.4482209877619
"1980","deja",11.9195191482808,33,14,19,5.55177901223807,27.4482209877619
"1980","hurt bad",11.9195191482808,33,14,19,5.55177901223807,27.4482209877619
"1980","live like",11.9195191482808,33,14,19,5.55177901223807,27.4482209877619
"1980","tonight dont",11.9195191482808,33,14,19,5.55177901223807,27.4482209877619
"2000","dont forget",11.9187212884818,69,32,37,18.5669124176599,50.4330875823401
"2000","haters",11.9187212884818,69,32,37,18.5669124176599,50.4330875823401
"1960","ill just",11.9137831960586,48,10,38,2.86671712285795,45.1332828771421
"1990","brothers",11.913482705938,68,27,41,14.4258393232082,53.5741606767919
"1990","ill always",11.9132044060959,85,32,53,18.0322991540102,66.9677008459898
"1990","need know",11.9069977213856,172,56,116,36.4888876998794,135.511112300121
"1980","seem",11.8967454292358,295,73,222,49.6295396548555,245.370460345144
"1960","baby love baby",11.8895211957107,40,9,31,2.38893093571496,37.611069064285
"1960","oh little",11.8895211957107,40,9,31,2.38893093571496,37.611069064285
"1960","easy",11.8826423310299,503,50,453,30.0408065166156,472.959193483384
"1970","enough",11.8552436252709,798,144,654,109.204617690792,688.795382309208
"1960","taught",11.83200276861,84,14,70,5.01675496500141,78.9832450349986
"2000","wanna one",11.8165446660267,45,23,22,12.1088559245608,32.8911440754392
"1990","lovers",11.80223028052,218,68,150,46.2475437126379,171.752456287362
"1980","broken hearts",11.7922317100974,23,11,12,3.86942173580229,19.1305782641977
"1980","close dont",11.7922317100974,23,11,12,3.86942173580229,19.1305782641977
"1980","coming coming",11.7922317100974,23,11,12,3.86942173580229,19.1305782641977
"1980","got find",11.7922317100974,23,11,12,3.86942173580229,19.1305782641977
"1980","know best",11.7922317100974,23,11,12,3.86942173580229,19.1305782641977
"1980","yeah yeah im",11.7922317100974,23,11,12,3.86942173580229,19.1305782641977
"2000","show",11.7908490437683,1443,447,996,388.290646647583,1054.70935335242
"2000","south",11.7863369287569,112,47,65,30.1375969677958,81.8624030322042
"1990","just little bit",11.779735100908,75,29,46,15.9108521947149,59.0891478052851
"1990","nobodys",11.779735100908,75,29,46,15.9108521947149,59.0891478052851
"2010","might say",11.7707210664981,32,13,19,4.9268071673106,27.0731928326894
"1960","made",11.7645636594809,1068,92,976,63.7844559835894,1004.21554401641
"1980","im crazy",11.7543341244836,84,27,57,14.1318011220605,69.8681988779394
"1970","friend mine",11.7380660448478,44,15,29,6.02130724109631,37.9786927589037
"1970","wont go",11.7380660448478,44,15,29,6.02130724109631,37.9786927589037
"2010","dont really care",11.7349606024435,18,9,9,2.77132903161221,15.2286709683878
"2010","gonna find way",11.7349606024435,18,9,9,2.77132903161221,15.2286709683878
"2010","gotta show",11.7349606024435,18,9,9,2.77132903161221,15.2286709683878
"2010","id never let",11.7349606024435,18,9,9,2.77132903161221,15.2286709683878
"2010","lion",11.7349606024435,18,9,9,2.77132903161221,15.2286709683878
"2010","little closer",11.7349606024435,18,9,9,2.77132903161221,15.2286709683878
"2010","paris",11.7349606024435,18,9,9,2.77132903161221,15.2286709683878
"2010","shirts",11.7349606024435,18,9,9,2.77132903161221,15.2286709683878
"2010","tonight need",11.7349606024435,18,9,9,2.77132903161221,15.2286709683878
"1970","searching",11.7308663204507,117,30,87,16.0112033456425,100.988796654358
"2000","cant love",11.7286932187748,30,17,13,8.07257061637387,21.9274293836261
"2000","get see",11.7286932187748,30,17,13,8.07257061637387,21.9274293836261
"2000","got babe",11.7286932187748,30,17,13,8.07257061637387,21.9274293836261
"2000","lets go lets",11.7286932187748,30,17,13,8.07257061637387,21.9274293836261
"2000","like em",11.7286932187748,30,17,13,8.07257061637387,21.9274293836261
"2000","uh oh oh",11.7286932187748,30,17,13,8.07257061637387,21.9274293836261
"2000","used say",11.7286932187748,30,17,13,8.07257061637387,21.9274293836261
"2000","way look",11.7286932187748,30,17,13,8.07257061637387,21.9274293836261
"1960","fruit",11.7186251450089,19,6,13,1.13474219446461,17.8652578055354
"1960","love day",11.7186251450089,19,6,13,1.13474219446461,17.8652578055354
"1960","stop cant stop",11.7186251450089,19,6,13,1.13474219446461,17.8652578055354
"1960","im glad",11.7161493317297,104,16,88,6.21122043285889,97.7887795671411
"1960","theyve",11.7161493317297,104,16,88,6.21122043285889,97.7887795671411
"1970","bleed",11.7096059580752,53,17,36,7.25293826768419,45.7470617323158
"1970","moments",11.7096059580752,53,17,36,7.25293826768419,45.7470617323158
"1980","pink",11.7083105485566,48,18,30,8.07531492689174,39.9246850731083
"2010","dust",11.7048507027543,105,30,75,16.1660860177379,88.8339139822621
"1990","dad",11.702605319006,82,31,51,17.3958650662216,64.6041349337784
"2000","seats",11.6941782156903,40,21,19,10.7634274884985,29.2365725115015
"2000","sho",11.6941782156903,40,21,19,10.7634274884985,29.2365725115015
"1970","use",11.6856255758221,290,61,229,39.6858886344984,250.314111365502
"1980","shadows",11.6855409775738,80,26,54,13.4588582114862,66.5411417885138
"1990","lets get",11.680817916882,269,81,188,57.066923205044,211.933076794956
"1990","crew",11.6691104004275,89,33,56,18.8808779377283,70.1191220622717
"1990","place",11.668617313144,943,244,699,200.052448261548,742.947551738452
"2010","running",11.6672888359899,365,81,284,56.1963942521365,308.803605747863
"1970","dont know never",11.6655380822137,13,7,6,1.77902259396027,11.2209774060397
"1970","face love",11.6655380822137,13,7,6,1.77902259396027,11.2209774060397
"1970","going round",11.6655380822137,13,7,6,1.77902259396027,11.2209774060397
"1970","hi hi",11.6655380822137,13,7,6,1.77902259396027,11.2209774060397
"1970","keep rollin",11.6655380822137,13,7,6,1.77902259396027,11.2209774060397
"1970","little darlin",11.6655380822137,13,7,6,1.77902259396027,11.2209774060397
"1970","now move",11.6655380822137,13,7,6,1.77902259396027,11.2209774060397
"1970","please dont let",11.6655380822137,13,7,6,1.77902259396027,11.2209774060397
"1970","rich girl",11.6655380822137,13,7,6,1.77902259396027,11.2209774060397
"1970","riders",11.6655380822137,13,7,6,1.77902259396027,11.2209774060397
"1970","said come",11.6655380822137,13,7,6,1.77902259396027,11.2209774060397
"1970","say well",11.6655380822137,13,7,6,1.77902259396027,11.2209774060397
"1970","talk love",11.6655380822137,13,7,6,1.77902259396027,11.2209774060397
"1970","tighter",11.6655380822137,13,7,6,1.77902259396027,11.2209774060397
"1970","used call",11.6655380822137,13,7,6,1.77902259396027,11.2209774060397
"1970","way gonna",11.6655380822137,13,7,6,1.77902259396027,11.2209774060397
"1970","youcome",11.6655380822137,13,7,6,1.77902259396027,11.2209774060397
"1990","cause id",11.6640911320194,22,12,10,4.6671833104497,17.3328166895503
"1990","da da da la",11.6640911320194,22,12,10,4.6671833104497,17.3328166895503
"1990","dont wait",11.6640911320194,22,12,10,4.6671833104497,17.3328166895503
"1990","dont waste time",11.6640911320194,22,12,10,4.6671833104497,17.3328166895503
"1990","glad youre",11.6640911320194,22,12,10,4.6671833104497,17.3328166895503
"1990","like ya",11.6640911320194,22,12,10,4.6671833104497,17.3328166895503
"1990","reason im",11.6640911320194,22,12,10,4.6671833104497,17.3328166895503
"1990","sexy sexy",11.6640911320194,22,12,10,4.6671833104497,17.3328166895503
"1960","baby love",11.6627486242431,270,31,239,16.125283816076,253.874716183924
"2010","excuse",11.6550489565525,69,22,47,10.6234279545135,58.3765720454865
"1980","running",11.6546443761727,365,87,278,61.4060405899059,303.593959410094
"2010","pretend",11.6540061982643,124,34,90,19.0913777733286,104.908622226671
"2000","away far",11.6514110550836,35,19,16,9.41799905243618,25.5820009475638
"2000","butterflies",11.6514110550836,35,19,16,9.41799905243618,25.5820009475638
"2000","feel know",11.6514110550836,35,19,16,9.41799905243618,25.5820009475638
"2000","get outta",11.6514110550836,35,19,16,9.41799905243618,25.5820009475638
"2000","wicked",11.6514110550836,35,19,16,9.41799905243618,25.5820009475638
"2000","motion",11.6491676304728,148,59,89,39.8246817074444,108.175318292556
"2000","paper",11.648378415248,92,40,52,24.7558832235465,67.2441167764535
"2000","smoke",11.6464549643708,200,76,124,53.8171374424925,146.182862557508
"1980","falling",11.6412866030721,375,89,286,63.0883978663417,311.911602133658
"1980","star",11.6412866030721,375,89,286,63.0883978663417,311.911602133658
"1960","cant see",11.6411300632285,306,34,272,18.2753216582194,287.724678341781
"1970","love can",11.6380705739219,182,42,140,24.9063163154438,157.093683684556
"2010","look",11.6374061189025,1903,348,1555,292.991063731002,1610.008936269
"2010","say never",11.6318046205532,36,14,22,5.54265806322443,30.4573419367756
"2010","skinny",11.6318046205532,36,14,22,5.54265806322443,30.4573419367756
"1970","love much",11.6201797494003,72,21,51,9.85304821270305,62.146951787297
"1980","pushing",11.6161957261278,37,15,22,6.22472192281238,30.7752780771876
"1980","turn away",11.6161957261278,37,15,22,6.22472192281238,30.7752780771876
"1980","want feel",11.6161957261278,37,15,22,6.22472192281238,30.7752780771876
"1980","take take",11.6152924806218,110,33,77,18.5059300407936,91.4940699592064
"1960","won",11.6129456328284,33,8,25,1.97086802196484,31.0291319780352
"2000","baby uh",11.6094879912751,23,14,9,6.18897080588663,16.8110291941134
"2000","got em",11.6094879912751,23,14,9,6.18897080588663,16.8110291941134
"2000","kim",11.6094879912751,23,14,9,6.18897080588663,16.8110291941134
"2000","know heard",11.6094879912751,23,14,9,6.18897080588663,16.8110291941134
"2000","mewhat",11.6094879912751,23,14,9,6.18897080588663,16.8110291941134
"2000","obsessed",11.6094879912751,23,14,9,6.18897080588663,16.8110291941134
"2000","stepping",11.6094879912751,23,14,9,6.18897080588663,16.8110291941134
"2000","sweet like",11.6094879912751,23,14,9,6.18897080588663,16.8110291941134
"2000","whips",11.6094879912751,23,14,9,6.18897080588663,16.8110291941134
"1980","come one",11.6072738031948,14,8,6,2.35530018701009,11.6446998129899
"1980","eagles",11.6072738031948,14,8,6,2.35530018701009,11.6446998129899
"1980","going know",11.6072738031948,14,8,6,2.35530018701009,11.6446998129899
"1980","got nowhere",11.6072738031948,14,8,6,2.35530018701009,11.6446998129899
"1980","know much true",11.6072738031948,14,8,6,2.35530018701009,11.6446998129899
"1980","nine five",11.6072738031948,14,8,6,2.35530018701009,11.6446998129899
"1980","now ive found",11.6072738031948,14,8,6,2.35530018701009,11.6446998129899
"1980","wow oh",11.6072738031948,14,8,6,2.35530018701009,11.6446998129899
"2000","birthday",11.6060635988868,64,30,34,17.2214839815976,46.7785160184024
"2000","im fallin",11.6060635988868,64,30,34,17.2214839815976,46.7785160184024
"1980","get excited",11.6060197201129,20,10,10,3.36471455287156,16.6352854471284
"1980","hope gone",11.6060197201129,20,10,10,3.36471455287156,16.6352854471284
"1980","love darling",11.6060197201129,20,10,10,3.36471455287156,16.6352854471284
"1980","stuck middle",11.6060197201129,20,10,10,3.36471455287156,16.6352854471284
"1980","want much",11.6060197201129,20,10,10,3.36471455287156,16.6352854471284
"1990","ill make",11.5984780154236,158,52,106,33.518861956866,124.481138043134
"1960","birds",11.592882137959,85,14,71,5.07647823839428,79.9235217616057
"1970","cant lose",11.5837044282495,10,6,4,1.36847891843098,8.63152108156902
"1970","country boy",11.5837044282495,10,6,4,1.36847891843098,8.63152108156902
"1970","day say",11.5837044282495,10,6,4,1.36847891843098,8.63152108156902
"1970","fountain",11.5837044282495,10,6,4,1.36847891843098,8.63152108156902
"1970","free ride",11.5837044282495,10,6,4,1.36847891843098,8.63152108156902
"1970","girl eyes",11.5837044282495,10,6,4,1.36847891843098,8.63152108156902
"1970","girl whole",11.5837044282495,10,6,4,1.36847891843098,8.63152108156902
"1970","id lost",11.5837044282495,10,6,4,1.36847891843098,8.63152108156902
"1970","ill holding",11.5837044282495,10,6,4,1.36847891843098,8.63152108156902
"1970","im glad im",11.5837044282495,10,6,4,1.36847891843098,8.63152108156902
"1970","keep groovin",11.5837044282495,10,6,4,1.36847891843098,8.63152108156902
"1970","keep heart",11.5837044282495,10,6,4,1.36847891843098,8.63152108156902
"1970","lies got",11.5837044282495,10,6,4,1.36847891843098,8.63152108156902
"1970","nearer",11.5837044282495,10,6,4,1.36847891843098,8.63152108156902
"1970","onenight",11.5837044282495,10,6,4,1.36847891843098,8.63152108156902
"1970","roll rock",11.5837044282495,10,6,4,1.36847891843098,8.63152108156902
"1970","show go",11.5837044282495,10,6,4,1.36847891843098,8.63152108156902
"1970","virginia",11.5837044282495,10,6,4,1.36847891843098,8.63152108156902
"1970","wont let wait",11.5837044282495,10,6,4,1.36847891843098,8.63152108156902
"2010","kitchen",11.5825803483649,48,17,31,7.3902107509659,40.6097892490341
"2010","time baby",11.5825803483649,48,17,31,7.3902107509659,40.6097892490341
"2010","dumb",11.5771530603285,78,24,54,12.0090924703196,65.9909075296804
"2010","change im",11.5659068161385,12,7,5,1.84755268774148,10.1524473122585
"2010","crave",11.5659068161385,12,7,5,1.84755268774148,10.1524473122585
"2010","dont deserve",11.5659068161385,12,7,5,1.84755268774148,10.1524473122585
"2010","featuring",11.5659068161385,12,7,5,1.84755268774148,10.1524473122585
"2010","got stuck",11.5659068161385,12,7,5,1.84755268774148,10.1524473122585
"2010","life good",11.5659068161385,12,7,5,1.84755268774148,10.1524473122585
"2010","middle cry",11.5659068161385,12,7,5,1.84755268774148,10.1524473122585
"2010","motivation",11.5659068161385,12,7,5,1.84755268774148,10.1524473122585
"2010","one put",11.5659068161385,12,7,5,1.84755268774148,10.1524473122585
"2010","pay mind",11.5659068161385,12,7,5,1.84755268774148,10.1524473122585
"2010","show now",11.5659068161385,12,7,5,1.84755268774148,10.1524473122585
"2010","think always",11.5659068161385,12,7,5,1.84755268774148,10.1524473122585
"2010","whoah",11.5659068161385,12,7,5,1.84755268774148,10.1524473122585
"2010","worship",11.5659068161385,12,7,5,1.84755268774148,10.1524473122585
"2010","yeah yeah dont",11.5659068161385,12,7,5,1.84755268774148,10.1524473122585
"2010","youll need",11.5659068161385,12,7,5,1.84755268774148,10.1524473122585
"2010","using",11.5658766288054,40,15,25,6.15850895913825,33.8414910408617
"1980","heels",11.561677587289,56,20,36,9.42120074804036,46.5787992519596
"2010","baddest",11.5537802471654,44,16,28,6.77435985505208,37.2256401449479
"1980","believe true",11.5512227558471,30,13,17,5.04707182930734,24.9529281706927
"1980","go make",11.5512227558471,30,13,17,5.04707182930734,24.9529281706927
"1980","innocence",11.5512227558471,30,13,17,5.04707182930734,24.9529281706927
"1980","know youre gonna",11.5512227558471,30,13,17,5.04707182930734,24.9529281706927
"1980","make feel way",11.5512227558471,30,13,17,5.04707182930734,24.9529281706927
"1980","sounds like",11.5512227558471,30,13,17,5.04707182930734,24.9529281706927
"2010","body got",11.5497028718538,15,8,7,2.30944085967684,12.6905591403232
"2010","boy big",11.5497028718538,15,8,7,2.30944085967684,12.6905591403232
"2010","broken hearted",11.5497028718538,15,8,7,2.30944085967684,12.6905591403232
"2010","dont ever want",11.5497028718538,15,8,7,2.30944085967684,12.6905591403232
"2010","eso",11.5497028718538,15,8,7,2.30944085967684,12.6905591403232
"2010","got long",11.5497028718538,15,8,7,2.30944085967684,12.6905591403232
"2010","hope die",11.5497028718538,15,8,7,2.30944085967684,12.6905591403232
"2010","listen close",11.5497028718538,15,8,7,2.30944085967684,12.6905591403232
"2010","miles just",11.5497028718538,15,8,7,2.30944085967684,12.6905591403232
"2010","one youll",11.5497028718538,15,8,7,2.30944085967684,12.6905591403232
"2010","something im",11.5497028718538,15,8,7,2.30944085967684,12.6905591403232
"2010","thats dont",11.5497028718538,15,8,7,2.30944085967684,12.6905591403232
"2010","thats right im",11.5497028718538,15,8,7,2.30944085967684,12.6905591403232
"2010","time play",11.5497028718538,15,8,7,2.30944085967684,12.6905591403232
"2010","truth im",11.5497028718538,15,8,7,2.30944085967684,12.6905591403232
"2010","ya hands",11.5497028718538,15,8,7,2.30944085967684,12.6905591403232
"1970","leave",11.5494697249554,1265,216,1049,173.112583181519,1091.88741681848
"1990","gods",11.5481340185781,49,21,28,10.3950901005471,38.604909899453
"1990","motherfuckin",11.5481340185781,49,21,28,10.3950901005471,38.604909899453
"2010","dont treat",11.5478667103601,25,11,14,3.84906809946141,21.1509319005386
"2010","ever feel",11.5478667103601,25,11,14,3.84906809946141,21.1509319005386
"2010","half way",11.5478667103601,25,11,14,3.84906809946141,21.1509319005386
"2010","just put",11.5478667103601,25,11,14,3.84906809946141,21.1509319005386
"2010","lose im",11.5478667103601,25,11,14,3.84906809946141,21.1509319005386
"2010","thing never",11.5478667103601,25,11,14,3.84906809946141,21.1509319005386
"1970","yes im",11.5470030705812,97,26,71,13.2742455087805,83.7257544912195
"1980","sweetest",11.5348312679219,60,21,39,10.0941436586147,49.9058563413853
"1990","five",11.5272781595633,196,62,134,41.5803604021882,154.419639597812
"1980","baby can take",11.5221571996773,17,9,8,2.86000736994083,14.1399926300592
"1980","crazy just",11.5221571996773,17,9,8,2.86000736994083,14.1399926300592
"1980","just cant hide",11.5221571996773,17,9,8,2.86000736994083,14.1399926300592
"1980","things im",11.5221571996773,17,9,8,2.86000736994083,14.1399926300592
"1980","youre way",11.5221571996773,17,9,8,2.86000736994083,14.1399926300592
"1970","can dance can",11.5119975873417,20,9,11,2.73695783686196,17.263042163138
"1970","closes",11.5119975873417,20,9,11,2.73695783686196,17.263042163138
"1970","didnt love",11.5119975873417,20,9,11,2.73695783686196,17.263042163138
"1970","flowin",11.5119975873417,20,9,11,2.73695783686196,17.263042163138
"1970","get used",11.5119975873417,20,9,11,2.73695783686196,17.263042163138
"1970","gotcha",11.5119975873417,20,9,11,2.73695783686196,17.263042163138
"1970","never fall love",11.5119975873417,20,9,11,2.73695783686196,17.263042163138
"1970","nuff",11.5119975873417,20,9,11,2.73695783686196,17.263042163138
"1960","now shes",11.5100212702453,41,9,32,2.44865420910783,38.5513457908922
"1960","pity",11.5100212702453,41,9,32,2.44865420910783,38.5513457908922
"1960","song sing",11.5029524219449,26,7,19,1.55280510821472,24.4471948917853
"1960","way now",11.5029524219449,26,7,19,1.55280510821472,24.4471948917853
"1980","cold",11.5022820843422,522,118,404,87.8190498299477,434.180950170052
"2000","watch",11.4555125584664,697,228,469,187.552723987086,509.447276012914
"1970","got keep",11.4511238945535,49,16,33,6.7055467003118,42.2944532996882
"1970","wood",11.4511238945535,49,16,33,6.7055467003118,42.2944532996882
"1990","ride",11.4483514778258,898,233,665,190.505936944719,707.494063055281
"1960","whoaoh",11.4415376006292,58,11,47,3.46394985678669,54.5360501432133
"1980","nothings",11.4397391424743,89,28,61,14.9729797602784,74.0270202397216
"1990","bank account",11.4389739495257,12,8,4,2.54573635115438,9.45426364884562
"1990","days just",11.4389739495257,12,8,4,2.54573635115438,9.45426364884562
"1990","dont know youve",11.4389739495257,12,8,4,2.54573635115438,9.45426364884562
"1990","get thats",11.4389739495257,12,8,4,2.54573635115438,9.45426364884562
"1990","heart feel",11.4389739495257,12,8,4,2.54573635115438,9.45426364884562
"1990","im glad youre",11.4389739495257,12,8,4,2.54573635115438,9.45426364884562
"1990","know just need",11.4389739495257,12,8,4,2.54573635115438,9.45426364884562
"1990","know make feel",11.4389739495257,12,8,4,2.54573635115438,9.45426364884562
"1990","much pain",11.4389739495257,12,8,4,2.54573635115438,9.45426364884562
"1990","now maybe",11.4389739495257,12,8,4,2.54573635115438,9.45426364884562
"1990","plain see youre",11.4389739495257,12,8,4,2.54573635115438,9.45426364884562
"1990","stash",11.4389739495257,12,8,4,2.54573635115438,9.45426364884562
"1990","stay tell",11.4389739495257,12,8,4,2.54573635115438,9.45426364884562
"1990","take make",11.4389739495257,12,8,4,2.54573635115438,9.45426364884562
"1990","tight baby",11.4389739495257,12,8,4,2.54573635115438,9.45426364884562
"1990","want got need",11.4389739495257,12,8,4,2.54573635115438,9.45426364884562
"1990","whatd",11.4389739495257,12,8,4,2.54573635115438,9.45426364884562
"1990","whats really",11.4389739495257,12,8,4,2.54573635115438,9.45426364884562
"1990","ya head",11.4389739495257,12,8,4,2.54573635115438,9.45426364884562
"1990","yes girl",11.4389739495257,12,8,4,2.54573635115438,9.45426364884562
"1990","yousay",11.4389739495257,12,8,4,2.54573635115438,9.45426364884562
"1990","quit",11.4371710724336,118,41,77,25.0330741196847,92.9669258803153
"1990","every little thing",11.4336939821451,46,20,26,9.75865601275846,36.2413439872415
"1960","good good good",11.4223191373034,67,12,55,4.00145931732255,62.9985406826774
"1990","baby feel",11.4178860098534,25,13,12,5.30361739823829,19.6963826017617
"1990","gin",11.4178860098534,25,13,12,5.30361739823829,19.6963826017617
"1990","love feeling",11.4178860098534,25,13,12,5.30361739823829,19.6963826017617
"1990","promise will",11.4178860098534,25,13,12,5.30361739823829,19.6963826017617
"1990","see ill",11.4178860098534,25,13,12,5.30361739823829,19.6963826017617
"1990","want really",11.4178860098534,25,13,12,5.30361739823829,19.6963826017617
"1990","want taste",11.4178860098534,25,13,12,5.30361739823829,19.6963826017617
"2010","friday",11.4077962544586,92,27,65,14.164570606018,77.835429393982
"1980","roll baby",11.4004836797496,41,16,25,6.8976648333867,34.1023351666133
"1980","things never",11.4004836797496,41,16,25,6.8976648333867,34.1023351666133
"2000","rockin",11.3975298290987,173,67,106,46.551823887756,126.448176112244
"1970","children",11.3964018333537,134,33,101,18.3376175069751,115.662382493025
"1970","oh yes",11.3964018333537,134,33,101,18.3376175069751,115.662382493025
"1970","write",11.3941717044337,172,40,132,23.5378373970128,148.462162602987
"1980","dont cry",11.3787032137496,102,31,71,17.1600442196449,84.8399557803551
"1990","somehow",11.364500269394,170,55,115,36.0645983080204,133.93540169198
"1960","baby now",11.3584014982241,86,14,72,5.13620151178716,80.8637984882128
"2000","watchin",11.3514085070296,84,37,47,22.6031977258468,61.3968022741532
"1980","red",11.3420025206863,452,104,348,76.0425488948972,375.957451105103
"2000","away take",11.337798336248,43,22,21,11.5706845501359,31.4293154498641
"1990","ah yeah",11.3357099158858,43,19,24,9.12222192496986,33.8777780750301
"1990","tuesday",11.3357099158858,43,19,24,9.12222192496986,33.8777780750301
"2000","momma",11.3355451115578,164,64,100,44.1300527028438,119.869947297156
"2010","can take",11.3181094386814,261,61,200,40.1842709583771,220.815729041623
"1990","alone youre",11.3130960555408,17,10,7,3.60645983080204,13.393540169198
"1990","heart got",11.3130960555408,17,10,7,3.60645983080204,13.393540169198
"1990","party people",11.3130960555408,17,10,7,3.60645983080204,13.393540169198
"1990","thing go",11.3130960555408,17,10,7,3.60645983080204,13.393540169198
"1990","wanna night",11.3130960555408,17,10,7,3.60645983080204,13.393540169198
"1990","youre strong",11.3130960555408,17,10,7,3.60645983080204,13.393540169198
"1970","baby lets get",11.2970299552066,24,10,14,3.28434940423435,20.7156505957656
"1970","big fat",11.2970299552066,24,10,14,3.28434940423435,20.7156505957656
"1970","comin home",11.2970299552066,24,10,14,3.28434940423435,20.7156505957656
"1970","mind time",11.2970299552066,24,10,14,3.28434940423435,20.7156505957656
"1970","together can",11.2970299552066,24,10,14,3.28434940423435,20.7156505957656
"1970","wanna right",11.2970299552066,24,10,14,3.28434940423435,20.7156505957656
"2000","dance dont",11.2873763522624,28,16,12,7.53439924194894,20.4656007580511
"2000","changed",11.2870448162332,155,61,94,41.7082815179316,113.291718482068
"1970","cant cant cant",11.2797726545183,32,12,20,4.37913253897913,27.6208674610209
"1990","im far",11.2737289923537,28,14,14,5.94005148602689,22.0599485139731
"1990","miss baby",11.2737289923537,28,14,14,5.94005148602689,22.0599485139731
"1990","missy",11.2737289923537,28,14,14,5.94005148602689,22.0599485139731
"2000","cream",11.2730423260852,87,38,49,23.4104547874842,63.5895452125158
"2000","forgot",11.2730423260852,87,38,49,23.4104547874842,63.5895452125158
"1980","hangin",11.2666573765911,98,30,68,16.4871013090706,81.5128986909294
"2000","got want",11.2547375507905,51,25,26,13.7233700478356,37.2766299521644
"2000","candy",11.2544745930658,146,58,88,39.2865103330195,106.71348966698
"2010","get drunk",11.2534525456306,29,12,17,4.46491899537523,24.5350810046248
"2010","got heart",11.2534525456306,29,12,17,4.46491899537523,24.5350810046248
"2010","im girl",11.2534525456306,29,12,17,4.46491899537523,24.5350810046248
"2010","mean nothing",11.2534525456306,29,12,17,4.46491899537523,24.5350810046248
"2010","tell really",11.2534525456306,29,12,17,4.46491899537523,24.5350810046248
"2000","wings",11.2502844430321,128,52,76,34.4429679631952,93.5570320368048
"1960","flower",11.2469121184501,50,10,40,2.9861636696437,47.0138363303563
"1960","ill stay",11.2469121184501,50,10,40,2.9861636696437,47.0138363303563
"1960","pouring",11.2469121184501,50,10,40,2.9861636696437,47.0138363303563
"2000","baby baby baby baby",11.2412637436777,134,54,80,36.0574820864699,97.9425179135301
"1970","imagination",11.2385604393786,28,11,17,3.83174097160674,24.1682590283933
"1970","life let",11.2385604393786,28,11,17,3.83174097160674,24.1682590283933
"1970","suzie",11.2385604393786,28,11,17,3.83174097160674,24.1682590283933
"2000","bad make",11.2360109681263,21,13,8,5.65079943146171,15.3492005685383
"2000","im mr",11.2360109681263,21,13,8,5.65079943146171,15.3492005685383
"2000","just walked",11.2360109681263,21,13,8,5.65079943146171,15.3492005685383
"2000","mad dont",11.2360109681263,21,13,8,5.65079943146171,15.3492005685383
"2000","say nothing",11.2360109681263,21,13,8,5.65079943146171,15.3492005685383
"2000","strapped",11.2360109681263,21,13,8,5.65079943146171,15.3492005685383
"2000","us dont",11.2360109681263,21,13,8,5.65079943146171,15.3492005685383
"2000","wanna cry",11.2360109681263,21,13,8,5.65079943146171,15.3492005685383
"2000","youre walkin",11.2360109681263,21,13,8,5.65079943146171,15.3492005685383
"1990","kid",11.2323784306949,178,57,121,37.7617558754566,140.238244124543
"1970","can love",11.2304833712811,73,21,52,9.98989610454615,63.0101038954538
"1990","shall",11.222327045657,56,23,33,11.8801029720538,44.1198970279462
"2000","just dance",11.219668128209,38,20,18,10.2252561140736,27.7747438859264
"1970","company",11.2101432074865,45,15,30,6.15815513293941,38.8418448670606
"1970","thank god",11.2101432074865,45,15,30,6.15815513293941,38.8418448670606
"1980","around ill",11.2076004235583,27,12,15,4.5423646463766,22.4576353536234
"1980","stop us",11.2076004235583,27,12,15,4.5423646463766,22.4576353536234
"1980","sexual",11.2055246746047,34,14,20,5.72001473988165,28.2799852601184
"1980","way make feel",11.2055246746047,34,14,20,5.72001473988165,28.2799852601184
"1990","shiny",11.2048004261863,37,17,20,7.84935374939267,29.1506462506073
"1990","youve got",11.2034849367345,391,111,280,82.9485761084469,308.051423891553
"1990","caress",11.2018463097299,31,15,16,6.57648557381548,24.4235144261845
"1990","right know",11.2018463097299,31,15,16,6.57648557381548,24.4235144261845
"1990","finally",11.1994140948681,201,63,138,42.6410838818359,158.358916118164
"1990","oh baby",11.1939624763569,387,110,277,82.0999973247287,304.900002675271
"2000","butt",11.1893776784778,73,33,40,19.6432551665097,53.3567448334902
"2000","back let",11.1872763887813,33,18,15,8.87982767801125,24.1201723219887
"1990","hes just",11.1831513044647,34,16,18,7.21291966160408,26.7870803383959
"1990","know tell",11.1831513044647,34,16,18,7.21291966160408,26.7870803383959
"1990","see wanna",11.1831513044647,34,16,18,7.21291966160408,26.7870803383959
"1990","take control",11.1831513044647,34,16,18,7.21291966160408,26.7870803383959
"2010","seat",11.1817263984564,79,24,55,12.163055194298,66.8369448057019
"1960","walking",11.1810610164102,227,27,200,13.5571830601824,213.442816939818
"1970","made",11.17585092986,1068,185,883,146.153548488429,921.846451511571
"1980","prove",11.1687032731823,138,39,99,23.2165304148138,114.783469585186
"1980","around",11.1553373653689,2228,435,1793,374.829201189892,1853.17079881011
"1960","seemed",11.1539833325767,68,12,56,4.06118259071543,63.9388174092846
"1960","must",11.1532451988006,696,64,632,41.5673982814403,654.43260171856
"1960","cloud",11.1480930436205,59,11,48,3.52367313017956,55.4763268698204
"1960","hiding",11.1480930436205,59,11,48,3.52367313017956,55.4763268698204
"1990","waste",11.1276764045382,152,50,102,32.2459937812888,119.754006218711
"2010","black",11.1235068689768,428,92,336,65.8960458627793,362.103954137221
"1980","tell",11.123388706739,3445,654,2791,579.572081732126,2865.42791826787
"2010","thirsty",11.1170932786726,22,10,12,3.38717992752604,18.612820072474
"1960","dont work",11.1060994604707,20,6,14,1.19446546785748,18.8055345321425
"1960","overnight",11.1060994604707,20,6,14,1.19446546785748,18.8055345321425
"1980","heart soul",11.0870633804736,53,19,34,8.91649356510963,44.0835064348904
"1980","let us",11.0870633804736,53,19,34,8.91649356510963,44.0835064348904
"1970","aint way",11.0842198811971,59,18,41,8.07402561874278,50.9259743812572
"2010","go got",11.0833132404387,33,13,20,5.08076989128906,27.9192301087109
"2010","press",11.0833132404387,33,13,20,5.08076989128906,27.9192301087109
"1970","freedom",11.0739091358551,114,29,85,15.6006596701132,98.3993403298868
"2000","think",11.0636295601074,2640,787,1853,710.3862142409,1929.6137857591
"1980","night oh",11.0577370213951,90,28,62,15.141215487922,74.858784512078
"1960","pretty",11.0559094867689,487,48,439,29.0852341423296,457.91476585767
"1980","gonna tell",11.0505276460328,61,21,40,10.2623793862583,50.7376206137417
"1970","left",11.0495445453774,889,157,732,121.657775848514,767.342224151486
"2000","yet",11.0483781123076,174,67,107,46.8209095749684,127.179090425032
"1980","comes oh",11.0366519073989,9,6,3,1.5141215487922,7.4858784512078
"1980","feel heart beating",11.0366519073989,9,6,3,1.5141215487922,7.4858784512078
"1980","forever come",11.0366519073989,9,6,3,1.5141215487922,7.4858784512078
"1980","heart stone",11.0366519073989,9,6,3,1.5141215487922,7.4858784512078
"1980","help baby",11.0366519073989,9,6,3,1.5141215487922,7.4858784512078
"1980","keep giving",11.0366519073989,9,6,3,1.5141215487922,7.4858784512078
"1980","midnight hour",11.0366519073989,9,6,3,1.5141215487922,7.4858784512078
"1980","oh feeling",11.0366519073989,9,6,3,1.5141215487922,7.4858784512078
"1980","por ti",11.0366519073989,9,6,3,1.5141215487922,7.4858784512078
"1980","say always",11.0366519073989,9,6,3,1.5141215487922,7.4858784512078
"1980","say goodbye never",11.0366519073989,9,6,3,1.5141215487922,7.4858784512078
"1980","seasons change",11.0366519073989,9,6,3,1.5141215487922,7.4858784512078
"1980","see forever",11.0366519073989,9,6,3,1.5141215487922,7.4858784512078
"1980","start heart",11.0366519073989,9,6,3,1.5141215487922,7.4858784512078
"1980","still believed",11.0366519073989,9,6,3,1.5141215487922,7.4858784512078
"1980","strong carry",11.0366519073989,9,6,3,1.5141215487922,7.4858784512078
"1980","sun still",11.0366519073989,9,6,3,1.5141215487922,7.4858784512078
"1980","tell ive",11.0366519073989,9,6,3,1.5141215487922,7.4858784512078
"1980","town just",11.0366519073989,9,6,3,1.5141215487922,7.4858784512078
"1980","will remain",11.0366519073989,9,6,3,1.5141215487922,7.4858784512078
"1980","worth living",11.0366519073989,9,6,3,1.5141215487922,7.4858784512078
"2000","know thats",11.0349443438777,46,23,23,12.3779416117733,33.6220583882267
"2000","take slow",11.0349443438777,46,23,23,12.3779416117733,33.6220583882267
"1970","love now",11.0346346547244,130,32,98,17.7902259396027,112.209774060397
"2000","can come",11.0296233877794,54,26,28,14.530627109473,39.469372890527
"2000","shirt",11.0296233877794,54,26,28,14.530627109473,39.469372890527
"2000","soldier",11.0296233877794,54,26,28,14.530627109473,39.469372890527
"1990","hits",11.0231674702696,80,30,50,16.9715756743625,63.0284243256375
"1960","care dont",11.0125534827326,27,7,20,1.6125283816076,25.3874716183924
"1990","work work",11.0112024149882,63,25,38,13.3651158435605,49.6348841564395
"2000","life oh",11.0007270467057,102,43,59,27.4467400956712,74.5532599043289
"1980","miss",10.9995184218561,717,155,562,120.625016720445,596.374983279555
"2010","itd",10.9984923564063,37,14,23,5.69662078720288,31.3033792127971
"2010","well just",10.9984923564063,37,14,23,5.69662078720288,31.3033792127971
"1970","keep keep",10.9915482908128,41,14,27,5.61076356556702,35.389236434433
"1970","refuse",10.9915482908128,41,14,27,5.61076356556702,35.389236434433
"2000","noise",10.9854661028127,79,35,44,21.2577692897845,57.7422307102155
"2000","im im",10.9815199033958,65,30,35,17.49056966881,47.50943033119
"2010","yeah wanna",10.9749359395849,41,15,26,6.31247168311671,34.6875283168833
"1970","shake",10.9695617210163,1207,206,1001,165.175405454619,1041.82459454538
"2000","never thought",10.9654653086948,105,44,61,28.2539971573085,76.7460028426915
"1970","baby made",10.9629756066352,17,8,9,2.32641416133266,14.6735858386673
"1970","deep love deep love",10.9629756066352,17,8,9,2.32641416133266,14.6735858386673
"1970","foolin",10.9629756066352,17,8,9,2.32641416133266,14.6735858386673
"1970","loves love",10.9629756066352,17,8,9,2.32641416133266,14.6735858386673
"1970","notion",10.9629756066352,17,8,9,2.32641416133266,14.6735858386673
"1970","now believe",10.9629756066352,17,8,9,2.32641416133266,14.6735858386673
"1970","relieve",10.9629756066352,17,8,9,2.32641416133266,14.6735858386673
"1970","stay alive",10.9629756066352,17,8,9,2.32641416133266,14.6735858386673
"1970","waits",10.9629756066352,17,8,9,2.32641416133266,14.6735858386673
"1970","ya say",10.9629756066352,17,8,9,2.32641416133266,14.6735858386673
"1970","yeah show",10.9629756066352,17,8,9,2.32641416133266,14.6735858386673
"1980","reaching",10.9628515171703,38,15,23,6.39295765045596,31.607042349544
"1980","winning",10.9628515171703,38,15,23,6.39295765045596,31.607042349544
"1960","good",10.9567316408429,2885,216,2669,172.301643738441,2712.69835626156
"1960","now youre",10.9519019105488,183,23,160,10.9293590308959,172.070640969104
"1970","fire",10.9358045785253,674,123,551,92.235479102248,581.764520897752
"1960","now dont",10.9261470641144,172,22,150,10.2724030235743,161.727596976426
"1990","cant explain",10.9208099205316,50,21,29,10.6072347964766,39.3927652035234
"1990","always love will",10.9201728686669,10,7,3,2.12144695929532,7.87855304070468
"1990","amends",10.9201728686669,10,7,3,2.12144695929532,7.87855304070468
"1990","baby theres nothing",10.9201728686669,10,7,3,2.12144695929532,7.87855304070468
"1990","came get",10.9201728686669,10,7,3,2.12144695929532,7.87855304070468
"1990","cept",10.9201728686669,10,7,3,2.12144695929532,7.87855304070468
"1990","every single word",10.9201728686669,10,7,3,2.12144695929532,7.87855304070468
"1990","faithfully",10.9201728686669,10,7,3,2.12144695929532,7.87855304070468
"1990","freak like",10.9201728686669,10,7,3,2.12144695929532,7.87855304070468
"1990","get friends",10.9201728686669,10,7,3,2.12144695929532,7.87855304070468
"1990","just made",10.9201728686669,10,7,3,2.12144695929532,7.87855304070468
"1990","knew never",10.9201728686669,10,7,3,2.12144695929532,7.87855304070468
"1990","let cry",10.9201728686669,10,7,3,2.12144695929532,7.87855304070468
"1990","let know love",10.9201728686669,10,7,3,2.12144695929532,7.87855304070468
"1990","little something",10.9201728686669,10,7,3,2.12144695929532,7.87855304070468
"1990","love sun",10.9201728686669,10,7,3,2.12144695929532,7.87855304070468
"1990","make amends",10.9201728686669,10,7,3,2.12144695929532,7.87855304070468
"1990","make weak",10.9201728686669,10,7,3,2.12144695929532,7.87855304070468
"1990","mine can",10.9201728686669,10,7,3,2.12144695929532,7.87855304070468
"1990","one hit",10.9201728686669,10,7,3,2.12144695929532,7.87855304070468
"1990","reali",10.9201728686669,10,7,3,2.12144695929532,7.87855304070468
"1990","really wanted",10.9201728686669,10,7,3,2.12144695929532,7.87855304070468
"1990","sing im",10.9201728686669,10,7,3,2.12144695929532,7.87855304070468
"1990","slow know",10.9201728686669,10,7,3,2.12144695929532,7.87855304070468
"1990","someone show",10.9201728686669,10,7,3,2.12144695929532,7.87855304070468
"1990","take now",10.9201728686669,10,7,3,2.12144695929532,7.87855304070468
"1990","time heart",10.9201728686669,10,7,3,2.12144695929532,7.87855304070468
"1990","try change",10.9201728686669,10,7,3,2.12144695929532,7.87855304070468
"1990","understand understand",10.9201728686669,10,7,3,2.12144695929532,7.87855304070468
"1990","unite",10.9201728686669,10,7,3,2.12144695929532,7.87855304070468
"1990","want things",10.9201728686669,10,7,3,2.12144695929532,7.87855304070468
"1990","will always love will",10.9201728686669,10,7,3,2.12144695929532,7.87855304070468
"1990","yeah mama",10.9201728686669,10,7,3,2.12144695929532,7.87855304070468
"1990","youi love",10.9201728686669,10,7,3,2.12144695929532,7.87855304070468
"2010","ohi",10.9147815944569,62,20,42,9.54568888666429,52.4543111133357
"1960","oh yeah oh",10.9028939897072,88,14,74,5.25564805857291,82.7443519414271
"2000","truck",10.9008771996833,82,36,46,22.0650263514219,59.9349736485781
"1970","lived",10.8984985977586,69,20,49,9.44250453717376,59.5574954628262
"1970","sang",10.8984985977586,69,20,49,9.44250453717376,59.5574954628262
"1980","cmon baby",10.8977178948251,24,11,13,4.03765746344587,19.9623425365541
"1980","feel body",10.8977178948251,24,11,13,4.03765746344587,19.9623425365541
"1980","fits",10.8977178948251,24,11,13,4.03765746344587,19.9623425365541
"1980","shes mine",10.8977178948251,24,11,13,4.03765746344587,19.9623425365541
"1980","stray",10.8977178948251,24,11,13,4.03765746344587,19.9623425365541
"1960","theres",10.8942108361385,1942,152,1790,115.982596928961,1826.01740307104
"2000","chris",10.8856569538904,19,12,7,5.11262805703678,13.8873719429632
"2000","dance baby",10.8856569538904,19,12,7,5.11262805703678,13.8873719429632
"2000","just gotta get",10.8856569538904,19,12,7,5.11262805703678,13.8873719429632
"2000","make hard",10.8856569538904,19,12,7,5.11262805703678,13.8873719429632
"2000","mansion",10.8856569538904,19,12,7,5.11262805703678,13.8873719429632
"2000","pay rent",10.8856569538904,19,12,7,5.11262805703678,13.8873719429632
"2000","real bad",10.8856569538904,19,12,7,5.11262805703678,13.8873719429632
"2000","step now",10.8856569538904,19,12,7,5.11262805703678,13.8873719429632
"2000","take im",10.8856569538904,19,12,7,5.11262805703678,13.8873719429632
"2000","take want",10.8856569538904,19,12,7,5.11262805703678,13.8873719429632
"2000","uh like",10.8856569538904,19,12,7,5.11262805703678,13.8873719429632
"1960","number",10.8851992629016,241,28,213,14.3933088876826,226.606691112317
"1990","blowing",10.8812605239167,70,27,43,14.8501287150672,55.1498712849328
"1990","distance",10.8812605239167,70,27,43,14.8501287150672,55.1498712849328
"1990","brooklyn",10.8770899976124,20,11,9,4.24289391859063,15.7571060814094
"1990","can drive",10.8770899976124,20,11,9,4.24289391859063,15.7571060814094
"1990","get lovin",10.8770899976124,20,11,9,4.24289391859063,15.7571060814094
"1990","one ill",10.8770899976124,20,11,9,4.24289391859063,15.7571060814094
"1990","taller",10.8770899976124,20,11,9,4.24289391859063,15.7571060814094
"1990","us just",10.8770899976124,20,11,9,4.24289391859063,15.7571060814094
"1980","shout",10.8756862468083,139,39,100,23.3847661424573,115.615233857543
"1970","held",10.8638238666557,136,33,103,18.6113132906613,117.388686709339
"1960","evening",10.8624182395967,60,11,49,3.58339640357244,56.4166035964276
"1960","slip",10.8576881490826,129,18,111,7.70430226768074,121.295697732319
"1990","rain",10.8529932052708,767,201,566,162.714981777951,604.285018222049
"2000","away like",10.8520433618981,26,15,11,6.99622786752402,19.003772132476
"1970","coming home",10.8286384334171,79,22,57,10.8109834556047,68.1890165443953
"1970","n roll",10.8286384334171,79,22,57,10.8109834556047,68.1890165443953
"1970","rock n",10.8286384334171,79,22,57,10.8109834556047,68.1890165443953
"1970","rock n roll",10.8286384334171,79,22,57,10.8109834556047,68.1890165443953
"2010","love love love",10.8219127033932,381,83,298,58.6597978357918,322.340202164208
"2010","yeah thats",10.814486140625,71,22,49,10.9313534024704,60.0686465975296
"1970","ooh",10.8090612075957,2077,337,1740,284.233071358114,1792.76692864189
"1980","come im",10.8084009734482,31,13,18,5.21530755695092,25.7846924430491
"1980","think got",10.8084009734482,31,13,18,5.21530755695092,25.7846924430491
"1970","bells",10.8022467952191,37,13,24,5.06337199819462,31.9366280018054
"1980","run away",10.794763971093,95,29,66,15.9823941261399,79.0176058738601
"1980","can find",10.7934719414437,78,25,53,13.1223867561991,64.8776132438009
"1990","fool",10.7926438838461,381,108,273,80.8271291491515,300.172870850848
"1960","roam",10.7914629132076,43,9,34,2.56810075589358,40.4318992441064
"1960","shade",10.7858041343199,35,8,27,2.09031456875059,32.9096854312494
"1970","go round",10.785740382687,55,17,38,7.52663405137039,47.4733659486296
"2000","nobody",10.7833575220301,718,233,485,193.203523418548,524.796476581452
"1990","close eyes",10.7818241063982,218,67,151,46.2475437126379,171.752456287362
"2010","knife",10.7757661760942,58,19,39,8.92983799075047,49.0701620092495
"1990","words",10.7732352926845,612,164,448,129.832553908873,482.167446091127
"1990","sittin",10.7659433828278,172,55,117,36.4888876998794,135.511112300121
"2010","ive enough",10.7529224982029,26,11,15,4.00303082343986,21.9969691765601
"2010","youre worth",10.7529224982029,26,11,15,4.00303082343986,21.9969691765601
"2000","lets talk",10.7457444672848,36,19,17,9.68708473964864,26.3129152603514
"2000","numbers",10.7457444672848,36,19,17,9.68708473964864,26.3129152603514
"1980","say",10.7365249509598,4757,886,3871,800.2973564005,3956.7026435995
"2010","aint enough",10.7357058639205,19,9,10,2.92529175559067,16.0747082444093
"2010","bottom top",10.7357058639205,19,9,10,2.92529175559067,16.0747082444093
"2010","call dont",10.7357058639205,19,9,10,2.92529175559067,16.0747082444093
"2010","come rock",10.7357058639205,19,9,10,2.92529175559067,16.0747082444093
"2010","deep love deep",10.7357058639205,19,9,10,2.92529175559067,16.0747082444093
"2010","get put",10.7357058639205,19,9,10,2.92529175559067,16.0747082444093
"2010","going make",10.7357058639205,19,9,10,2.92529175559067,16.0747082444093
"2010","like im gonna",10.7357058639205,19,9,10,2.92529175559067,16.0747082444093
"2010","think theres",10.7357058639205,19,9,10,2.92529175559067,16.0747082444093
"2010","youre coming",10.7357058639205,19,9,10,2.92529175559067,16.0747082444093
"2000","come can",10.7251694661962,31,17,14,8.34165630358633,22.6583436964137
"2000","got new",10.7251694661962,31,17,14,8.34165630358633,22.6583436964137
"2000","life time",10.7251694661962,31,17,14,8.34165630358633,22.6583436964137
"1970","picked",10.7044512848149,46,15,31,6.29500302478251,39.7049969752175
"1980","im falling",10.6857716841182,91,28,63,15.3094512155656,75.6905487844344
"1990","dare",10.6825754060685,67,26,41,14.2136946272786,52.7863053727214
"1980","gonna get",10.6712674197769,272,67,205,45.7601179190532,226.239882080947
"1960","old",10.6681657490031,730,66,664,43.597989576798,686.402010423202
"1980","dont look",10.6625584047579,70,23,47,11.7765009350505,58.2234990649496
"2000","dirty",10.6583931783616,244,89,155,65.6569076798408,178.343092320159
"1970","youre mine",10.6579579581162,60,18,42,8.21087351058588,51.7891264894141
"1980","wont",10.6552932884163,2313,449,1864,389.129238039596,1923.8707619604
"1990","dont know dont know",10.6537701524889,57,23,34,12.0922476679833,44.9077523320167
"1990","love wanna",10.6537701524889,57,23,34,12.0922476679833,44.9077523320167
"1970","go youre",10.6523515157838,33,12,21,4.51598043082223,28.4840195691778
"1970","now shake",10.6497384351121,21,9,12,2.87380572870506,18.1261942712949
"1970","sleepin",10.6497384351121,21,9,12,2.87380572870506,18.1261942712949
"1970","somebody somebody",10.6497384351121,21,9,12,2.87380572870506,18.1261942712949
"1960","day night",10.6360214388039,70,12,58,4.18062913750118,65.8193708624988
"1980","dont want see",10.6357748291723,21,10,11,3.53295028051514,17.4670497194849
"1980","jukebox",10.6357748291723,21,10,11,3.53295028051514,17.4670497194849
"1980","keep holding",10.6357748291723,21,10,11,3.53295028051514,17.4670497194849
"1980","never felt way",10.6357748291723,21,10,11,3.53295028051514,17.4670497194849
"1980","said wanna",10.6357748291723,21,10,11,3.53295028051514,17.4670497194849
"1980","see much",10.6357748291723,21,10,11,3.53295028051514,17.4670497194849
"1980","tell heart",10.6357748291723,21,10,11,3.53295028051514,17.4670497194849
"2000","wide",10.6260405969835,166,64,102,44.6682240772687,121.331775922731
"2000","cant even",10.6242935231081,74,33,41,19.9123408537222,54.0876591462778
"2000","doors",10.6242935231081,74,33,41,19.9123408537222,54.0876591462778
"2000","make sure",10.6242935231081,74,33,41,19.9123408537222,54.0876591462778
"1990","blind see",10.6161009492503,23,12,11,4.87932800637923,18.1206719936208
"1990","candlelight",10.6161009492503,23,12,11,4.87932800637923,18.1206719936208
"1990","language",10.6161009492503,23,12,11,4.87932800637923,18.1206719936208
"1990","look see",10.6161009492503,23,12,11,4.87932800637923,18.1206719936208
"1990","love together",10.6161009492503,23,12,11,4.87932800637923,18.1206719936208
"1990","mission",10.6161009492503,23,12,11,4.87932800637923,18.1206719936208
"1990","tell will",10.6161009492503,23,12,11,4.87932800637923,18.1206719936208
"1990","way im feeling",10.6161009492503,23,12,11,4.87932800637923,18.1206719936208
"1990","white boy",10.6161009492503,23,12,11,4.87932800637923,18.1206719936208
"1980","come lets",10.6133867515533,50,18,32,8.4117863821789,41.5882136178211
"1980","love strong",10.6133867515533,50,18,32,8.4117863821789,41.5882136178211
"1960","youve",10.6072309254782,1117,94,1023,66.7108963798402,1050.28910362016
"1990","got feeling",10.6053952134912,95,34,61,20.1537461133055,74.8462538866945
"1990","never knew",10.60432783156,135,45,90,28.6395339504868,106.360466049513
"2010","bar",10.6020590200226,172,43,129,26.4815885242945,145.518411475706
"1960","choose",10.5842436008143,120,17,103,7.16679280714487,112.833207192855
"1960","although",10.5842277191475,61,11,50,3.64311967696531,57.3568803230347
"1960","now oh",10.5842277191475,61,11,50,3.64311967696531,57.3568803230347
"1980","gonna stop",10.5834408798241,62,21,41,10.4306151139018,51.5693848860982
"1980","let go dont",10.5834408798241,62,21,41,10.4306151139018,51.5693848860982
"1990","can treat",10.5797007176827,15,9,6,3.18217043894297,11.817829561057
"1990","good yeah",10.5797007176827,15,9,6,3.18217043894297,11.817829561057
"1990","head now",10.5797007176827,15,9,6,3.18217043894297,11.817829561057
"1990","looking eyes",10.5797007176827,15,9,6,3.18217043894297,11.817829561057
"1990","made us",10.5797007176827,15,9,6,3.18217043894297,11.817829561057
"1990","passenger",10.5797007176827,15,9,6,3.18217043894297,11.817829561057
"1990","piece mind",10.5797007176827,15,9,6,3.18217043894297,11.817829561057
"1990","play little",10.5797007176827,15,9,6,3.18217043894297,11.817829561057
"1990","wanna lay",10.5797007176827,15,9,6,3.18217043894297,11.817829561057
"1990","whenever need",10.5797007176827,15,9,6,3.18217043894297,11.817829561057
"1990","will yes",10.5797007176827,15,9,6,3.18217043894297,11.817829561057
"1970","walk away",10.5781471224485,170,39,131,23.2641416133266,146.735858386673
"1980","cant tell",10.5779902280172,54,19,35,9.08472929275321,44.9152707072468
"1980","day just",10.5779902280172,54,19,35,9.08472929275321,44.9152707072468
"1980","lovei",10.5779902280172,54,19,35,9.08472929275321,44.9152707072468
"2000","know wanna",10.5717836766411,100,42,58,26.9085687212462,73.0914312787538
"1970","get home",10.5701040871533,65,19,46,8.89511296980137,56.1048870301986
"1980","human",10.5696871158071,58,20,38,9.75767220332752,48.2423277966725
"2000","back club",10.5670235038142,17,11,6,4.57445668261186,12.4255433173881
"2000","blind love",10.5670235038142,17,11,6,4.57445668261186,12.4255433173881
"2000","d e",10.5670235038142,17,11,6,4.57445668261186,12.4255433173881
"2000","even get",10.5670235038142,17,11,6,4.57445668261186,12.4255433173881
"2000","give dont give",10.5670235038142,17,11,6,4.57445668261186,12.4255433173881
"2000","morei",10.5670235038142,17,11,6,4.57445668261186,12.4255433173881
"2000","move im",10.5670235038142,17,11,6,4.57445668261186,12.4255433173881
"2000","please stay",10.5670235038142,17,11,6,4.57445668261186,12.4255433173881
"2000","see later",10.5670235038142,17,11,6,4.57445668261186,12.4255433173881
"2000","six feet",10.5670235038142,17,11,6,4.57445668261186,12.4255433173881
"2000","take know",10.5670235038142,17,11,6,4.57445668261186,12.4255433173881
"2000","thing say",10.5670235038142,17,11,6,4.57445668261186,12.4255433173881
"2000","trips",10.5670235038142,17,11,6,4.57445668261186,12.4255433173881
"2000","youre falling",10.5670235038142,17,11,6,4.57445668261186,12.4255433173881
"1990","alive cause",10.5622415170274,8,6,2,1.69715756743625,6.30284243256375
"1990","baby really want",10.5622415170274,8,6,2,1.69715756743625,6.30284243256375
"1990","best just",10.5622415170274,8,6,2,1.69715756743625,6.30284243256375
"1990","blue every",10.5622415170274,8,6,2,1.69715756743625,6.30284243256375
"1990","call name ill",10.5622415170274,8,6,2,1.69715756743625,6.30284243256375
"1990","can right",10.5622415170274,8,6,2,1.69715756743625,6.30284243256375
"1990","cant face",10.5622415170274,8,6,2,1.69715756743625,6.30284243256375
"1990","close one",10.5622415170274,8,6,2,1.69715756743625,6.30284243256375
"1990","concentrate",10.5622415170274,8,6,2,1.69715756743625,6.30284243256375
"1990","cry one",10.5622415170274,8,6,2,1.69715756743625,6.30284243256375
"1990","dig way",10.5622415170274,8,6,2,1.69715756743625,6.30284243256375
"1990","dont wanna say",10.5622415170274,8,6,2,1.69715756743625,6.30284243256375
"1990","end always",10.5622415170274,8,6,2,1.69715756743625,6.30284243256375
"1990","faint",10.5622415170274,8,6,2,1.69715756743625,6.30284243256375
"1990","found one",10.5622415170274,8,6,2,1.69715756743625,6.30284243256375
"1990","funky yeah",10.5622415170274,8,6,2,1.69715756743625,6.30284243256375
"1990","hand love",10.5622415170274,8,6,2,1.69715756743625,6.30284243256375
"1990","happyi",10.5622415170274,8,6,2,1.69715756743625,6.30284243256375
"1990","hey said",10.5622415170274,8,6,2,1.69715756743625,6.30284243256375
"1990","hot let",10.5622415170274,8,6,2,1.69715756743625,6.30284243256375
"1990","im nothing",10.5622415170274,8,6,2,1.69715756743625,6.30284243256375
"1990","know dont wanna",10.5622415170274,8,6,2,1.69715756743625,6.30284243256375
"1990","lets show",10.5622415170274,8,6,2,1.69715756743625,6.30284243256375
"1990","life just begun",10.5622415170274,8,6,2,1.69715756743625,6.30284243256375
"1990","like disco",10.5622415170274,8,6,2,1.69715756743625,6.30284243256375
"1990","lots money",10.5622415170274,8,6,2,1.69715756743625,6.30284243256375
"1990","man whats",10.5622415170274,8,6,2,1.69715756743625,6.30284243256375
"1990","mind way",10.5622415170274,8,6,2,1.69715756743625,6.30284243256375
"1990","mind world",10.5622415170274,8,6,2,1.69715756743625,6.30284243256375
"1990","moreim",10.5622415170274,8,6,2,1.69715756743625,6.30284243256375
"1990","moth",10.5622415170274,8,6,2,1.69715756743625,6.30284243256375
"1990","nowhow",10.5622415170274,8,6,2,1.69715756743625,6.30284243256375
"1990","oh just wanna",10.5622415170274,8,6,2,1.69715756743625,6.30284243256375
"1990","one foot",10.5622415170274,8,6,2,1.69715756743625,6.30284243256375
"1990","pain let",10.5622415170274,8,6,2,1.69715756743625,6.30284243256375
"1990","right come come",10.5622415170274,8,6,2,1.69715756743625,6.30284243256375
"1990","room feel",10.5622415170274,8,6,2,1.69715756743625,6.30284243256375
"1990","runnin back",10.5622415170274,8,6,2,1.69715756743625,6.30284243256375
"1990","say stop",10.5622415170274,8,6,2,1.69715756743625,6.30284243256375
"1990","see boy",10.5622415170274,8,6,2,1.69715756743625,6.30284243256375
"1990","share dreams",10.5622415170274,8,6,2,1.69715756743625,6.30284243256375
"1990","tearing us",10.5622415170274,8,6,2,1.69715756743625,6.30284243256375
"1990","tears fall",10.5622415170274,8,6,2,1.69715756743625,6.30284243256375
"1990","time ooh",10.5622415170274,8,6,2,1.69715756743625,6.30284243256375
"1990","used knew",10.5622415170274,8,6,2,1.69715756743625,6.30284243256375
"1990","walk awayits",10.5622415170274,8,6,2,1.69715756743625,6.30284243256375
"1990","wanna share",10.5622415170274,8,6,2,1.69715756743625,6.30284243256375
"1990","want without",10.5622415170274,8,6,2,1.69715756743625,6.30284243256375
"1990","worth price",10.5622415170274,8,6,2,1.69715756743625,6.30284243256375
"1990","ya know im",10.5622415170274,8,6,2,1.69715756743625,6.30284243256375
"1990","yeah yeah yeah hey",10.5622415170274,8,6,2,1.69715756743625,6.30284243256375
"1990","youi will",10.5622415170274,8,6,2,1.69715756743625,6.30284243256375
"1990","youre black",10.5622415170274,8,6,2,1.69715756743625,6.30284243256375
"1980","dont let go",10.5593568005653,100,30,70,16.8235727643578,83.1764272356422
"1990","finally found",10.5590074689192,41,18,23,8.6979325331108,32.3020674668892
"1970","rocket",10.5573131529717,29,11,18,3.96858886344984,25.0314111365502
"1970","sing sing",10.5573131529717,29,11,18,3.96858886344984,25.0314111365502
"1970","till day",10.5573131529717,29,11,18,3.96858886344984,25.0314111365502
"1970","tom",10.5573131529717,29,11,18,3.96858886344984,25.0314111365502
"1980","come baby",10.5540189746863,177,47,130,29.7777237929133,147.222276207087
"1960","baby baby love",10.5481052334486,28,7,21,1.67225165500047,26.3277483449995
"1960","long can",10.5481052334486,28,7,21,1.67225165500047,26.3277483449995
"1960","love every",10.5481052334486,28,7,21,1.67225165500047,26.3277483449995
"1960","love gave",10.5481052334486,28,7,21,1.67225165500047,26.3277483449995
"1960","love woman",10.5481052334486,28,7,21,1.67225165500047,26.3277483449995
"2010","fore",10.5432810891782,30,12,18,4.61888171935369,25.3811182806463
"2010","now make",10.5432810891782,30,12,18,4.61888171935369,25.3811182806463
"2010","thats alright",10.5432810891782,30,12,18,4.61888171935369,25.3811182806463
"1970","boys girls",10.5420520689837,25,10,15,3.42119729607745,21.5788027039226
"1970","oh wow",10.5420520689837,25,10,15,3.42119729607745,21.5788027039226
"1970","ooo baby baby",10.5420520689837,25,10,15,3.42119729607745,21.5788027039226
"1970","thats left",10.5420520689837,25,10,15,3.42119729607745,21.5788027039226
"1970","tomorrow",10.54045982135,279,58,221,38.1805618242243,240.819438175776
"1960","baby baby ooo",10.5365109361552,21,6,15,1.25418874125035,19.7458112587496
"1960","baby roll",10.5365109361552,21,6,15,1.25418874125035,19.7458112587496
"1960","every day every",10.5365109361552,21,6,15,1.25418874125035,19.7458112587496
"1960","love fall",10.5365109361552,21,6,15,1.25418874125035,19.7458112587496
"1960","now shake",10.5365109361552,21,6,15,1.25418874125035,19.7458112587496
"1960","rain oh",10.5365109361552,21,6,15,1.25418874125035,19.7458112587496
"1960","stop cant",10.5365109361552,21,6,15,1.25418874125035,19.7458112587496
"1960","sue",10.5365109361552,21,6,15,1.25418874125035,19.7458112587496
"1960","thing ever",10.5365109361552,21,6,15,1.25418874125035,19.7458112587496
"2010","kids",10.5336921416007,213,51,162,32.7940602074112,180.205939792589
"1980","couldve",10.5327398960691,35,14,21,5.88825046752523,29.1117495324748
"1980","just long",10.5327398960691,35,14,21,5.88825046752523,29.1117495324748
"2000","cant say",10.5139871625177,63,29,34,16.9523982943851,46.0476017056149
"1960","bound",10.5139652695602,80,13,67,4.77786187142992,75.2221381285701
"1980","alone",10.5050762789539,975,203,772,164.029834452488,810.970165547512
"1970","couldnt get",10.4968212122783,51,16,35,6.97924248399799,44.020757516002
"1970","come join",10.4965732996708,14,7,7,1.91587048580337,12.0841295141966
"1970","daisy",10.4965732996708,14,7,7,1.91587048580337,12.0841295141966
"1970","dixie",10.4965732996708,14,7,7,1.91587048580337,12.0841295141966
"1970","dues",10.4965732996708,14,7,7,1.91587048580337,12.0841295141966
"1970","got place",10.4965732996708,14,7,7,1.91587048580337,12.0841295141966
"1970","light eyes",10.4965732996708,14,7,7,1.91587048580337,12.0841295141966
"1970","mine cant",10.4965732996708,14,7,7,1.91587048580337,12.0841295141966
"1970","morning sun",10.4965732996708,14,7,7,1.91587048580337,12.0841295141966
"1970","sometimes think",10.4965732996708,14,7,7,1.91587048580337,12.0841295141966
"1970","think better",10.4965732996708,14,7,7,1.91587048580337,12.0841295141966
"1970","time leave",10.4965732996708,14,7,7,1.91587048580337,12.0841295141966
"1970","time want",10.4965732996708,14,7,7,1.91587048580337,12.0841295141966
"1970","world wont",10.4965732996708,14,7,7,1.91587048580337,12.0841295141966
"1980","around think",10.4948716567603,12,7,5,2.01882873172294,9.98117126827706
"1980","away long",10.4948716567603,12,7,5,2.01882873172294,9.98117126827706
"1980","boy tell",10.4948716567603,12,7,5,2.01882873172294,9.98117126827706
"1980","craze",10.4948716567603,12,7,5,2.01882873172294,9.98117126827706
"1980","defeated",10.4948716567603,12,7,5,2.01882873172294,9.98117126827706
"1980","eyes go",10.4948716567603,12,7,5,2.01882873172294,9.98117126827706
"1980","free tonight",10.4948716567603,12,7,5,2.01882873172294,9.98117126827706
"1980","getting stronger",10.4948716567603,12,7,5,2.01882873172294,9.98117126827706
"1980","hear cant",10.4948716567603,12,7,5,2.01882873172294,9.98117126827706
"1980","hear youre",10.4948716567603,12,7,5,2.01882873172294,9.98117126827706
"1980","im excited",10.4948716567603,12,7,5,2.01882873172294,9.98117126827706
"1980","intend",10.4948716567603,12,7,5,2.01882873172294,9.98117126827706
"1980","long find",10.4948716567603,12,7,5,2.01882873172294,9.98117126827706
"1980","mine aint",10.4948716567603,12,7,5,2.01882873172294,9.98117126827706
"1980","need find",10.4948716567603,12,7,5,2.01882873172294,9.98117126827706
"1980","never dreamed",10.4948716567603,12,7,5,2.01882873172294,9.98117126827706
"1980","right hold",10.4948716567603,12,7,5,2.01882873172294,9.98117126827706
"1980","rockin night",10.4948716567603,12,7,5,2.01882873172294,9.98117126827706
"1980","say tell",10.4948716567603,12,7,5,2.01882873172294,9.98117126827706
"1980","show want",10.4948716567603,12,7,5,2.01882873172294,9.98117126827706
"1980","tempt",10.4948716567603,12,7,5,2.01882873172294,9.98117126827706
"1980","voice can",10.4948716567603,12,7,5,2.01882873172294,9.98117126827706
"1980","ya gonna",10.4948716567603,12,7,5,2.01882873172294,9.98117126827706
"1990","cant change",10.487285189713,64,25,39,13.57726053949,50.42273946051
"1990","hold hand",10.487285189713,64,25,39,13.57726053949,50.42273946051
"1990","la da",10.487285189713,64,25,39,13.57726053949,50.42273946051
"2000","drunk",10.4858273191274,145,57,88,39.017424645807,105.982575354193
"1990","every single day",10.4737109254003,38,17,21,8.0614984453222,29.9385015546778
"2000","step",10.4730877251611,552,183,369,148.535299341279,403.464700658721
"1990","cheated",10.468462635757,26,13,13,5.51576209416782,20.4842379058322
"1990","goes thats",10.468462635757,26,13,13,5.51576209416782,20.4842379058322
"1990","hold tight dont",10.468462635757,26,13,13,5.51576209416782,20.4842379058322
"1990","hypnotize",10.468462635757,26,13,13,5.51576209416782,20.4842379058322
"1960","hurry",10.465361129758,142,19,123,8.4807048217881,133.519295178212
"2010","wont let go",10.4646173203152,46,16,30,7.08228530300899,38.917714696991
"1970","got go",10.4628003269874,42,14,28,5.74761145741011,36.2523885425899
"1980","finer things",10.4454177481016,18,9,9,3.0282430975844,14.9717569024156
"1980","now find",10.4454177481016,18,9,9,3.0282430975844,14.9717569024156
"1980","now ive got",10.4454177481016,18,9,9,3.0282430975844,14.9717569024156
"1980","right let",10.4454177481016,18,9,9,3.0282430975844,14.9717569024156
"1980","tommy",10.4454177481016,18,9,9,3.0282430975844,14.9717569024156
"1980","yeah yeah yeah im",10.4454177481016,18,9,9,3.0282430975844,14.9717569024156
"1980","youre running",10.4454177481016,18,9,9,3.0282430975844,14.9717569024156
"1990","hold",10.4374363884679,1726,422,1304,366.161745174372,1359.83825482563
"2010","love oh oh",10.4353317832623,34,13,21,5.23473261526751,28.7652673847325
"2010","baby please dont go",10.4310760910609,16,8,8,2.4634035836553,13.5365964163447
"2010","getting older",10.4310760910609,16,8,8,2.4634035836553,13.5365964163447
"2010","go insane",10.4310760910609,16,8,8,2.4634035836553,13.5365964163447
"2010","go said",10.4310760910609,16,8,8,2.4634035836553,13.5365964163447
"2010","gotta see",10.4310760910609,16,8,8,2.4634035836553,13.5365964163447
"2010","hear em",10.4310760910609,16,8,8,2.4634035836553,13.5365964163447
"2010","heart hope",10.4310760910609,16,8,8,2.4634035836553,13.5365964163447
"2010","im older",10.4310760910609,16,8,8,2.4634035836553,13.5365964163447
"2010","need aint",10.4310760910609,16,8,8,2.4634035836553,13.5365964163447
"2010","see good",10.4310760910609,16,8,8,2.4634035836553,13.5365964163447
"2010","take high",10.4310760910609,16,8,8,2.4634035836553,13.5365964163447
"2010","watch fall",10.4310760910609,16,8,8,2.4634035836553,13.5365964163447
"1980","im waiting",10.4290841061876,28,12,16,4.71060037402018,23.2893996259798
"1980","lettin",10.4290841061876,28,12,16,4.71060037402018,23.2893996259798
"1980","live forever",10.4290841061876,28,12,16,4.71060037402018,23.2893996259798
"1980","night time",10.4290841061876,28,12,16,4.71060037402018,23.2893996259798
"1980","one good",10.4290841061876,28,12,16,4.71060037402018,23.2893996259798
"1980","restless",10.4290841061876,28,12,16,4.71060037402018,23.2893996259798
"2000","cap",10.4242156256875,24,14,10,6.45805649309909,17.5419435069009
"2000","didnt see",10.4242156256875,24,14,10,6.45805649309909,17.5419435069009
"2000","ya just",10.4242156256875,24,14,10,6.45805649309909,17.5419435069009
"2000","youre back",10.4242156256875,24,14,10,6.45805649309909,17.5419435069009
"2010","bite",10.4236856242992,81,24,57,12.470980642255,68.529019357745
"1960","higher",10.4214571978602,233,27,206,13.9155227005396,219.08447729946
"1990","really",10.4136586359296,1880,457,1423,398.832028347519,1481.16797165248
"1990","alone dont",10.4134822586902,35,16,19,7.42506435753361,27.5749356424664
"1990","dont want dont",10.4134822586902,35,16,19,7.42506435753361,27.5749356424664
"1990","one ever",10.4134822586902,35,16,19,7.42506435753361,27.5749356424664
"2010","want oh",10.4121519783627,42,15,27,6.46643440709516,35.5335655929048
"1960","youll see",10.4032473942641,121,17,104,7.22651608053775,113.773483919462
"1970","bring",10.401164836633,896,157,739,122.615711091416,773.384288908584
"1990","eternal",10.3988058873113,29,14,15,6.15219618195642,22.8478038180436
"1990","man like",10.3988058873113,29,14,15,6.15219618195642,22.8478038180436
"2010","nobody nobody",10.3981033945449,38,14,24,5.85058351118134,32.1494164888187
"1960","last time",10.3860040574071,71,12,59,4.24035241089405,66.759647589106
"1980","sugar",10.3854195603845,254,63,191,42.7318748214688,211.268125178531
"1990","hammer",10.3852514553875,32,15,17,6.78863026974501,25.211369730255
"1990","just close",10.3852514553875,32,15,17,6.78863026974501,25.211369730255
"1990","theres nothing can",10.3852514553875,32,15,17,6.78863026974501,25.211369730255
"2000","sip",10.3810770310782,83,36,47,22.3341120386344,60.6658879613656
"2000","messed",10.3806238839086,39,20,19,10.494341801286,28.505658198714
"1990","sayin",10.3705582336539,181,57,124,38.3981899632452,142.601810036755
"1980","break chains",10.3694138649937,15,8,7,2.52353591465367,12.4764640853463
"1980","cuddle",10.3694138649937,15,8,7,2.52353591465367,12.4764640853463
"1980","gonna cause",10.3694138649937,15,8,7,2.52353591465367,12.4764640853463
"1980","ill run",10.3694138649937,15,8,7,2.52353591465367,12.4764640853463
"1980","love baby just",10.3694138649937,15,8,7,2.52353591465367,12.4764640853463
"1980","never much",10.3694138649937,15,8,7,2.52353591465367,12.4764640853463
"1980","take look around",10.3694138649937,15,8,7,2.52353591465367,12.4764640853463
"1980","takes night",10.3694138649937,15,8,7,2.52353591465367,12.4764640853463
"1980","talk just",10.3694138649937,15,8,7,2.52353591465367,12.4764640853463
"1980","want kiss",10.3694138649937,15,8,7,2.52353591465367,12.4764640853463
"1980","yes true",10.3694138649937,15,8,7,2.52353591465367,12.4764640853463
"2010","shoot",10.3661389980294,95,27,68,14.6264587779533,80.3735412220467
"1990","son",10.3606816795224,208,64,144,44.1260967533426,163.873903246657
"2000","know make",10.3598737010972,55,26,29,14.7997127966854,40.2002872033146
"1970","time got",10.3485903514759,56,17,39,7.66348194321348,48.3365180567865
"1970","truly",10.3485903514759,56,17,39,7.66348194321348,48.3365180567865
"1980","might well",10.343853591824,39,15,24,6.56119337809954,32.4388066219005
"1960","girl youre",10.3366087964073,132,18,114,7.88347208785936,124.116527912141
"2010","always mine",10.3298386261276,10,6,4,1.53962723978456,8.46037276021544
"2010","areand",10.3298386261276,10,6,4,1.53962723978456,8.46037276021544
"2010","around cause youre",10.3298386261276,10,6,4,1.53962723978456,8.46037276021544
"2010","baby goes",10.3298386261276,10,6,4,1.53962723978456,8.46037276021544
"2010","bout every",10.3298386261276,10,6,4,1.53962723978456,8.46037276021544
"2010","bout get",10.3298386261276,10,6,4,1.53962723978456,8.46037276021544
"2010","cause told",10.3298386261276,10,6,4,1.53962723978456,8.46037276021544
"2010","chains love",10.3298386261276,10,6,4,1.53962723978456,8.46037276021544
"2010","come come now",10.3298386261276,10,6,4,1.53962723978456,8.46037276021544
"2010","day day day",10.3298386261276,10,6,4,1.53962723978456,8.46037276021544
"2010","drippin",10.3298386261276,10,6,4,1.53962723978456,8.46037276021544
"2010","fourth july",10.3298386261276,10,6,4,1.53962723978456,8.46037276021544
"2010","go deep",10.3298386261276,10,6,4,1.53962723978456,8.46037276021544
"2010","got away",10.3298386261276,10,6,4,1.53962723978456,8.46037276021544
"2010","im stronger",10.3298386261276,10,6,4,1.53962723978456,8.46037276021544
"2010","issues",10.3298386261276,10,6,4,1.53962723978456,8.46037276021544
"2010","just one touch",10.3298386261276,10,6,4,1.53962723978456,8.46037276021544
"2010","know happiness",10.3298386261276,10,6,4,1.53962723978456,8.46037276021544
"2010","know im one",10.3298386261276,10,6,4,1.53962723978456,8.46037276021544
"2010","like summer",10.3298386261276,10,6,4,1.53962723978456,8.46037276021544
"2010","now told",10.3298386261276,10,6,4,1.53962723978456,8.46037276021544
"2010","oh oh yeah yeah",10.3298386261276,10,6,4,1.53962723978456,8.46037276021544
"2010","oh thought",10.3298386261276,10,6,4,1.53962723978456,8.46037276021544
"2010","oooooooo",10.3298386261276,10,6,4,1.53962723978456,8.46037276021544
"2010","pitch",10.3298386261276,10,6,4,1.53962723978456,8.46037276021544
"2010","rah",10.3298386261276,10,6,4,1.53962723978456,8.46037276021544
"2010","sky like",10.3298386261276,10,6,4,1.53962723978456,8.46037276021544
"2010","smith",10.3298386261276,10,6,4,1.53962723978456,8.46037276021544
"2010","thats whats",10.3298386261276,10,6,4,1.53962723978456,8.46037276021544
"2010","timeso",10.3298386261276,10,6,4,1.53962723978456,8.46037276021544
"2010","told twice",10.3298386261276,10,6,4,1.53962723978456,8.46037276021544
"2010","tonight oh oh",10.3298386261276,10,6,4,1.53962723978456,8.46037276021544
"2010","turn cant",10.3298386261276,10,6,4,1.53962723978456,8.46037276021544
"2010","want scream",10.3298386261276,10,6,4,1.53962723978456,8.46037276021544
"2010","wouldnt just",10.3298386261276,10,6,4,1.53962723978456,8.46037276021544
"2010","yeah uh huh",10.3298386261276,10,6,4,1.53962723978456,8.46037276021544
"2010","yeah yeah girl",10.3298386261276,10,6,4,1.53962723978456,8.46037276021544
"2010","youre holding",10.3298386261276,10,6,4,1.53962723978456,8.46037276021544
"1960","now can",10.3212165162218,111,16,95,6.62928334660901,104.370716653391
"2000","steady",10.3192465922867,86,37,49,23.1413691002718,62.8586308997282
"2000","tick",10.2968462746333,47,23,24,12.6470272989857,34.3529727010143
"1990","hard say",10.2958814420995,61,24,37,12.9408264517014,48.0591735482986
"2000","aint seen nothing",10.2936736094763,15,10,5,4.03628530818693,10.9637146918131
"2000","brains",10.2936736094763,15,10,5,4.03628530818693,10.9637146918131
"2000","can spend",10.2936736094763,15,10,5,4.03628530818693,10.9637146918131
"2000","floor like",10.2936736094763,15,10,5,4.03628530818693,10.9637146918131
"2000","gotta work",10.2936736094763,15,10,5,4.03628530818693,10.9637146918131
"2000","hustlin",10.2936736094763,15,10,5,4.03628530818693,10.9637146918131
"2000","loves got",10.2936736094763,15,10,5,4.03628530818693,10.9637146918131
"2000","ohhhh",10.2936736094763,15,10,5,4.03628530818693,10.9637146918131
"2000","shell never",10.2936736094763,15,10,5,4.03628530818693,10.9637146918131
"2000","show things",10.2936736094763,15,10,5,4.03628530818693,10.9637146918131
"2000","matter",10.2914830097644,533,177,356,143.422671284242,389.577328715758
"1980","just little",10.281702968453,274,67,207,46.0965893743403,227.90341062566
"2010","always want",10.2755347104963,23,10,13,3.5411426515045,19.4588573484955
"2010","calling name",10.2755347104963,23,10,13,3.5411426515045,19.4588573484955
"2010","know oh oh",10.2755347104963,23,10,13,3.5411426515045,19.4588573484955
"2010","way dont wanna",10.2755347104963,23,10,13,3.5411426515045,19.4588573484955
"2010","ya im",10.2755347104963,23,10,13,3.5411426515045,19.4588573484955
"1990","right right",10.2739602768715,136,45,91,28.8516786464163,107.148321353584
"2000","hold im",10.2725109408206,34,18,16,9.14891336522372,24.8510866347763
"2000","looking like",10.2725109408206,34,18,16,9.14891336522372,24.8510866347763
"2000","talking bout",10.2725109408206,34,18,16,9.14891336522372,24.8510866347763
"2000","want show",10.2725109408206,34,18,16,9.14891336522372,24.8510866347763
"2010","drinks",10.2723123950997,86,25,61,13.2407942621472,72.7592057378528
"1960","can",10.2706986019162,8122,555,7567,485.072426496922,7636.92757350308
"2000","around say",10.2655125724902,29,16,13,7.80348492916141,21.1965150708386
"2000","flashing",10.2655125724902,29,16,13,7.80348492916141,21.1965150708386
"2000","go without",10.2655125724902,29,16,13,7.80348492916141,21.1965150708386
"2000","got big",10.2655125724902,29,16,13,7.80348492916141,21.1965150708386
"2000","show got",10.2655125724902,29,16,13,7.80348492916141,21.1965150708386
"2010","baby baby got",10.256101341157,13,7,6,2.00151541171993,10.9984845882801
"2010","blessings",10.256101341157,13,7,6,2.00151541171993,10.9984845882801
"2010","bruce",10.256101341157,13,7,6,2.00151541171993,10.9984845882801
"2010","ego",10.256101341157,13,7,6,2.00151541171993,10.9984845882801
"2010","hard yeah",10.256101341157,13,7,6,2.00151541171993,10.9984845882801
"2010","hey can",10.256101341157,13,7,6,2.00151541171993,10.9984845882801
"2010","just wanna take",10.256101341157,13,7,6,2.00151541171993,10.9984845882801
"2010","know half",10.256101341157,13,7,6,2.00151541171993,10.9984845882801
"2010","lets roll",10.256101341157,13,7,6,2.00151541171993,10.9984845882801
"2010","mean oh",10.256101341157,13,7,6,2.00151541171993,10.9984845882801
"2010","one think",10.256101341157,13,7,6,2.00151541171993,10.9984845882801
"2010","onso",10.256101341157,13,7,6,2.00151541171993,10.9984845882801
"2010","ooh yeah ooh",10.256101341157,13,7,6,2.00151541171993,10.9984845882801
"2010","rest peace",10.256101341157,13,7,6,2.00151541171993,10.9984845882801
"2010","theres party",10.256101341157,13,7,6,2.00151541171993,10.9984845882801
"2010","theres thing",10.256101341157,13,7,6,2.00151541171993,10.9984845882801
"2010","wont take long",10.256101341157,13,7,6,2.00151541171993,10.9984845882801
"2010","youre ill",10.256101341157,13,7,6,2.00151541171993,10.9984845882801
"1970","turn back",10.2459847061144,61,18,43,8.34772140242897,52.652278597571
"1970","heard",10.2457426067678,586,108,478,80.1928646200554,505.807135379945
"1970","please come",10.2451602750417,38,13,25,5.20021989003772,32.7997801099623
"1970","well dont",10.2451602750417,38,13,25,5.20021989003772,32.7997801099623
"1970","itll",10.2444283386316,133,32,101,18.200769615132,114.799230384868
"1970","friend",10.2326282133094,649,118,531,88.8142818061706,560.185718193829
"2010","id never",10.2306836077301,68,21,47,10.469465230535,57.530534769465
"2010","nobody can",10.2306836077301,68,21,47,10.469465230535,57.530534769465
"1970","make happy",10.2198049988162,47,15,32,6.4318509166256,40.5681490833744
"1970","pillow",10.2198049988162,47,15,32,6.4318509166256,40.5681490833744
"2000","chill",10.2188938582858,92,39,53,24.7558832235465,67.2441167764535
"1980","since youve",10.2184075398808,43,16,27,7.23413628867385,35.7658637113261
"1980","faith",10.1891575457013,146,40,106,24.5624162359624,121.437583764038
"1980","dont ask",10.1803617230356,67,22,45,11.2717937521197,55.7282062478803
"1970","another lonely",10.1800632185948,11,6,5,1.50532681027408,9.49467318972592
"1970","baby still",10.1800632185948,11,6,5,1.50532681027408,9.49467318972592
"1970","breakin rules",10.1800632185948,11,6,5,1.50532681027408,9.49467318972592
"1970","come everybody",10.1800632185948,11,6,5,1.50532681027408,9.49467318972592
"1970","coming right",10.1800632185948,11,6,5,1.50532681027408,9.49467318972592
"1970","dont say dont say",10.1800632185948,11,6,5,1.50532681027408,9.49467318972592
"1970","got future",10.1800632185948,11,6,5,1.50532681027408,9.49467318972592
"1970","ill bet",10.1800632185948,11,6,5,1.50532681027408,9.49467318972592
"1970","know look",10.1800632185948,11,6,5,1.50532681027408,9.49467318972592
"1970","kong",10.1800632185948,11,6,5,1.50532681027408,9.49467318972592
"1970","lord dont",10.1800632185948,11,6,5,1.50532681027408,9.49467318972592
"1970","love just little",10.1800632185948,11,6,5,1.50532681027408,9.49467318972592
"1970","love young",10.1800632185948,11,6,5,1.50532681027408,9.49467318972592
"1970","make try",10.1800632185948,11,6,5,1.50532681027408,9.49467318972592
"1970","man make",10.1800632185948,11,6,5,1.50532681027408,9.49467318972592
"1970","met knew",10.1800632185948,11,6,5,1.50532681027408,9.49467318972592
"1970","recipe",10.1800632185948,11,6,5,1.50532681027408,9.49467318972592
"1970","rode",10.1800632185948,11,6,5,1.50532681027408,9.49467318972592
"1970","sailor",10.1800632185948,11,6,5,1.50532681027408,9.49467318972592
"1970","see cryin",10.1800632185948,11,6,5,1.50532681027408,9.49467318972592
"1970","stumblin",10.1800632185948,11,6,5,1.50532681027408,9.49467318972592
"1970","willow",10.1800632185948,11,6,5,1.50532681027408,9.49467318972592
"1970","youre gonna die",10.1800632185948,11,6,5,1.50532681027408,9.49467318972592
"1960","needs",10.1773687543017,235,27,208,14.0349692473254,220.965030752675
"1990","ecstasy",10.169601325724,48,20,28,10.1829454046175,37.8170545953825
"1980","find way",10.1460079807146,160,43,117,26.9177164229725,133.082283577028
"2000","sit",10.1451735741702,265,95,170,71.3077071113025,193.692292888697
"1960","louder",10.1417166588086,72,12,60,4.30007568428692,67.6999243157131
"1960","poor",10.1417166588086,72,12,60,4.30007568428692,67.6999243157131
"1970","cause ive",10.1411364086467,71,20,51,9.71620032085995,61.2837996791401
"1970","day day",10.1411364086467,71,20,51,9.71620032085995,61.2837996791401
"1970","tell love",10.1381120389964,112,28,84,15.326963886427,96.673036113573
"2000","supposed",10.1375140696873,149,58,91,40.0937673946569,108.906232605343
"1980","resist",10.1328799757323,63,21,42,10.5988508415454,52.4011491584546
"1990","will come",10.1296215619311,107,37,70,22.6994824644599,84.3005175355401
"1970","love life",10.1263837884671,76,21,55,10.4004397800754,65.5995602199246
"1980","fallen",10.1122202060079,32,13,19,5.38354328459449,26.6164567154055
"1980","giving love",10.1122202060079,32,13,19,5.38354328459449,26.6164567154055
"1980","lonely days",10.1122202060079,32,13,19,5.38354328459449,26.6164567154055
"1980","love bad",10.1122202060079,32,13,19,5.38354328459449,26.6164567154055
"1980","wont please",10.1122202060079,32,13,19,5.38354328459449,26.6164567154055
"1990","imagine",10.1089557531256,58,23,35,12.3043923639128,45.6956076360872
"1990","will ever",10.1089557531256,58,23,35,12.3043923639128,45.6956076360872
"1960","find place",10.1074873414961,29,7,22,1.73197492839334,27.2680250716067
"1960","finds",10.1074873414961,29,7,22,1.73197492839334,27.2680250716067
"1960","teardrops",10.1074873414961,29,7,22,1.73197492839334,27.2680250716067
"1960","tell us",10.1074873414961,29,7,22,1.73197492839334,27.2680250716067
"1960","wore",10.1074873414961,29,7,22,1.73197492839334,27.2680250716067
"1980","jean",10.1013306268242,59,20,39,9.9259079309711,49.0740920690289
"1980","wont long",10.1013306268242,59,20,39,9.9259079309711,49.0740920690289
"2000","anymore dont wanna",10.0972803419708,9,7,2,2.42177118491216,6.57822881508784
"2000","around back",10.0972803419708,9,7,2,2.42177118491216,6.57822881508784
"2000","big girls",10.0972803419708,9,7,2,2.42177118491216,6.57822881508784
"2000","body need",10.0972803419708,9,7,2,2.42177118491216,6.57822881508784
"2000","boy say",10.0972803419708,9,7,2,2.42177118491216,6.57822881508784
"2000","bunny",10.0972803419708,9,7,2,2.42177118491216,6.57822881508784
"2000","buy bar",10.0972803419708,9,7,2,2.42177118491216,6.57822881508784
"2000","christina",10.0972803419708,9,7,2,2.42177118491216,6.57822881508784
"2000","cleaning",10.0972803419708,9,7,2,2.42177118491216,6.57822881508784
"2000","dont fooled",10.0972803419708,9,7,2,2.42177118491216,6.57822881508784
"2000","dribble",10.0972803419708,9,7,2,2.42177118491216,6.57822881508784
"2000","even kiss",10.0972803419708,9,7,2,2.42177118491216,6.57822881508784
"2000","even makes",10.0972803419708,9,7,2,2.42177118491216,6.57822881508784
"2000","every time come around",10.0972803419708,9,7,2,2.42177118491216,6.57822881508784
"2000","feel like never",10.0972803419708,9,7,2,2.42177118491216,6.57822881508784
"2000","feeling one",10.0972803419708,9,7,2,2.42177118491216,6.57822881508784
"2000","go eat",10.0972803419708,9,7,2,2.42177118491216,6.57822881508784
"2000","good idea",10.0972803419708,9,7,2,2.42177118491216,6.57822881508784
"2000","got keys",10.0972803419708,9,7,2,2.42177118491216,6.57822881508784
"2000","hard ill",10.0972803419708,9,7,2,2.42177118491216,6.57822881508784
"2000","highly",10.0972803419708,9,7,2,2.42177118491216,6.57822881508784
"2000","just get back",10.0972803419708,9,7,2,2.42177118491216,6.57822881508784
"2000","knew start",10.0972803419708,9,7,2,2.42177118491216,6.57822881508784
"2000","know dont even",10.0972803419708,9,7,2,2.42177118491216,6.57822881508784
"2000","lead right direction",10.0972803419708,9,7,2,2.42177118491216,6.57822881508784
"2000","left without",10.0972803419708,9,7,2,2.42177118491216,6.57822881508784
"2000","lips just",10.0972803419708,9,7,2,2.42177118491216,6.57822881508784
"2000","long keep",10.0972803419708,9,7,2,2.42177118491216,6.57822881508784
"2000","man things",10.0972803419708,9,7,2,2.42177118491216,6.57822881508784
"2000","mis",10.0972803419708,9,7,2,2.42177118491216,6.57822881508784
"2000","please dont tell",10.0972803419708,9,7,2,2.42177118491216,6.57822881508784
"2000","swiss",10.0972803419708,9,7,2,2.42177118491216,6.57822881508784
"2000","tell everyone",10.0972803419708,9,7,2,2.42177118491216,6.57822881508784
"2000","thing wouldnt",10.0972803419708,9,7,2,2.42177118491216,6.57822881508784
"2000","thought one",10.0972803419708,9,7,2,2.42177118491216,6.57822881508784
"2000","tight cause",10.0972803419708,9,7,2,2.42177118491216,6.57822881508784
"2000","windin",10.0972803419708,9,7,2,2.42177118491216,6.57822881508784
"2000","wont worry",10.0972803419708,9,7,2,2.42177118491216,6.57822881508784
"1990","baby turn",10.0941707098158,18,10,8,3.81860452673157,14.1813954732684
"1990","can night",10.0941707098158,18,10,8,3.81860452673157,14.1813954732684
"1990","fightin",10.0941707098158,18,10,8,3.81860452673157,14.1813954732684
"1990","know belong",10.0941707098158,18,10,8,3.81860452673157,14.1813954732684
"1990","one oh",10.0941707098158,18,10,8,3.81860452673157,14.1813954732684
"1990","stand ground",10.0941707098158,18,10,8,3.81860452673157,14.1813954732684
"1990","wanna chill",10.0941707098158,18,10,8,3.81860452673157,14.1813954732684
"1990","wanna fight",10.0941707098158,18,10,8,3.81860452673157,14.1813954732684
"1990","world cant",10.0941707098158,18,10,8,3.81860452673157,14.1813954732684
"2000","alrighti",10.0884437342278,13,9,4,3.49811393376201,9.50188606623799
"2000","big wheels",10.0884437342278,13,9,4,3.49811393376201,9.50188606623799
"2000","burn let",10.0884437342278,13,9,4,3.49811393376201,9.50188606623799
"2000","cool im",10.0884437342278,13,9,4,3.49811393376201,9.50188606623799
"2000","dancei",10.0884437342278,13,9,4,3.49811393376201,9.50188606623799
"2000","doesnt even",10.0884437342278,13,9,4,3.49811393376201,9.50188606623799
"2000","dont ask questions",10.0884437342278,13,9,4,3.49811393376201,9.50188606623799
"2000","free im",10.0884437342278,13,9,4,3.49811393376201,9.50188606623799
"2000","get live",10.0884437342278,13,9,4,3.49811393376201,9.50188606623799
"2000","getcha",10.0884437342278,13,9,4,3.49811393376201,9.50188606623799
"2000","girl must",10.0884437342278,13,9,4,3.49811393376201,9.50188606623799
"2000","gonna treat",10.0884437342278,13,9,4,3.49811393376201,9.50188606623799
"2000","im thinkin bout",10.0884437342278,13,9,4,3.49811393376201,9.50188606623799
"2000","jockin",10.0884437342278,13,9,4,3.49811393376201,9.50188606623799
"2000","oh oh oh ohi",10.0884437342278,13,9,4,3.49811393376201,9.50188606623799
"2000","pain just",10.0884437342278,13,9,4,3.49811393376201,9.50188606623799
"2000","relax mind",10.0884437342278,13,9,4,3.49811393376201,9.50188606623799
"2000","youll think",10.0884437342278,13,9,4,3.49811393376201,9.50188606623799
"2000","alright alright alright",10.0759933385883,50,24,26,13.4542843606231,36.5457156393769
"2000","don",10.0753839661492,42,21,21,11.3015988629234,30.6984011370766
"2000","dont let go dont",10.0753839661492,42,21,21,11.3015988629234,30.6984011370766
"2000","go dont let go",10.0753839661492,42,21,21,11.3015988629234,30.6984011370766
"2000","way get",10.0753839661492,42,21,21,11.3015988629234,30.6984011370766
"1980","baby really",10.073844852944,25,11,14,4.20589319108945,20.7941068089106
"1980","run around",10.073844852944,25,11,14,4.20589319108945,20.7941068089106
"2010","cut",10.0723400025066,236,55,181,36.3352028589157,199.664797141084
"2010","legs",10.0604205378535,82,24,58,12.6249433662334,69.3750566337666
"1970","gangsta lean",10.0595891587013,34,12,22,4.65282832266533,29.3471716773347
"1970","got little",10.0595891587013,34,12,22,4.65282832266533,29.3471716773347
"1970","shootin",10.0595891587013,34,12,22,4.65282832266533,29.3471716773347
"1990","theres nothing",10.0506849745951,186,58,128,39.4589134428929,146.541086557107
"2000","im tryin",10.0472601610875,61,28,33,16.4142269199602,44.5857730800398
"1970","believe im",10.0470169789187,52,16,36,7.11609037584109,44.8839096241589
"1970","better time",10.0348341847603,18,8,10,2.46326205317576,15.5367379468242
"1970","home now",10.0348341847603,18,8,10,2.46326205317576,15.5367379468242
"1970","im gonna stay",10.0348341847603,18,8,10,2.46326205317576,15.5367379468242
"1970","lover lover lover",10.0348341847603,18,8,10,2.46326205317576,15.5367379468242
"1970","never heard",10.0348341847603,18,8,10,2.46326205317576,15.5367379468242
"1960","rain",10.0329053685443,767,68,699,45.8077506923343,721.192249307666
"1990","heart heart",10.0274952276644,45,19,26,9.54651131682892,35.4534886831711
"1990","nite",10.0274952276644,45,19,26,9.54651131682892,35.4534886831711
"1960","michael",10.0265345060269,37,8,29,2.20976111553634,34.7902388844637
"1960","oughta",10.0265345060269,37,8,29,2.20976111553634,34.7902388844637
"1960","umbrella",10.0265345060269,37,8,29,2.20976111553634,34.7902388844637
"2000","caught",10.02182350585,330,115,215,88.7982767801126,241.201723219887
"2010","fall asleep",10.0144685074037,27,11,16,4.15699354741832,22.8430064525817
"2010","group",10.0144685074037,27,11,16,4.15699354741832,22.8430064525817
"2010","know came",10.0144685074037,27,11,16,4.15699354741832,22.8430064525817
"2010","wildest",10.0144685074037,27,11,16,4.15699354741832,22.8430064525817
"2010","now",10.0140961450894,6525,1098,5427,1004.60677395943,5520.39322604057
"1960","peace",10.0122180400945,167,21,146,9.97378665660995,157.02621334339
"2000","can take away",10.0059812204627,22,13,9,5.91988511867417,16.0801148813258
"2000","cant without",10.0059812204627,22,13,9,5.91988511867417,16.0801148813258
"2000","confessions",10.0059812204627,22,13,9,5.91988511867417,16.0801148813258
"2000","enough youre",10.0059812204627,22,13,9,5.91988511867417,16.0801148813258
"2000","fiend",10.0059812204627,22,13,9,5.91988511867417,16.0801148813258
"2000","soon youll",10.0059812204627,22,13,9,5.91988511867417,16.0801148813258
"1960","better place",10.0050805654492,22,6,16,1.31391201464323,20.6860879853568
"1960","cheating",10.0050805654492,22,6,16,1.31391201464323,20.6860879853568
"1960","facts",10.0050805654492,22,6,16,1.31391201464323,20.6860879853568
"1960","get gonna",10.0050805654492,22,6,16,1.31391201464323,20.6860879853568
"1960","let love baby",10.0050805654492,22,6,16,1.31391201464323,20.6860879853568
"1960","yeah id",10.0050805654492,22,6,16,1.31391201464323,20.6860879853568
"2000","aaaa",9.99340323343452,11,8,3,2.95994255933709,8.04005744066292
"2000","around pretty",9.99340323343452,11,8,3,2.95994255933709,8.04005744066292
"2000","baby ill make",9.99340323343452,11,8,3,2.95994255933709,8.04005744066292
"2000","blowed",9.99340323343452,11,8,3,2.95994255933709,8.04005744066292
"2000","cant take cant",9.99340323343452,11,8,3,2.95994255933709,8.04005744066292
"2000","chromed",9.99340323343452,11,8,3,2.95994255933709,8.04005744066292
"2000","comes see",9.99340323343452,11,8,3,2.95994255933709,8.04005744066292
"2000","done got",9.99340323343452,11,8,3,2.95994255933709,8.04005744066292
"2000","everybody sing",9.99340323343452,11,8,3,2.95994255933709,8.04005744066292
"2000","fire make",9.99340323343452,11,8,3,2.95994255933709,8.04005744066292
"2000","four five",9.99340323343452,11,8,3,2.95994255933709,8.04005744066292
"2000","girl oh yeah",9.99340323343452,11,8,3,2.95994255933709,8.04005744066292
"2000","got girls",9.99340323343452,11,8,3,2.95994255933709,8.04005744066292
"2000","grain",9.99340323343452,11,8,3,2.95994255933709,8.04005744066292
"2000","im fun",9.99340323343452,11,8,3,2.95994255933709,8.04005744066292
"2000","let lick",9.99340323343452,11,8,3,2.95994255933709,8.04005744066292
"2000","live cant",9.99340323343452,11,8,3,2.95994255933709,8.04005744066292
"2000","live dont wanna",9.99340323343452,11,8,3,2.95994255933709,8.04005744066292
"2000","love way move",9.99340323343452,11,8,3,2.95994255933709,8.04005744066292
"2000","low oh",9.99340323343452,11,8,3,2.95994255933709,8.04005744066292
"2000","make sound",9.99340323343452,11,8,3,2.95994255933709,8.04005744066292
"2000","mami got",9.99340323343452,11,8,3,2.95994255933709,8.04005744066292
"2000","mind take",9.99340323343452,11,8,3,2.95994255933709,8.04005744066292
"2000","pistol",9.99340323343452,11,8,3,2.95994255933709,8.04005744066292
"2000","pretend youre",9.99340323343452,11,8,3,2.95994255933709,8.04005744066292
"2000","said need",9.99340323343452,11,8,3,2.95994255933709,8.04005744066292
"2000","say way",9.99340323343452,11,8,3,2.95994255933709,8.04005744066292
"2000","sent im",9.99340323343452,11,8,3,2.95994255933709,8.04005744066292
"2000","stink",9.99340323343452,11,8,3,2.95994255933709,8.04005744066292
"2000","take deep breath",9.99340323343452,11,8,3,2.95994255933709,8.04005744066292
"2000","traded",9.99340323343452,11,8,3,2.95994255933709,8.04005744066292
"2000","trying find way",9.99340323343452,11,8,3,2.95994255933709,8.04005744066292
"2000","tuck",9.99340323343452,11,8,3,2.95994255933709,8.04005744066292
"2000","ultimate",9.99340323343452,11,8,3,2.95994255933709,8.04005744066292
"2000","wan",9.99340323343452,11,8,3,2.95994255933709,8.04005744066292
"2000","wanna take clothes",9.99340323343452,11,8,3,2.95994255933709,8.04005744066292
"2000","wat",9.99340323343452,11,8,3,2.95994255933709,8.04005744066292
"2000","whipped",9.99340323343452,11,8,3,2.95994255933709,8.04005744066292
"2000","ya dont know",9.99340323343452,11,8,3,2.95994255933709,8.04005744066292
"1980","free",9.98844672848134,710,152,558,119.44736662694,590.55263337306
"1990","ohoh",9.98340436484332,65,25,40,13.7894052354196,51.2105947645804
"1980","anymore",9.97447705081541,227,57,170,38.1895101750922,188.810489824908
"2010","stay",9.95990168437801,1204,226,978,185.371119670061,1018.62888032994
"1970","mess around",9.95787257919466,43,14,29,5.88445934925321,37.1155406507468
"1970","settle",9.95787257919466,43,14,29,5.88445934925321,37.1155406507468
"1970","ill tell",9.94945899145686,118,29,89,16.1480512374856,101.851948762514
"2010","go ahead",9.94470441395561,101,28,73,15.5502351218241,85.4497648781759
"2000","lets get",9.93913067013467,269,96,173,72.3840498601524,196.615950139848
"1990","problems",9.92478939452123,86,31,55,18.2444438499397,67.7555561500603
"2010","mean",9.92298529902416,746,147,599,114.856192087928,631.143807912072
"1990","bank",9.92085072324261,72,27,45,15.2744181069263,56.7255818930737
"1970","need ya",9.91825501316733,30,11,19,4.10543675529294,25.8945632447071
"2000","girl dont",9.91646997889919,165,63,102,44.3991383900563,120.600861609944
"1980","share",9.90318309005346,237,59,178,39.871867451528,197.128132548472
"2000","boyz",9.90223017734667,37,19,18,9.9561704268611,27.0438295731389
"2000","youre hot",9.90223017734667,37,19,18,9.9561704268611,27.0438295731389
"1990","gotta move",9.89840058735264,42,18,24,8.91007722904033,33.0899227709597
"1990","never want",9.89840058735264,42,18,24,8.91007722904033,33.0899227709597
"1980","late",9.89712376215935,421,96,325,70.8272413379463,350.172758662054
"2010","good time",9.89632656124345,175,43,132,26.9434766962299,148.05652330377
"2010","lane",9.88967643988918,60,19,41,9.23776343870738,50.7622365612926
"2000","time say",9.88627802592897,53,25,28,14.2615414222605,38.7384585777395
"1970","bright",9.88349809021154,277,57,220,37.9068660405381,239.093133959462
"2000","im crazy",9.87973629659273,84,36,48,22.6031977258468,61.3968022741532
"1960","sunday",9.87788470827456,103,15,88,6.15149715946602,96.848502840534
"2010","im giving",9.87759895260204,31,12,19,4.77284444333215,26.2271555566679
"2010","lip",9.87759895260204,31,12,19,4.77284444333215,26.2271555566679
"2010","love hate",9.87759895260204,31,12,19,4.77284444333215,26.2271555566679
"2010","aim",9.87583548780777,43,15,28,6.62039713107362,36.3796028689264
"2010","boy know",9.87583548780777,43,15,28,6.62039713107362,36.3796028689264
"2010","whoa ooh",9.87583548780777,43,15,28,6.62039713107362,36.3796028689264
"1990","always friend",9.8689561463423,13,8,5,2.75788104708391,10.2421189529161
"1990","besides",9.8689561463423,13,8,5,2.75788104708391,10.2421189529161
"1990","compares",9.8689561463423,13,8,5,2.75788104708391,10.2421189529161
"1990","cotton",9.8689561463423,13,8,5,2.75788104708391,10.2421189529161
"1990","cry tears",9.8689561463423,13,8,5,2.75788104708391,10.2421189529161
"1990","find ive",9.8689561463423,13,8,5,2.75788104708391,10.2421189529161
"1990","friend like",9.8689561463423,13,8,5,2.75788104708391,10.2421189529161
"1990","get fuck",9.8689561463423,13,8,5,2.75788104708391,10.2421189529161
"1990","heaven oh",9.8689561463423,13,8,5,2.75788104708391,10.2421189529161
"1990","im cried",9.8689561463423,13,8,5,2.75788104708391,10.2421189529161
"1990","knowledge",9.8689561463423,13,8,5,2.75788104708391,10.2421189529161
"1990","mind money money",9.8689561463423,13,8,5,2.75788104708391,10.2421189529161
"1990","oh things",9.8689561463423,13,8,5,2.75788104708391,10.2421189529161
"1990","right right now",9.8689561463423,13,8,5,2.75788104708391,10.2421189529161
"1990","rights",9.8689561463423,13,8,5,2.75788104708391,10.2421189529161
"1990","say im sorry",9.8689561463423,13,8,5,2.75788104708391,10.2421189529161
"1990","wanna alone",9.8689561463423,13,8,5,2.75788104708391,10.2421189529161
"1990","wanna know wanna",9.8689561463423,13,8,5,2.75788104708391,10.2421189529161
"1990","wanna youre",9.8689561463423,13,8,5,2.75788104708391,10.2421189529161
"1990","will dont",9.8689561463423,13,8,5,2.75788104708391,10.2421189529161
"1990","yeah good",9.8689561463423,13,8,5,2.75788104708391,10.2421189529161
"1990","yeah youll",9.8689561463423,13,8,5,2.75788104708391,10.2421189529161
"1970","give want",9.85906526746453,22,9,13,3.01065362054815,18.9893463794518
"1970","good lord",9.85906526746453,22,9,13,3.01065362054815,18.9893463794518
"1970","one try",9.85906526746453,22,9,13,3.01065362054815,18.9893463794518
"1970","wander",9.85906526746453,22,9,13,3.01065362054815,18.9893463794518
"2010","fallin love",9.85197068479738,78,23,55,12.0090924703196,65.9909075296804
"2010","fly",9.83780820829988,764,150,614,117.627521119541,646.372478880459
"2010","go go go go",9.83284008138164,69,21,48,10.6234279545135,58.3765720454865
"2010","cups",9.8314739894796,20,9,11,3.07925447956913,16.9207455204309
"2010","haze",9.8314739894796,20,9,11,3.07925447956913,16.9207455204309
"2010","hunt",9.8314739894796,20,9,11,3.07925447956913,16.9207455204309
"2010","just fun",9.8314739894796,20,9,11,3.07925447956913,16.9207455204309
"2010","wildest dreams",9.8314739894796,20,9,11,3.07925447956913,16.9207455204309
"2010","will never change",9.8314739894796,20,9,11,3.07925447956913,16.9207455204309
"2010","worried",9.82843424005727,39,14,25,6.0045462351598,32.9954537648402
"1970","oh night",9.8275139726844,87,23,64,11.9057665903495,75.0942334096505
"2010","just dream",9.82379243399528,35,13,22,5.38869533924597,29.611304660754
"2010","show show",9.82379243399528,35,13,22,5.38869533924597,29.611304660754
"2000","depend",9.81801193601053,45,22,23,12.1088559245608,32.8911440754392
"2000","grand",9.81801193601053,45,22,23,12.1088559245608,32.8911440754392
"1990","hand can",9.81497968373986,21,11,10,4.45503861452016,16.5449613854798
"1990","lie cause",9.81497968373986,21,11,10,4.45503861452016,16.5449613854798
"1990","make break",9.81497968373986,21,11,10,4.45503861452016,16.5449613854798
"1990","place world",9.81497968373986,21,11,10,4.45503861452016,16.5449613854798
"1990","rain oh",9.81497968373986,21,11,10,4.45503861452016,16.5449613854798
"1990","said loved",9.81497968373986,21,11,10,4.45503861452016,16.5449613854798
"1990","stop cant",9.81497968373986,21,11,10,4.45503861452016,16.5449613854798
"1990","youve got love",9.81497968373986,21,11,10,4.45503861452016,16.5449613854798
"2000","fed",9.8088542586732,27,15,12,7.26531355473648,19.7346864452635
"2000","girl one",9.8088542586732,27,15,12,7.26531355473648,19.7346864452635
"2000","junk",9.8088542586732,27,15,12,7.26531355473648,19.7346864452635
"2000","oh ohi",9.8088542586732,27,15,12,7.26531355473648,19.7346864452635
"2000","titties",9.8088542586732,27,15,12,7.26531355473648,19.7346864452635
"2000","way hey",9.8088542586732,27,15,12,7.26531355473648,19.7346864452635
"2000","work body",9.8088542586732,27,15,12,7.26531355473648,19.7346864452635
"1960","minds",9.7919331141722,64,11,53,3.82228949714393,60.1777105028561
"1960","theres just",9.7919331141722,64,11,53,3.82228949714393,60.1777105028561
"1970","telephone",9.77888422993369,77,21,56,10.5372876719185,66.4627123280815
"1970","night",9.77751627144639,3598,558,3040,492.378714851466,3105.62128514853
"1970","bump",9.77603660903221,108,27,81,14.7795723190546,93.2204276809454
"1970","taken",9.77603660903221,108,27,81,14.7795723190546,93.2204276809454
"1980","still cant",9.75692545713048,40,15,25,6.72942910574312,33.2705708942569
"1970","instrumental",9.75511248665604,48,15,33,6.5686988084687,41.4313011915313
"1970","wont get",9.75511248665604,48,15,33,6.5686988084687,41.4313011915313
"1980","another girl",9.75232526873834,22,10,12,3.70118600815871,18.2988139918413
"1980","irresistible",9.75232526873834,22,10,12,3.70118600815871,18.2988139918413
"1980","know real",9.75232526873834,22,10,12,3.70118600815871,18.2988139918413
"1980","life never",9.75232526873834,22,10,12,3.70118600815871,18.2988139918413
"1980","longest",9.75232526873834,22,10,12,3.70118600815871,18.2988139918413
"1980","love around",9.75232526873834,22,10,12,3.70118600815871,18.2988139918413
"1980","need im",9.75232526873834,22,10,12,3.70118600815871,18.2988139918413
"1980","oh right",9.75232526873834,22,10,12,3.70118600815871,18.2988139918413
"1980","world youre",9.75232526873834,22,10,12,3.70118600815871,18.2988139918413
"1990","around im",9.75157559078657,52,21,31,11.0315241883356,40.9684758116644
"1990","burned",9.75157559078657,52,21,31,11.0315241883356,40.9684758116644
"2010","nothing",9.74906874769735,1236,231,1005,190.297926837372,1045.70207316263
"1990","can",9.74899598098759,8122,1839,6283,1723.03922033966,6398.96077966034
"2010","fill",9.74110106515107,191,46,145,29.4068802798852,161.593119720115
"2010","go baby",9.7347346205498,56,18,38,8.62191254279355,47.3780874572064
"2010","meaning byamandah",9.7347346205498,56,18,38,8.62191254279355,47.3780874572064
"2010","meaning byamandah editor",9.7347346205498,56,18,38,8.62191254279355,47.3780874572064
"1990","hold tight",9.72541406919508,149,48,101,31.6095596935002,117.3904403065
"2000","tonights",9.72273756539004,56,26,30,15.0687984838979,40.9312015161021
"2000","deal",9.72033882249077,96,40,56,25.8322259723964,70.1677740276036
"1960","last",9.71897640593905,827,72,755,49.3911470959067,777.608852904093
"1970","fortune",9.71545744648827,39,13,26,5.33706778188082,33.6629322181192
"1970","well thats",9.71545744648827,39,13,26,5.33706778188082,33.6629322181192
"1970","youll know",9.71545744648827,39,13,26,5.33706778188082,33.6629322181192
"2000","rhymes",9.71446215785739,70,31,39,18.8359981048724,51.1640018951276
"1990","join",9.70875257097458,69,26,43,14.6379840191377,54.3620159808623
"2010","dont wanna",9.70861333533546,771,151,620,118.70526018739,652.29473981261
"1960","happened",9.705811596804,125,17,108,7.46540917410924,117.534590825891
"1980","around oh",9.70420553262221,29,12,17,4.87883610166376,24.1211638983362
"1980","dont wanna lose",9.70420553262221,29,12,17,4.87883610166376,24.1211638983362
"1980","end time",9.70420553262221,29,12,17,4.87883610166376,24.1211638983362
"1980","forever will",9.70420553262221,29,12,17,4.87883610166376,24.1211638983362
"1980","get life",9.70420553262221,29,12,17,4.87883610166376,24.1211638983362
"1980","ive always",9.70420553262221,29,12,17,4.87883610166376,24.1211638983362
"1980","wanna lose",9.70420553262221,29,12,17,4.87883610166376,24.1211638983362
"2000","probably",9.70094604716476,138,54,84,37.1338248353198,100.86617516468
"2000","two three",9.69530126100077,99,41,58,26.6394830340338,72.3605169659662
"1990","baby cant see",9.69197438846676,36,16,20,7.63720905346314,28.3627909465369
"1990","drops",9.69197438846676,36,16,20,7.63720905346314,28.3627909465369
"1960","eyed",9.68883068002675,30,7,23,1.79169820178622,28.2083017982138
"1960","man love",9.68883068002675,30,7,23,1.79169820178622,28.2083017982138
"1980","love want",9.68602746493515,125,35,90,21.0294659554472,103.970534044553
"1960","hold one",9.66975877707751,38,8,30,2.26948438892921,35.7305156110708
"1960","like say",9.66975877707751,38,8,30,2.26948438892921,35.7305156110708
"1960","ya baby",9.66975877707751,38,8,30,2.26948438892921,35.7305156110708
"1980","im gonna get",9.66960391989815,44,16,28,7.40237201631743,36.5976279836826
"1990","girl gonna",9.66319627916027,24,12,12,5.09147270230876,18.9085272976912
"1990","got soul",9.66319627916027,24,12,12,5.09147270230876,18.9085272976912
"1990","oh heaven",9.66319627916027,24,12,12,5.09147270230876,18.9085272976912
"1990","stay together",9.66319627916027,24,12,12,5.09147270230876,18.9085272976912
"1990","will stand",9.66319627916027,24,12,12,5.09147270230876,18.9085272976912
"2000","cause cant",9.64797129546901,108,44,64,29.0612542189459,78.9387457810541
"2010","ooh whoa",9.64762755027371,65,20,45,10.0075770585997,54.9924229414003
"2010","gonna miss",9.64750355703419,74,22,52,11.3932415744058,62.6067584255942
"2010","will will",9.64750355703419,74,22,52,11.3932415744058,62.6067584255942
"2010","locked",9.63353401016154,102,28,74,15.7041978458025,86.2958021541975
"2010","smack",9.63353401016154,102,28,74,15.7041978458025,86.2958021541975
"1980","finger",9.62747045438014,94,28,66,15.8141583984963,78.1858416015037
"1980","lines",9.62747045438014,94,28,66,15.8141583984963,78.1858416015037
"1990","feel pain",9.62386142465549,33,15,18,7.00077496567454,25.9992250343255
"1990","heart know",9.62386142465549,33,15,18,7.00077496567454,25.9992250343255
"1990","make little",9.62386142465549,33,15,18,7.00077496567454,25.9992250343255
"1990","suppose",9.62386142465549,33,15,18,7.00077496567454,25.9992250343255
"1980","youre fine",9.62317886550526,48,17,31,8.07531492689174,39.9246850731083
"1970","everybodys",9.62181161143745,152,35,117,20.8008795601509,131.199120439849
"1980","words say",9.61926394523633,56,19,37,9.42120074804036,46.5787992519596
"1970","headed",9.61431153834154,53,16,37,7.25293826768419,45.7470617323158
"2000","blonde",9.60028789070241,20,12,8,5.38171374424925,14.6182862557508
"2000","curves",9.60028789070241,20,12,8,5.38171374424925,14.6182862557508
"2000","cuz im",9.60028789070241,20,12,8,5.38171374424925,14.6182862557508
"2000","girl come",9.60028789070241,20,12,8,5.38171374424925,14.6182862557508
"2000","let work",9.60028789070241,20,12,8,5.38171374424925,14.6182862557508
"2000","like told",9.60028789070241,20,12,8,5.38171374424925,14.6182862557508
"2000","princess",9.60028789070241,20,12,8,5.38171374424925,14.6182862557508
"2000","pullin",9.60028789070241,20,12,8,5.38171374424925,14.6182862557508
"2000","stay home",9.60028789070241,20,12,8,5.38171374424925,14.6182862557508
"2000","stomach",9.60028789070241,20,12,8,5.38171374424925,14.6182862557508
"2000","undress",9.60028789070241,20,12,8,5.38171374424925,14.6182862557508
"2000","wont even",9.60028789070241,20,12,8,5.38171374424925,14.6182862557508
"2000","boyfriend",9.59954926547384,48,23,25,12.9161129861982,35.0838870138018
"1980","aint gonna",9.59836731716679,139,38,101,23.3847661424573,115.615233857543
"1990","beat heart",9.59609544439017,27,13,14,5.72790679009735,21.2720932099026
"1990","get knees",9.59609544439017,27,13,14,5.72790679009735,21.2720932099026
"1990","pro",9.59609544439017,27,13,14,5.72790679009735,21.2720932099026
"1990","want world",9.59609544439017,27,13,14,5.72790679009735,21.2720932099026
"2010","im afraid",9.59322316007711,52,17,35,8.00606164687973,43.9939383531203
"1990","better way",9.58833586592676,30,14,16,6.36434087788595,23.6356591221141
"1990","cant dance",9.58833586592676,30,14,16,6.36434087788595,23.6356591221141
"1990","every now",9.58833586592676,30,14,16,6.36434087788595,23.6356591221141
"1990","move body",9.58833586592676,30,14,16,6.36434087788595,23.6356591221141
"1990","one loves",9.58833586592676,30,14,16,6.36434087788595,23.6356591221141
"1990","thati",9.58833586592676,30,14,16,6.36434087788595,23.6356591221141
"1990","youll love",9.58833586592676,30,14,16,6.36434087788595,23.6356591221141
"1970","romance",9.5877831183725,114,28,86,15.6006596701132,98.3993403298868
"1970","love love love",9.58695361285721,381,74,307,52.1390467922203,328.86095320778
"1990","fade away",9.58309638796679,49,20,29,10.3950901005471,38.604909899453
"1990","shared",9.58309638796679,49,20,29,10.3950901005471,38.604909899453
"1980","lost",9.57270677784562,635,137,498,106.829687053672,528.170312946328
"1970","hes",9.55146814994601,841,147,694,115.089077040045,725.910922959955
"1960","hey hey hey hey",9.54238172109568,159,20,139,9.49600046946696,149.503999530533
"1980","now love",9.5320282681933,77,24,53,12.9541510285555,64.0458489714445
"1970","yellow",9.52230692921254,158,36,122,21.6219669112095,136.378033088791
"1990","oh night",9.51413235151454,87,31,56,18.4565885458693,68.5434114541307
"1970","breakin",9.51188638345909,88,23,65,12.0426144821926,75.9573855178074
"1970","celebrate",9.51188638345909,88,23,65,12.0426144821926,75.9573855178074
"1960","away baby",9.50779128078206,23,6,17,1.3736352880361,21.6263647119639
"1960","day every day",9.50779128078206,23,6,17,1.3736352880361,21.6263647119639
"1960","girls love",9.50779128078206,23,6,17,1.3736352880361,21.6263647119639
"1960","never loved",9.50779128078206,23,6,17,1.3736352880361,21.6263647119639
"1960","time goes",9.50779128078206,23,6,17,1.3736352880361,21.6263647119639
"2010","go night",9.50099043947391,24,10,14,3.69510537548295,20.3048946245171
"1970","high like",9.49893520996298,35,12,23,4.78967621450843,30.2103237854916
"1960","youd better",9.49747922369273,47,9,38,2.80699384946508,44.1930061505349
"2000","neck",9.49602103695834,79,34,45,21.2577692897845,57.7422307102155
"2000","now just",9.49602103695834,79,34,45,21.2577692897845,57.7422307102155
"2010","death",9.48436174932635,93,26,67,14.3185333299964,78.6814666700036
"1980","heart ill",9.48019170146807,19,9,10,3.19647882522798,15.803521174772
"1980","miss much",9.48019170146807,19,9,10,3.19647882522798,15.803521174772
"1980","now world",9.48019170146807,19,9,10,3.19647882522798,15.803521174772
"1980","oh oh just",9.48019170146807,19,9,10,3.19647882522798,15.803521174772
"1980","prove love",9.48019170146807,19,9,10,3.19647882522798,15.803521174772
"1980","thing every",9.48019170146807,19,9,10,3.19647882522798,15.803521174772
"1980","time gonna",9.48019170146807,19,9,10,3.19647882522798,15.803521174772
"1980","together oh",9.48019170146807,19,9,10,3.19647882522798,15.803521174772
"1980","true never",9.48019170146807,19,9,10,3.19647882522798,15.803521174772
"1980","will tell",9.48019170146807,19,9,10,3.19647882522798,15.803521174772
"1980","youdo",9.48019170146807,19,9,10,3.19647882522798,15.803521174772
"1970","pie",9.47540820119451,44,14,30,6.02130724109631,37.9786927589037
"1960","trick",9.47344813122673,56,10,46,3.34450331000094,52.6554966899991
"1970","give keep",9.47132377258139,15,7,8,2.05271837764647,12.9472816223535
"1970","id really",9.47132377258139,15,7,8,2.05271837764647,12.9472816223535
"1970","like fire",9.47132377258139,15,7,8,2.05271837764647,12.9472816223535
"1970","much get",9.47132377258139,15,7,8,2.05271837764647,12.9472816223535
"1970","plant",9.47132377258139,15,7,8,2.05271837764647,12.9472816223535
"1970","right behind",9.47132377258139,15,7,8,2.05271837764647,12.9472816223535
"1970","someone elses",9.47132377258139,15,7,8,2.05271837764647,12.9472816223535
"1970","want dance",9.47132377258139,15,7,8,2.05271837764647,12.9472816223535
"2010","pink",9.46835106502921,48,16,32,7.3902107509659,40.6097892490341
"1990","dreamed",9.4659595120801,73,27,46,15.4865628028558,57.5134371971442
"1990","minute",9.46135054892681,251,74,177,53.2483186783124,197.751681321688
"2000","got right",9.45914255229529,62,28,34,16.6833126071727,45.3166873928273
"1980","everybody needs",9.45884107183791,33,13,20,5.55177901223807,27.4482209877619
"1980","well together",9.45884107183791,33,13,20,5.55177901223807,27.4482209877619
"1970","help",9.44723282857464,765,135,630,104.68863725997,660.31136274003
"2000","homies",9.44221128883486,82,35,47,22.0650263514219,59.9349736485781
"1960","whoop",9.44153516756348,75,12,63,4.47924550446555,70.5207544955345
"2010","dont know youre going",9.43802294770791,17,8,9,2.61736630763376,14.3826336923662
"2010","everyday like",9.43802294770791,17,8,9,2.61736630763376,14.3826336923662
"2010","friends dont",9.43802294770791,17,8,9,2.61736630763376,14.3826336923662
"2010","im moving",9.43802294770791,17,8,9,2.61736630763376,14.3826336923662
"2010","im sleeping",9.43802294770791,17,8,9,2.61736630763376,14.3826336923662
"2010","im stuck",9.43802294770791,17,8,9,2.61736630763376,14.3826336923662
"2010","im top",9.43802294770791,17,8,9,2.61736630763376,14.3826336923662
"2010","life yeah",9.43802294770791,17,8,9,2.61736630763376,14.3826336923662
"2010","love told",9.43802294770791,17,8,9,2.61736630763376,14.3826336923662
"2010","reppin",9.43802294770791,17,8,9,2.61736630763376,14.3826336923662
"2010","roll roll roll",9.43802294770791,17,8,9,2.61736630763376,14.3826336923662
"2010","shining bright",9.43802294770791,17,8,9,2.61736630763376,14.3826336923662
"2010","stares",9.43802294770791,17,8,9,2.61736630763376,14.3826336923662
"2010","sucks",9.43802294770791,17,8,9,2.61736630763376,14.3826336923662
"1990","come",9.43449652274529,4867,1121,3746,1032.50823508903,3834.49176491097
"2000","knocks",9.42399498724289,35,18,17,9.41799905243618,25.5820009475638
"2000","see cant",9.42399498724289,35,18,17,9.41799905243618,25.5820009475638
"2000","without dont",9.42399498724289,35,18,17,9.41799905243618,25.5820009475638
"1980","now know",9.42152857613739,177,46,131,29.7777237929133,147.222276207087
"1970","wrong",9.42138721964648,946,163,783,129.458105683571,816.541894316429
"2000","hes got",9.41316822118233,51,24,27,13.7233700478356,37.2766299521644
"1980","baby love baby love",9.40208600612072,10,6,4,1.68235727643578,8.31764272356422
"1980","boys get",9.40208600612072,10,6,4,1.68235727643578,8.31764272356422
"1980","dance life",9.40208600612072,10,6,4,1.68235727643578,8.31764272356422
"1980","day let",9.40208600612072,10,6,4,1.68235727643578,8.31764272356422
"1980","dont feel good",9.40208600612072,10,6,4,1.68235727643578,8.31764272356422
"1980","dont think time",9.40208600612072,10,6,4,1.68235727643578,8.31764272356422
"1980","enough wanna",9.40208600612072,10,6,4,1.68235727643578,8.31764272356422
"1980","feel tell",9.40208600612072,10,6,4,1.68235727643578,8.31764272356422
"1980","girl id",9.40208600612072,10,6,4,1.68235727643578,8.31764272356422
"1980","got lots",9.40208600612072,10,6,4,1.68235727643578,8.31764272356422
"1980","im boy",9.40208600612072,10,6,4,1.68235727643578,8.31764272356422
"1980","im shy",9.40208600612072,10,6,4,1.68235727643578,8.31764272356422
"1980","im soldier",9.40208600612072,10,6,4,1.68235727643578,8.31764272356422
"1980","im steppin",9.40208600612072,10,6,4,1.68235727643578,8.31764272356422
"1980","ive forgotten",9.40208600612072,10,6,4,1.68235727643578,8.31764272356422
"1980","long wanna",9.40208600612072,10,6,4,1.68235727643578,8.31764272356422
"1980","loving cant",9.40208600612072,10,6,4,1.68235727643578,8.31764272356422
"1980","much youre",9.40208600612072,10,6,4,1.68235727643578,8.31764272356422
"1980","must something",9.40208600612072,10,6,4,1.68235727643578,8.31764272356422
"1980","night alone",9.40208600612072,10,6,4,1.68235727643578,8.31764272356422
"1980","night long wanna",9.40208600612072,10,6,4,1.68235727643578,8.31764272356422
"1980","privacy",9.40208600612072,10,6,4,1.68235727643578,8.31764272356422
"1980","real time",9.40208600612072,10,6,4,1.68235727643578,8.31764272356422
"1980","rev",9.40208600612072,10,6,4,1.68235727643578,8.31764272356422
"1980","standing alone",9.40208600612072,10,6,4,1.68235727643578,8.31764272356422
"1980","sun rain",9.40208600612072,10,6,4,1.68235727643578,8.31764272356422
"1980","think ever",9.40208600612072,10,6,4,1.68235727643578,8.31764272356422
"1980","tonight gotta",9.40208600612072,10,6,4,1.68235727643578,8.31764272356422
"1980","wake wake",9.40208600612072,10,6,4,1.68235727643578,8.31764272356422
"1980","wont feel",9.40208600612072,10,6,4,1.68235727643578,8.31764272356422
"1970","much",9.39895732011699,1552,255,1297,212.387928140488,1339.61207185951
"1990","every",9.39747431326481,2061,495,1566,437.230218310765,1623.76978168924
"1990","shes gone",9.39438592000206,56,22,34,11.8801029720538,44.1198970279462
"1980","can see",9.39025931153122,450,101,349,75.7060774396101,374.29392256039
"1980","special",9.37378368424344,201,51,150,33.8153812563592,167.184618743641
"1960","hold tight",9.36798681209242,149,19,130,8.89876773553822,140.101232264462
"2000","cause need",9.3573637038533,88,37,51,23.6795404746967,64.3204595253033
"2000","definitely",9.35592047120599,25,14,11,6.72714218031156,18.2728578196884
"2000","love boy",9.35592047120599,25,14,11,6.72714218031156,18.2728578196884
"2000","loving loving",9.35592047120599,25,14,11,6.72714218031156,18.2728578196884
"2000","thats good",9.35592047120599,25,14,11,6.72714218031156,18.2728578196884
"2000","want ya",9.35592047120599,25,14,11,6.72714218031156,18.2728578196884
"2000","wayne",9.35592047120599,25,14,11,6.72714218031156,18.2728578196884
"1980","another one",9.3535503876206,69,22,47,11.6082652074069,57.3917347925931
"2000","beer",9.35330167744677,65,29,36,17.49056966881,47.50943033119
"1970","songs",9.35200039134454,187,41,146,25.5905557746593,161.409444225341
"2000","let go dont let",9.33926560623178,43,21,22,11.5706845501359,31.4293154498641
"2000","cant pretend",9.32866783774752,30,16,14,8.07257061637387,21.9274293836261
"2000","vibe",9.32866783774752,30,16,14,8.07257061637387,21.9274293836261
"1960","yeah yeah",9.32865707497826,1719,134,1585,102.66430696235,1616.33569303765
"1960","kiss kiss",9.32702441058964,39,8,31,2.32920766232208,36.6707923376779
"1960","please dont go",9.32702441058964,39,8,31,2.32920766232208,36.6707923376779
"2010","cause heart",9.32700500577524,28,11,17,4.31095627139678,23.6890437286032
"2010","high high",9.32700500577524,28,11,17,4.31095627139678,23.6890437286032
"2010","love hard",9.32700500577524,28,11,17,4.31095627139678,23.6890437286032
"2010","way baby",9.32700500577524,28,11,17,4.31095627139678,23.6890437286032
"1970","eagle",9.31782966529914,31,11,20,4.24228464713604,26.757715352864
"1970","mind cant",9.31782966529914,31,11,20,4.24228464713604,26.757715352864
"1990","dont ever wanna",9.31687775563631,16,9,7,3.39431513487251,12.6056848651275
"1990","everythings gonna",9.31687775563631,16,9,7,3.39431513487251,12.6056848651275
"1990","friendship",9.31687775563631,16,9,7,3.39431513487251,12.6056848651275
"1990","god must",9.31687775563631,16,9,7,3.39431513487251,12.6056848651275
"1990","gon gon",9.31687775563631,16,9,7,3.39431513487251,12.6056848651275
"1990","happily",9.31687775563631,16,9,7,3.39431513487251,12.6056848651275
"1990","ill work",9.31687775563631,16,9,7,3.39431513487251,12.6056848651275
"1990","rear",9.31687775563631,16,9,7,3.39431513487251,12.6056848651275
"1990","springtime",9.31687775563631,16,9,7,3.39431513487251,12.6056848651275
"1990","together just",9.31687775563631,16,9,7,3.39431513487251,12.6056848651275
"1990","youre something",9.31687775563631,16,9,7,3.39431513487251,12.6056848651275
"1980","goes thats",9.31292933267637,26,11,15,4.37412891873303,21.625871081267
"1990","feel",9.30556741973828,3697,861,2836,784.298940851478,2912.70105914852
"1980","baby say",9.2987950322132,37,14,23,6.22472192281238,30.7752780771876
"1980","can show",9.2987950322132,37,14,23,6.22472192281238,30.7752780771876
"1980","every move",9.2987950322132,37,14,23,6.22472192281238,30.7752780771876
"1980","oni",9.2987950322132,37,14,23,6.22472192281238,30.7752780771876
"1960","love baby love",9.29657360390789,66,11,55,3.94173604392968,62.0582639560703
"1990","never find",9.29386228865773,102,35,67,21.6387589848122,80.3612410151878
"1990","step step",9.29116352939543,63,24,39,13.3651158435605,49.6348841564395
"1960","love babe",9.29047893970699,31,7,24,1.85142147517909,29.1485785248209
"1960","now feel",9.29047893970699,31,7,24,1.85142147517909,29.1485785248209
"1960","thing baby",9.29047893970699,31,7,24,1.85142147517909,29.1485785248209
"2010","cry just",9.28749876047262,40,14,26,6.15850895913825,33.8414910408617
"2010","wouldnt change",9.28749876047262,40,14,26,6.15850895913825,33.8414910408617
"1980","helps",9.28481577609034,16,8,8,2.69177164229725,13.3082283577028
"1980","hold tonight",9.28481577609034,16,8,8,2.69177164229725,13.3082283577028
"1980","just goes",9.28481577609034,16,8,8,2.69177164229725,13.3082283577028
"1980","lasts forever",9.28481577609034,16,8,8,2.69177164229725,13.3082283577028
"1980","like knife",9.28481577609034,16,8,8,2.69177164229725,13.3082283577028
"1980","night cant",9.28481577609034,16,8,8,2.69177164229725,13.3082283577028
"1980","star see",9.28481577609034,16,8,8,2.69177164229725,13.3082283577028
"1980","think wanna",9.28481577609034,16,8,8,2.69177164229725,13.3082283577028
"1980","turn back time",9.28481577609034,16,8,8,2.69177164229725,13.3082283577028
"2010","missing",9.28191015826856,188,45,143,28.9449921079498,159.05500789205
"2010","shouldve",9.28190014257202,75,22,53,11.5472042983842,63.4527957016158
"2010","yea",9.27684459860915,272,61,211,41.8778609221401,230.12213907786
"1990","wanna stay",9.27352762074047,43,18,25,9.12222192496986,33.8777780750301
"1980","know much",9.26864368869749,82,25,57,13.7953296667734,68.2046703332266
"2000","anything want",9.26175519245626,68,30,38,18.2978267304474,49.7021732695526
"2000","whoa whoa",9.26123231139667,167,63,104,44.9373097644812,122.062690235519
"1990","someday",9.25767236545127,143,46,97,30.336691517923,112.663308482077
"2010","give everything",9.25331480459715,66,20,46,10.1615397825781,55.8384602174219
"2010","miami",9.25270130304433,32,12,20,4.9268071673106,27.0731928326894
"2010","dont worry",9.2517847170916,183,44,139,28.1751784880575,154.824821511943
"1990","freaky",9.24847581416937,70,26,44,14.8501287150672,55.1498712849328
"1990","just know",9.24847581416937,70,26,44,14.8501287150672,55.1498712849328
"2010","baby please dont",9.24604287210011,36,13,23,5.54265806322443,30.4573419367756
"1960","guitar",9.24494024572323,96,14,82,5.7334342457159,90.2665657542841
"2000","wanna take",9.24021872165864,118,47,71,31.7521110910705,86.2478889089295
"1980","away give",9.2190948736683,13,7,6,2.18706445936651,10.8129355406335
"1980","billie",9.2190948736683,13,7,6,2.18706445936651,10.8129355406335
"1980","border",9.2190948736683,13,7,6,2.18706445936651,10.8129355406335
"1980","cry dont cry dont",9.2190948736683,13,7,6,2.18706445936651,10.8129355406335
"1980","desires",9.2190948736683,13,7,6,2.18706445936651,10.8129355406335
"1980","dont cry dont cry",9.2190948736683,13,7,6,2.18706445936651,10.8129355406335
"1980","ever come",9.2190948736683,13,7,6,2.18706445936651,10.8129355406335
"1980","feel coming",9.2190948736683,13,7,6,2.18706445936651,10.8129355406335
"1980","gonna fly",9.2190948736683,13,7,6,2.18706445936651,10.8129355406335
"1980","hide im",9.2190948736683,13,7,6,2.18706445936651,10.8129355406335
"1980","joker",9.2190948736683,13,7,6,2.18706445936651,10.8129355406335
"1980","lights sweet",9.2190948736683,13,7,6,2.18706445936651,10.8129355406335
"1980","love everybody",9.2190948736683,13,7,6,2.18706445936651,10.8129355406335
"1980","never free",9.2190948736683,13,7,6,2.18706445936651,10.8129355406335
"1980","never wanted",9.2190948736683,13,7,6,2.18706445936651,10.8129355406335
"1980","oh oh girl",9.2190948736683,13,7,6,2.18706445936651,10.8129355406335
"1980","oh oh hes",9.2190948736683,13,7,6,2.18706445936651,10.8129355406335
"1980","passions",9.2190948736683,13,7,6,2.18706445936651,10.8129355406335
"1980","reaches",9.2190948736683,13,7,6,2.18706445936651,10.8129355406335
"1980","side oh",9.2190948736683,13,7,6,2.18706445936651,10.8129355406335
"1980","though dont",9.2190948736683,13,7,6,2.18706445936651,10.8129355406335
"1980","time good",9.2190948736683,13,7,6,2.18706445936651,10.8129355406335
"1980","tonight will",9.2190948736683,13,7,6,2.18706445936651,10.8129355406335
"1980","true theres",9.2190948736683,13,7,6,2.18706445936651,10.8129355406335
"1980","wanna run away",9.2190948736683,13,7,6,2.18706445936651,10.8129355406335
"1980","wild free",9.2190948736683,13,7,6,2.18706445936651,10.8129355406335
"1980","world oh",9.2190948736683,13,7,6,2.18706445936651,10.8129355406335
"1980","billy",9.21606346939657,61,20,41,10.2623793862583,50.7376206137417
"2000","need",9.21494426151583,3735,1088,2647,1005.03504173855,2729.96495826145
"2000","anything can",9.21144046404525,18,11,7,4.84354236982432,13.1564576301757
"2000","around make",9.21144046404525,18,11,7,4.84354236982432,13.1564576301757
"2000","cause everybody",9.21144046404525,18,11,7,4.84354236982432,13.1564576301757
"2000","cook",9.21144046404525,18,11,7,4.84354236982432,13.1564576301757
"2000","hot make",9.21144046404525,18,11,7,4.84354236982432,13.1564576301757
"2000","know miss",9.21144046404525,18,11,7,4.84354236982432,13.1564576301757
"2000","las",9.21144046404525,18,11,7,4.84354236982432,13.1564576301757
"2000","lover ill",9.21144046404525,18,11,7,4.84354236982432,13.1564576301757
"2000","said go",9.21144046404525,18,11,7,4.84354236982432,13.1564576301757
"2000","us im",9.21144046404525,18,11,7,4.84354236982432,13.1564576301757
"2000","want love dont",9.21144046404525,18,11,7,4.84354236982432,13.1564576301757
"2000","well still",9.21144046404525,18,11,7,4.84354236982432,13.1564576301757
"2000","whats left",9.21144046404525,18,11,7,4.84354236982432,13.1564576301757
"1970","get dont",9.21140899924914,40,13,27,5.47391567372392,34.5260843262761
"1960","prayer",9.20773195547045,86,13,73,5.13620151178716,80.8637984882128
"1990","beggin",9.20675224835617,53,21,32,11.2436688842652,41.7563311157348
"1990","knees",9.20504461122151,197,60,137,41.7925050981177,155.207494901882
"1970","always get",9.19585909902734,19,8,11,2.60010994501886,16.3998900549811
"1970","day yeah",9.19585909902734,19,8,11,2.60010994501886,16.3998900549811
"1970","deep love deep",9.19585909902734,19,8,11,2.60010994501886,16.3998900549811
"1970","easy love",9.19585909902734,19,8,11,2.60010994501886,16.3998900549811
"1970","fight fight",9.19585909902734,19,8,11,2.60010994501886,16.3998900549811
"1970","gonna sing",9.19585909902734,19,8,11,2.60010994501886,16.3998900549811
"1970","just reach",9.19585909902734,19,8,11,2.60010994501886,16.3998900549811
"1970","radar",9.19585909902734,19,8,11,2.60010994501886,16.3998900549811
"1970","remember day",9.19585909902734,19,8,11,2.60010994501886,16.3998900549811
"1970","repeat chorus",9.19585909902734,19,8,11,2.60010994501886,16.3998900549811
"1970","wont keep",9.19585909902734,19,8,11,2.60010994501886,16.3998900549811
"1990","achieve",9.19374154445676,11,7,4,2.33359165522485,8.66640834477515
"1990","blind let",9.19374154445676,11,7,4,2.33359165522485,8.66640834477515
"1990","cry ill",9.19374154445676,11,7,4,2.33359165522485,8.66640834477515
"1990","days ive",9.19374154445676,11,7,4,2.33359165522485,8.66640834477515
"1990","days since",9.19374154445676,11,7,4,2.33359165522485,8.66640834477515
"1990","feeli",9.19374154445676,11,7,4,2.33359165522485,8.66640834477515
"1990","fool love",9.19374154445676,11,7,4,2.33359165522485,8.66640834477515
"1990","get get dont",9.19374154445676,11,7,4,2.33359165522485,8.66640834477515
"1990","gonna win",9.19374154445676,11,7,4,2.33359165522485,8.66640834477515
"1990","hots",9.19374154445676,11,7,4,2.33359165522485,8.66640834477515
"1990","im wishin",9.19374154445676,11,7,4,2.33359165522485,8.66640834477515
"1990","inside just",9.19374154445676,11,7,4,2.33359165522485,8.66640834477515
"1990","know someone",9.19374154445676,11,7,4,2.33359165522485,8.66640834477515
"1990","mariah",9.19374154445676,11,7,4,2.33359165522485,8.66640834477515
"1990","nowand",9.19374154445676,11,7,4,2.33359165522485,8.66640834477515
"1990","responsible",9.19374154445676,11,7,4,2.33359165522485,8.66640834477515
"1990","save soul",9.19374154445676,11,7,4,2.33359165522485,8.66640834477515
"1990","see truth",9.19374154445676,11,7,4,2.33359165522485,8.66640834477515
"1990","shes little",9.19374154445676,11,7,4,2.33359165522485,8.66640834477515
"1990","shes shes",9.19374154445676,11,7,4,2.33359165522485,8.66640834477515
"1990","shoulder cry",9.19374154445676,11,7,4,2.33359165522485,8.66640834477515
"1990","stains",9.19374154445676,11,7,4,2.33359165522485,8.66640834477515
"1990","till feel",9.19374154445676,11,7,4,2.33359165522485,8.66640834477515
"1990","wanna please",9.19374154445676,11,7,4,2.33359165522485,8.66640834477515
"1990","want meet",9.19374154445676,11,7,4,2.33359165522485,8.66640834477515
"1990","will never end",9.19374154445676,11,7,4,2.33359165522485,8.66640834477515
"1990","woman man",9.19374154445676,11,7,4,2.33359165522485,8.66640834477515
"1990","wouldnt last",9.19374154445676,11,7,4,2.33359165522485,8.66640834477515
"1990","yeahbaby",9.19374154445676,11,7,4,2.33359165522485,8.66640834477515
"1970","da da la",9.18705760629829,27,10,17,3.69489307976364,23.3051069202364
"1970","da da la da",9.18705760629829,27,10,17,3.69489307976364,23.3051069202364
"2000","ba ba",9.18271952644725,71,31,40,19.1050837920848,51.8949162079152
"2010","something",9.18162861578152,1202,224,978,185.063194222104,1016.9368057779
"1980","beat",9.17021010300709,765,161,604,128.700331647337,636.299668352663
"1980","town",9.16888432352513,467,104,363,78.5660848095509,388.433915190449
"1980","live without",9.15854187273587,202,51,151,33.9836169840027,168.016383015997
"1980","never told",9.14678560438071,45,16,29,7.57060774396101,37.429392256039
"1980","pony",9.14678560438071,45,16,29,7.57060774396101,37.429392256039
"2010","weed",9.14424769354115,80,23,57,12.3170179182765,67.6829820817235
"1970","know know know",9.13992728473808,132,31,101,18.0639217232889,113.936078276711
"1990","world just",9.13645760489311,40,17,23,8.48578783718126,31.5142121628187
"1970","around",9.13287086207343,2228,355,1873,304.897103026422,1923.10289697358
"1970","dance want",9.13144991436348,23,9,14,3.14750151239125,19.8524984876087
"1970","give baby",9.13144991436348,23,9,14,3.14750151239125,19.8524984876087
"1970","goin nowhere",9.13144991436348,23,9,14,3.14750151239125,19.8524984876087
"1970","say anything",9.13144991436348,23,9,14,3.14750151239125,19.8524984876087
"1970","tell something",9.13144991436348,23,9,14,3.14750151239125,19.8524984876087
"1970","wastin",9.13144991436348,23,9,14,3.14750151239125,19.8524984876087
"1970","white boy",9.13144991436348,23,9,14,3.14750151239125,19.8524984876087
"2010","bout go",9.12719157967827,14,7,7,2.15547813569839,11.8445218643016
"2010","dont plan",9.12719157967827,14,7,7,2.15547813569839,11.8445218643016
"2010","fun aint",9.12719157967827,14,7,7,2.15547813569839,11.8445218643016
"2010","girl way",9.12719157967827,14,7,7,2.15547813569839,11.8445218643016
"2010","good tonight",9.12719157967827,14,7,7,2.15547813569839,11.8445218643016
"2010","lie love",9.12719157967827,14,7,7,2.15547813569839,11.8445218643016
"2010","never turn",9.12719157967827,14,7,7,2.15547813569839,11.8445218643016
"2010","one dream",9.12719157967827,14,7,7,2.15547813569839,11.8445218643016
"2010","see take",9.12719157967827,14,7,7,2.15547813569839,11.8445218643016
"2010","sparks",9.12719157967827,14,7,7,2.15547813569839,11.8445218643016
"2010","till break dawn",9.12719157967827,14,7,7,2.15547813569839,11.8445218643016
"2010","timeand",9.12719157967827,14,7,7,2.15547813569839,11.8445218643016
"2010","want good",9.12719157967827,14,7,7,2.15547813569839,11.8445218643016
"2010","world girl",9.12719157967827,14,7,7,2.15547813569839,11.8445218643016
"2000","shake",9.12608320323906,1207,372,835,324.786424465442,882.213575534558
"2000","kissin",9.1165642634817,57,26,31,15.3378841711103,41.6621158288897
"1990","dont know dont",9.1162024805724,88,31,57,18.6687332417988,69.3312667582012
"2000","know one",9.11469798153635,74,32,42,19.9123408537222,54.0876591462778
"1990","hope",9.1144231751754,523,140,383,110.951675971145,412.048324028855
"1960","love love love love",9.11332270247103,162,20,142,9.67517028964558,152.324829710354
"1970","laid",9.11281575995286,79,21,58,10.8109834556047,68.1890165443953
"1970","shadow",9.09034608251071,64,18,46,8.75826507795827,55.2417349220417
"2000","fight",9.08960878357796,483,160,323,129.968386923619,353.031613076381
"1970","ding",9.08709373529673,74,20,54,10.1267439963892,63.8732560036107
"1970","tall",9.08709373529673,74,20,54,10.1267439963892,63.8732560036107
"1980","dont feel",9.08424008869916,109,31,78,18.33769431315,90.66230568685
"2000","making",9.08422779499826,367,125,242,98.7544472069737,268.245552793026
"1970","spell",9.07835839156886,69,19,50,9.44250453717376,59.5574954628262
"1990","lay",9.06185978419181,465,126,339,98.6472836072322,366.352716392768
"2000","streets",9.06078751503286,177,66,111,47.6281666366058,129.371833363394
"1960","baby ooo",9.04123305724162,24,6,18,1.43335856142897,22.566641438571
"1960","emptiness",9.04123305724162,24,6,18,1.43335856142897,22.566641438571
"1960","good good good good",9.04123305724162,24,6,18,1.43335856142897,22.566641438571
"1960","home just",9.04123305724162,24,6,18,1.43335856142897,22.566641438571
"1960","man oh",9.04123305724162,24,6,18,1.43335856142897,22.566641438571
"1960","miss miss",9.04123305724162,24,6,18,1.43335856142897,22.566641438571
"1960","say one",9.04123305724162,24,6,18,1.43335856142897,22.566641438571
"1960","strings",9.04123305724162,24,6,18,1.43335856142897,22.566641438571
"1960","tripping",9.04123305724162,24,6,18,1.43335856142897,22.566641438571
"2000","grab",9.03987058326883,146,56,90,39.2865103330195,106.71348966698
"1990","girl want",9.03259338061999,67,25,42,14.2136946272786,52.7863053727214
"1990","show love",9.03259338061999,67,25,42,14.2136946272786,52.7863053727214
"2010","least",9.03003684472898,85,24,61,13.0868315381688,71.9131684618312
"1980","drifting",9.02806276805925,30,12,18,5.04707182930734,24.9529281706927
"1980","life youre",9.02806276805925,30,12,18,5.04707182930734,24.9529281706927
"1980","night cause",9.02806276805925,30,12,18,5.04707182930734,24.9529281706927
"1980","wait see",9.02806276805925,30,12,18,5.04707182930734,24.9529281706927
"1990","love strong",9.02475148103007,50,20,30,10.6072347964766,39.3927652035234
"1990","somebody else",9.02475148103007,50,20,30,10.6072347964766,39.3927652035234
"1970","brown",9.02166637528666,138,32,106,18.8850090743475,119.114990925652
"1970","future",9.02166637528666,138,32,106,18.8850090743475,119.114990925652
"1990","feel inside",9.01494552438084,37,16,21,7.84935374939267,29.1506462506073
"1990","hey yeah",9.01494552438084,37,16,21,7.84935374939267,29.1506462506073
"1990","make good",9.01494552438084,37,16,21,7.84935374939267,29.1506462506073
"1990","messin",9.01494552438084,37,16,21,7.84935374939267,29.1506462506073
"1990","apart youre",9.0147321714502,19,10,9,4.0307492226611,14.9692507773389
"1990","every night day",9.0147321714502,19,10,9,4.0307492226611,14.9692507773389
"1990","eyes dont",9.0147321714502,19,10,9,4.0307492226611,14.9692507773389
"1990","find oh",9.0147321714502,19,10,9,4.0307492226611,14.9692507773389
"1990","get time",9.0147321714502,19,10,9,4.0307492226611,14.9692507773389
"1990","like honey",9.0147321714502,19,10,9,4.0307492226611,14.9692507773389
"1990","prayers",9.0147321714502,19,10,9,4.0307492226611,14.9692507773389
"1990","skirts",9.0147321714502,19,10,9,4.0307492226611,14.9692507773389
"1990","words just",9.0147321714502,19,10,9,4.0307492226611,14.9692507773389
"1990","yes yes yes",9.0147321714502,19,10,9,4.0307492226611,14.9692507773389
"1970","dont worry",9.01181214294612,183,40,143,25.0431642072869,157.956835792713
"2010","dum",9.00926985831414,21,9,12,3.23321720354758,17.7667827964524
"2010","every day every",9.00926985831414,21,9,12,3.23321720354758,17.7667827964524
"2010","know everything",9.00926985831414,21,9,12,3.23321720354758,17.7667827964524
"2010","leave im",9.00926985831414,21,9,12,3.23321720354758,17.7667827964524
"2010","reached",9.00926985831414,21,9,12,3.23321720354758,17.7667827964524
"2000","question",9.00682266713855,80,34,46,21.526854976997,58.473145023003
"1960","baby please",9.00041102178141,77,12,65,4.59869205125129,72.4013079487487
"1960","heartbeat",9.00041102178141,77,12,65,4.59869205125129,72.4013079487487
"1960","wheel",9.00041102178141,77,12,65,4.59869205125129,72.4013079487487
"2000","see want",8.9988114974416,60,27,33,16.1451412327477,43.8548587672523
"2000","stayed",8.9988114974416,60,27,33,16.1451412327477,43.8548587672523
"1960","get now",8.99752969476008,40,8,32,2.38893093571496,37.611069064285
"1960","see girl",8.99752969476008,40,8,32,2.38893093571496,37.611069064285
"1970","cant cant stand rain",8.99706282828927,12,6,6,1.64217470211718,10.3578252978828
"1970","dont pull",8.99706282828927,12,6,6,1.64217470211718,10.3578252978828
"1970","dont worry baby",8.99706282828927,12,6,6,1.64217470211718,10.3578252978828
"1970","easy know",8.99706282828927,12,6,6,1.64217470211718,10.3578252978828
"1970","evrybody",8.99706282828927,12,6,6,1.64217470211718,10.3578252978828
"1970","feelin good",8.99706282828927,12,6,6,1.64217470211718,10.3578252978828
"1970","girl show",8.99706282828927,12,6,6,1.64217470211718,10.3578252978828
"1970","just saw",8.99706282828927,12,6,6,1.64217470211718,10.3578252978828
"1970","light will",8.99706282828927,12,6,6,1.64217470211718,10.3578252978828
"1970","live together",8.99706282828927,12,6,6,1.64217470211718,10.3578252978828
"1970","love anymore",8.99706282828927,12,6,6,1.64217470211718,10.3578252978828
"1970","love just want",8.99706282828927,12,6,6,1.64217470211718,10.3578252978828
"1970","love please",8.99706282828927,12,6,6,1.64217470211718,10.3578252978828
"1970","love whoa",8.99706282828927,12,6,6,1.64217470211718,10.3578252978828
"1970","now weve got",8.99706282828927,12,6,6,1.64217470211718,10.3578252978828
"1970","people im",8.99706282828927,12,6,6,1.64217470211718,10.3578252978828
"1970","place thats",8.99706282828927,12,6,6,1.64217470211718,10.3578252978828
"1970","poetry",8.99706282828927,12,6,6,1.64217470211718,10.3578252978828
"1970","say dont say",8.99706282828927,12,6,6,1.64217470211718,10.3578252978828
"1970","sometimes dont",8.99706282828927,12,6,6,1.64217470211718,10.3578252978828
"1970","state mind",8.99706282828927,12,6,6,1.64217470211718,10.3578252978828
"1970","stay im",8.99706282828927,12,6,6,1.64217470211718,10.3578252978828
"1970","sunshine shes",8.99706282828927,12,6,6,1.64217470211718,10.3578252978828
"1970","sure can",8.99706282828927,12,6,6,1.64217470211718,10.3578252978828
"1970","tonight want",8.99706282828927,12,6,6,1.64217470211718,10.3578252978828
"1970","turning turning",8.99706282828927,12,6,6,1.64217470211718,10.3578252978828
"1990","cried",8.98778655751826,163,51,112,34.5795854365137,128.420414563486
"1960","true",8.97550019102468,1022,85,937,61.0371854075172,960.962814592483
"1970","ride ride",8.97434638176973,95,24,71,13.0005497250943,81.9994502749057
"1980","sad",8.97108603708504,326,76,250,54.8448472118064,271.155152788194
"1970","got best",8.96811456598916,36,12,24,4.92652410635153,31.0734758936485
"2010","aint going nowhere",8.96625243753704,11,6,5,1.69358996376302,9.30641003623698
"2010","believe real",8.96625243753704,11,6,5,1.69358996376302,9.30641003623698
"2010","blade",8.96625243753704,11,6,5,1.69358996376302,9.30641003623698
"2010","call home",8.96625243753704,11,6,5,1.69358996376302,9.30641003623698
"2010","cause imma",8.96625243753704,11,6,5,1.69358996376302,9.30641003623698
"2010","change cause",8.96625243753704,11,6,5,1.69358996376302,9.30641003623698
"2010","clear dont",8.96625243753704,11,6,5,1.69358996376302,9.30641003623698
"2010","feel like ive",8.96625243753704,11,6,5,1.69358996376302,9.30641003623698
"2010","fire cause",8.96625243753704,11,6,5,1.69358996376302,9.30641003623698
"2010","fire rain",8.96625243753704,11,6,5,1.69358996376302,9.30641003623698
"2010","go la",8.96625243753704,11,6,5,1.69358996376302,9.30641003623698
"2010","got plan",8.96625243753704,11,6,5,1.69358996376302,9.30641003623698
"2010","guess dont",8.96625243753704,11,6,5,1.69358996376302,9.30641003623698
"2010","hail",8.96625243753704,11,6,5,1.69358996376302,9.30641003623698
"2010","half million",8.96625243753704,11,6,5,1.69358996376302,9.30641003623698
"2010","hands like",8.96625243753704,11,6,5,1.69358996376302,9.30641003623698
"2010","im nigga",8.96625243753704,11,6,5,1.69358996376302,9.30641003623698
"2010","know happened",8.96625243753704,11,6,5,1.69358996376302,9.30641003623698
"2010","love love oh",8.96625243753704,11,6,5,1.69358996376302,9.30641003623698
"2010","love wanted",8.96625243753704,11,6,5,1.69358996376302,9.30641003623698
"2010","mad love",8.96625243753704,11,6,5,1.69358996376302,9.30641003623698
"2010","man girl",8.96625243753704,11,6,5,1.69358996376302,9.30641003623698
"2010","oh keep",8.96625243753704,11,6,5,1.69358996376302,9.30641003623698
"2010","oh oh ooh",8.96625243753704,11,6,5,1.69358996376302,9.30641003623698
"2010","opposite",8.96625243753704,11,6,5,1.69358996376302,9.30641003623698
"2010","rightcause",8.96625243753704,11,6,5,1.69358996376302,9.30641003623698
"2010","take sip",8.96625243753704,11,6,5,1.69358996376302,9.30641003623698
"2010","tell nobody",8.96625243753704,11,6,5,1.69358996376302,9.30641003623698
"2010","theres fire",8.96625243753704,11,6,5,1.69358996376302,9.30641003623698
"2010","theres nothing wouldnt",8.96625243753704,11,6,5,1.69358996376302,9.30641003623698
"2010","theyll tell",8.96625243753704,11,6,5,1.69358996376302,9.30641003623698
"2010","whip whip",8.96625243753704,11,6,5,1.69358996376302,9.30641003623698
"2010","without without cant",8.96625243753704,11,6,5,1.69358996376302,9.30641003623698
"2010","yeah theyre",8.96625243753704,11,6,5,1.69358996376302,9.30641003623698
"2010","youre lyin",8.96625243753704,11,6,5,1.69358996376302,9.30641003623698
"1980","night im",8.96074903114444,70,22,48,11.7765009350505,58.2234990649496
"1980","youyou",8.96074903114444,70,22,48,11.7765009350505,58.2234990649496
"1960","daughter",8.94806106847857,58,10,48,3.46394985678669,54.5360501432133
"2000","ass like",8.94594715102121,33,17,16,8.87982767801125,24.1201723219887
"1980","else dont",8.94479539245159,23,10,13,3.86942173580229,19.1305782641977
"1980","flesh",8.94479539245159,23,10,13,3.86942173580229,19.1305782641977
"1980","heart away",8.94479539245159,23,10,13,3.86942173580229,19.1305782641977
"1980","love youre one",8.94479539245159,23,10,13,3.86942173580229,19.1305782641977
"1980","rendezvous",8.94479539245159,23,10,13,3.86942173580229,19.1305782641977
"1980","way goes",8.94479539245159,23,10,13,3.86942173580229,19.1305782641977
"2000","tears eyes",8.94060392204091,49,23,26,13.1851986734107,35.8148013265894
"2010","smoke",8.93984794521457,200,47,153,30.7925447956913,169.207455204309
"2010","admit",8.93557521938742,90,25,65,13.8566451580611,76.1433548419389
"2000","deserve",8.93006322341098,86,36,50,23.1413691002718,62.8586308997282
"1980","makes feel",8.91501644564601,83,25,58,13.963565394417,69.036434605583
"1960","tears eyes",8.91309698764536,49,9,40,2.92644039625082,46.0735596037492
"1990","angry",8.91302439212964,34,15,19,7.21291966160408,26.7870803383959
"1990","go oh oh",8.91302439212964,34,15,19,7.21291966160408,26.7870803383959
"1990","need know need",8.91302439212964,34,15,19,7.21291966160408,26.7870803383959
"1990","us apart",8.91302439212964,34,15,19,7.21291966160408,26.7870803383959
"2000","talkin",8.91187787986632,335,115,220,90.1437052161749,244.856294783825
"1960","thirty",8.91095733938169,32,7,25,1.91114474857197,30.088855251428
"1960","whats mind",8.91095733938169,32,7,25,1.91114474857197,30.088855251428
"2000","drop drop",8.9076927938606,23,13,10,6.18897080588663,16.8110291941134
"2000","girl whos",8.9076927938606,23,13,10,6.18897080588663,16.8110291941134
"2000","make scream",8.9076927938606,23,13,10,6.18897080588663,16.8110291941134
"2000","right left",8.9076927938606,23,13,10,6.18897080588663,16.8110291941134
"2000","shit aint",8.9076927938606,23,13,10,6.18897080588663,16.8110291941134
"2000","slick",8.9076927938606,23,13,10,6.18897080588663,16.8110291941134
"2000","time goes",8.9076927938606,23,13,10,6.18897080588663,16.8110291941134
"1960","find",8.90655118814094,1686,131,1555,100.693438940385,1585.30656105961
"2000","wheels",8.89759749345743,63,28,35,16.9523982943851,46.0476017056149
"1990","pack",8.88547355010718,85,30,55,18.0322991540102,66.9677008459898
"1990","unless",8.88547355010718,85,30,55,18.0322991540102,66.9677008459898
"1990","kind",8.87656887207522,554,147,407,117.528161544961,436.471838455039
"2000","hey baby",8.86937401359514,122,48,74,32.8284538399204,89.1715461600796
"2000","live life",8.86937401359514,122,48,74,32.8284538399204,89.1715461600796
"1960","gonna give",8.86775707059381,98,14,84,5.85288079250165,92.1471192074984
"1970","women",8.862732786501,201,43,158,27.5064262604627,173.493573739537
"2000","hot youre",8.85843424272741,28,15,13,7.53439924194894,20.4656007580511
"2000","sellin",8.85843424272741,28,15,13,7.53439924194894,20.4656007580511
"2000","still im",8.85843424272741,28,15,13,7.53439924194894,20.4656007580511
"2000","time girl",8.85843424272741,28,15,13,7.53439924194894,20.4656007580511
"1990","close door",8.85792992256358,22,11,11,4.6671833104497,17.3328166895503
"1990","girl knew",8.85792992256358,22,11,11,4.6671833104497,17.3328166895503
"1990","got shit",8.85792992256358,22,11,11,4.6671833104497,17.3328166895503
"1990","hey love",8.85792992256358,22,11,11,4.6671833104497,17.3328166895503
"1990","look inside",8.85792992256358,22,11,11,4.6671833104497,17.3328166895503
"1990","lust",8.85792992256358,22,11,11,4.6671833104497,17.3328166895503
"1990","ill see",8.84944065998726,47,19,28,9.97080070868799,37.029199291312
"2000","cant keep",8.847401807019,98,40,58,26.3703973468213,71.6296026531787
"2000","make move",8.847401807019,98,40,58,26.3703973468213,71.6296026531787
"2000","always know",8.84599312780919,16,10,6,4.3053709953994,11.6946290046006
"2000","baby bring",8.84599312780919,16,10,6,4.3053709953994,11.6946290046006
"2000","bangin",8.84599312780919,16,10,6,4.3053709953994,11.6946290046006
"2000","becoming",8.84599312780919,16,10,6,4.3053709953994,11.6946290046006
"2000","blanket",8.84599312780919,16,10,6,4.3053709953994,11.6946290046006
"2000","die im",8.84599312780919,16,10,6,4.3053709953994,11.6946290046006
"2000","im leavin",8.84599312780919,16,10,6,4.3053709953994,11.6946290046006
"2000","itand",8.84599312780919,16,10,6,4.3053709953994,11.6946290046006
"2000","let go ill",8.84599312780919,16,10,6,4.3053709953994,11.6946290046006
"2000","one around",8.84599312780919,16,10,6,4.3053709953994,11.6946290046006
"2000","shes bad",8.84599312780919,16,10,6,4.3053709953994,11.6946290046006
"2000","take somewhere",8.84599312780919,16,10,6,4.3053709953994,11.6946290046006
"2000","waiting just",8.84599312780919,16,10,6,4.3053709953994,11.6946290046006
"2000","weave",8.84599312780919,16,10,6,4.3053709953994,11.6946290046006
"1980","break dawn",8.84488830655105,34,13,21,5.72001473988165,28.2799852601184
"1980","final",8.84488830655105,34,13,21,5.72001473988165,28.2799852601184
"1980","morning light",8.84488830655105,34,13,21,5.72001473988165,28.2799852601184
"1980","oooooo",8.84488830655105,34,13,21,5.72001473988165,28.2799852601184
"1980","true dont",8.84488830655105,34,13,21,5.72001473988165,28.2799852601184
"1970","ill always",8.84378869192697,85,22,63,11.6320708066633,73.3679291933367
"2000","bottles",8.83848161007041,101,41,60,27.1776544084587,73.8223455915413
"1990","freaks",8.836268334338,31,14,17,6.57648557381548,24.4235144261845
"1990","heart never",8.836268334338,31,14,17,6.57648557381548,24.4235144261845
"1990","never knew love",8.836268334338,31,14,17,6.57648557381548,24.4235144261845
"1990","time ive",8.836268334338,31,14,17,6.57648557381548,24.4235144261845
"1980","surprise",8.83225798323335,92,27,65,15.4776869432092,76.5223130567908
"1980","bad",8.8262732758047,1258,252,1006,211.640545375621,1046.35945462438
"1990","smokin",8.82528923757869,96,33,63,20.365890809235,75.634109190765
"1990","wear",8.80945969480787,183,56,127,38.8224793551043,144.177520644896
"1990","ever gonna",8.80508511625725,71,26,45,15.0622734109967,55.9377265890033
"1980","climb",8.7978349021187,79,24,55,13.2906224838427,65.7093775161573
"1970","sign",8.7971882590552,167,37,130,22.8535979377974,144.146402062203
"2010","beauty",8.79466029678253,100,27,73,15.3962723978456,84.6037276021544
"1990","cause need know",8.79379425206221,25,12,13,5.30361739823829,19.6963826017617
"1990","hiphop",8.79379425206221,25,12,13,5.30361739823829,19.6963826017617
"1990","love must",8.79379425206221,25,12,13,5.30361739823829,19.6963826017617
"1990","take deep",8.79379425206221,25,12,13,5.30361739823829,19.6963826017617
"1990","back can",8.79261610317421,28,13,15,5.94005148602689,22.0599485139731
"1990","ever say",8.79261610317421,28,13,15,5.94005148602689,22.0599485139731
"1990","girl ooh",8.79261610317421,28,13,15,5.94005148602689,22.0599485139731
"1990","na na nana na",8.79261610317421,28,13,15,5.94005148602689,22.0599485139731
"1990","na nana na na",8.79261610317421,28,13,15,5.94005148602689,22.0599485139731
"1990","nana na na",8.79261610317421,28,13,15,5.94005148602689,22.0599485139731
"1990","want wanna",8.79261610317421,28,13,15,5.94005148602689,22.0599485139731
"1960","love forever",8.78711199879726,78,12,66,4.65841532464417,73.3415846753558
"2010","degrees",8.78606757431515,25,10,15,3.84906809946141,21.1509319005386
"2010","eighty",8.78606757431515,25,10,15,3.84906809946141,21.1509319005386
"2010","feel something",8.78606757431515,25,10,15,3.84906809946141,21.1509319005386
"2010","gonna hold",8.78606757431515,25,10,15,3.84906809946141,21.1509319005386
"2010","things cant",8.78606757431515,25,10,15,3.84906809946141,21.1509319005386
"2000","heart cant",8.78521592271667,52,24,28,13.992455735048,38.007544264952
"2000","dont",8.77829055066792,11587,3260,8327,3117.8958577308,8469.1041422692
"1970","woke",8.77415793451019,101,25,76,13.8216370761529,87.1783629238471
"2010","go want",8.7735001246618,41,14,27,6.31247168311671,34.6875283168833
"2010","say word",8.7735001246618,41,14,27,6.31247168311671,34.6875283168833
"2010","think id",8.7735001246618,41,14,27,6.31247168311671,34.6875283168833
"2010","dont give",8.76581820260238,275,61,214,42.3397490940755,232.660250905924
"1970","dream dream",8.75291870306649,32,11,21,4.37913253897913,27.6208674610209
"1970","nothin can",8.75291870306649,32,11,21,4.37913253897913,27.6208674610209
"1970","pen",8.75291870306649,32,11,21,4.37913253897913,27.6208674610209
"2010","country",8.74386671145556,105,28,77,16.1660860177379,88.8339139822621
"2000","get know",8.736283811436,69,30,39,18.5669124176599,50.4330875823401
"2000","im goin",8.736283811436,69,30,39,18.5669124176599,50.4330875823401
"1980","gives",8.73397176582882,58,19,39,9.75767220332752,48.2423277966725
"1970","love sweet",8.73396483079365,70,19,51,9.57935242901686,60.4206475709831
"1980","say ooh",8.73243476224128,38,14,24,6.39295765045596,31.607042349544
"1980","know dont",8.72771787832524,243,59,184,40.8812818173894,202.118718182611
"2000","check",8.72584399202821,261,92,169,70.2313643624527,190.768635637547
"2000","whole",8.71977453534721,613,198,415,164.949526261239,448.050473738761
"2010","talks",8.71462153043921,54,17,37,8.31398709483664,45.6860129051634
"1980","takes",8.70533330683062,363,83,280,61.0695691346188,301.930430865381
"2010","sleeping",8.70391781783058,110,29,81,16.9358996376302,93.0641003623698
"2000","im ready",8.70343122631749,147,56,91,39.555596020232,107.444403979768
"1970","love cant",8.69989983076781,112,27,85,15.326963886427,96.673036113573
"2010","aint aint",8.69971454693875,37,13,24,5.69662078720288,31.3033792127971
"2010","make real",8.69971454693875,37,13,24,5.69662078720288,31.3033792127971
"2010","night know",8.69971454693875,37,13,24,5.69662078720288,31.3033792127971
"2010","really care",8.69971454693875,37,13,24,5.69662078720288,31.3033792127971
"1980","smooth",8.68620948094601,75,23,52,12.6176795732683,62.3823204267317
"2010","dont wanna fall",8.68581274043257,29,11,18,4.46491899537523,24.5350810046248
"2010","im gonna give",8.68581274043257,29,11,18,4.46491899537523,24.5350810046248
"2010","look now",8.68581274043257,29,11,18,4.46491899537523,24.5350810046248
"2010","make sense",8.68581274043257,29,11,18,4.46491899537523,24.5350810046248
"2010","sharp",8.68581274043257,29,11,18,4.46491899537523,24.5350810046248
"2010","sticks",8.68581274043257,29,11,18,4.46491899537523,24.5350810046248
"1980","food",8.68532569348484,54,18,36,9.08472929275321,44.9152707072468
"1980","talks",8.68532569348484,54,18,36,9.08472929275321,44.9152707072468
"1960","got time",8.68430607512374,99,14,85,5.91260406589452,93.0873959341055
"1960","clown",8.68053994579642,41,8,33,2.44865420910783,38.5513457908922
"2010","well never",8.67497784939433,63,19,44,9.69965161064275,53.3003483893573
"2000","dont really",8.67319909921909,144,55,89,38.7483389585946,105.251661041405
"2000","complete",8.67281215918431,72,31,41,19.3741694792973,52.6258305207027
"1960","reach",8.6726157262513,224,25,199,13.3780132400038,210.621986759996
"1980","easier",8.67125819046677,42,15,27,7.06590056103027,34.9340994389697
"1980","gonna lose",8.67125819046677,42,15,27,7.06590056103027,34.9340994389697
"2010","now lets",8.66533518537408,33,12,21,5.08076989128906,27.9192301087109
"2010","way aint",8.66533518537408,33,12,21,5.08076989128906,27.9192301087109
"1980","heart im",8.65529256775739,50,17,33,8.4117863821789,41.5882136178211
"1980","long ago",8.65529256775739,50,17,33,8.4117863821789,41.5882136178211
"1990","can give",8.65510156320365,82,29,53,17.3958650662216,64.6041349337784
"2000","girl cause",8.65279699788782,55,25,30,14.7997127966854,40.2002872033146
"2000","way youre",8.65279699788782,55,25,30,14.7997127966854,40.2002872033146
"2010","ooh baby",8.64965652583504,150,37,113,23.0944085967684,126.905591403232
"2000","butterfly",8.64757184659007,44,21,23,11.8397702373483,32.1602297626517
"2000","go dont let",8.64757184659007,44,21,23,11.8397702373483,32.1602297626517
"2000","yous",8.64757184659007,44,21,23,11.8397702373483,32.1602297626517
"1980","little",8.64142070478088,2553,486,2067,429.505812674054,2123.49418732595
"2010","dollar",8.63746439612208,145,36,109,22.3245949768762,122.675405023124
"2000","chance make",8.63604339955642,36,18,18,9.68708473964864,26.3129152603514
"2000","touch like",8.63604339955642,36,18,18,9.68708473964864,26.3129152603514
"1960","can fly",8.63490091438002,50,9,41,2.9861636696437,47.0138363303563
"2010","worry",8.62763760499274,292,64,228,44.9571154017092,247.042884598291
"1960","hour",8.61384066367279,110,15,95,6.56956007321613,103.430439926784
"1960","instead",8.61384066367279,110,15,95,6.56956007321613,103.430439926784
"1980","ann",8.6099885189167,20,9,11,3.36471455287156,16.6352854471284
"1980","becomes",8.6099885189167,20,9,11,3.36471455287156,16.6352854471284
"1980","can dance can",8.6099885189167,20,9,11,3.36471455287156,16.6352854471284
"1980","lost can",8.6099885189167,20,9,11,3.36471455287156,16.6352854471284
"1980","torn apart",8.6099885189167,20,9,11,3.36471455287156,16.6352854471284
"1980","wildest dreams",8.6099885189167,20,9,11,3.36471455287156,16.6352854471284
"1980","gonna dance",8.60850403376666,27,11,16,4.5423646463766,22.4576353536234
"1980","nina",8.60850403376666,27,11,16,4.5423646463766,22.4576353536234
"1980","ohh ohh",8.60850403376666,27,11,16,4.5423646463766,22.4576353536234
"1980","say wont",8.60850403376666,27,11,16,4.5423646463766,22.4576353536234
"1980","struck",8.60850403376666,27,11,16,4.5423646463766,22.4576353536234
"1980","well find",8.60850403376666,27,11,16,4.5423646463766,22.4576353536234
"1980","zero",8.60850403376666,27,11,16,4.5423646463766,22.4576353536234
"1960","endlessly",8.60248570866527,25,6,19,1.49308183482185,23.5069181651781
"1960","sam",8.60248570866527,25,6,19,1.49308183482185,23.5069181651781
"1960","youre one love",8.60248570866527,25,6,19,1.49308183482185,23.5069181651781
"1990","reason",8.59859416393734,340,95,245,72.1291966160408,267.870803383959
"1960","know will",8.59852710699558,69,11,58,4.1209058641083,64.8790941358917
"1960","stood",8.59852710699558,69,11,58,4.1209058641083,64.8790941358917
"2000","cant",8.59163260899302,5338,1532,3806,1436.37939834012,3901.62060165988
"1980","got something",8.58104495547207,71,22,49,11.944736662694,59.055263337306
"1990","always always",8.5792304621443,9,6,3,1.90930226336578,7.09069773663422
"1990","anything goes",8.5792304621443,9,6,3,1.90930226336578,7.09069773663422
"1990","aqui",8.5792304621443,9,6,3,1.90930226336578,7.09069773663422
"1990","around said",8.5792304621443,9,6,3,1.90930226336578,7.09069773663422
"1990","baby game",8.5792304621443,9,6,3,1.90930226336578,7.09069773663422
"1990","baby girl youre",8.5792304621443,9,6,3,1.90930226336578,7.09069773663422
"1990","babyboy",8.5792304621443,9,6,3,1.90930226336578,7.09069773663422
"1990","brand new dance",8.5792304621443,9,6,3,1.90930226336578,7.09069773663422
"1990","bushes",8.5792304621443,9,6,3,1.90930226336578,7.09069773663422
"1990","cause baby im",8.5792304621443,9,6,3,1.90930226336578,7.09069773663422
"1990","cause mean",8.5792304621443,9,6,3,1.90930226336578,7.09069773663422
"1990","crews",8.5792304621443,9,6,3,1.90930226336578,7.09069773663422
"1990","cried many",8.5792304621443,9,6,3,1.90930226336578,7.09069773663422
"1990","dont leave now",8.5792304621443,9,6,3,1.90930226336578,7.09069773663422
"1990","easy give",8.5792304621443,9,6,3,1.90930226336578,7.09069773663422
"1990","ends meet",8.5792304621443,9,6,3,1.90930226336578,7.09069773663422
"1990","entertain",8.5792304621443,9,6,3,1.90930226336578,7.09069773663422
"1990","everything ive got",8.5792304621443,9,6,3,1.90930226336578,7.09069773663422
"1990","find baby",8.5792304621443,9,6,3,1.90930226336578,7.09069773663422
"1990","fire didnt",8.5792304621443,9,6,3,1.90930226336578,7.09069773663422
"1990","gave world",8.5792304621443,9,6,3,1.90930226336578,7.09069773663422
"1990","girl believe",8.5792304621443,9,6,3,1.90930226336578,7.09069773663422
"1990","gonna move",8.5792304621443,9,6,3,1.90930226336578,7.09069773663422
"1990","happy days",8.5792304621443,9,6,3,1.90930226336578,7.09069773663422
"1990","id im",8.5792304621443,9,6,3,1.90930226336578,7.09069773663422
"1990","left man",8.5792304621443,9,6,3,1.90930226336578,7.09069773663422
"1990","lovewhat",8.5792304621443,9,6,3,1.90930226336578,7.09069773663422
"1990","make ends meet",8.5792304621443,9,6,3,1.90930226336578,7.09069773663422
"1990","mine one",8.5792304621443,9,6,3,1.90930226336578,7.09069773663422
"1990","missing life",8.5792304621443,9,6,3,1.90930226336578,7.09069773663422
"1990","morebaby",8.5792304621443,9,6,3,1.90930226336578,7.09069773663422
"1990","movin like",8.5792304621443,9,6,3,1.90930226336578,7.09069773663422
"1990","name ill",8.5792304621443,9,6,3,1.90930226336578,7.09069773663422
"1990","party oh",8.5792304621443,9,6,3,1.90930226336578,7.09069773663422
"1990","run game",8.5792304621443,9,6,3,1.90930226336578,7.09069773663422
"1990","saw best",8.5792304621443,9,6,3,1.90930226336578,7.09069773663422
"1990","see everyday",8.5792304621443,9,6,3,1.90930226336578,7.09069773663422
"1990","show baby",8.5792304621443,9,6,3,1.90930226336578,7.09069773663422
"1990","soul let",8.5792304621443,9,6,3,1.90930226336578,7.09069773663422
"1990","stars shining",8.5792304621443,9,6,3,1.90930226336578,7.09069773663422
"1990","swear will",8.5792304621443,9,6,3,1.90930226336578,7.09069773663422
"1990","together ooh",8.5792304621443,9,6,3,1.90930226336578,7.09069773663422
"1990","tried everything",8.5792304621443,9,6,3,1.90930226336578,7.09069773663422
"1990","want wait",8.5792304621443,9,6,3,1.90930226336578,7.09069773663422
"1990","watch tv",8.5792304621443,9,6,3,1.90930226336578,7.09069773663422
"1990","whatever im",8.5792304621443,9,6,3,1.90930226336578,7.09069773663422
"1990","world yeah",8.5792304621443,9,6,3,1.90930226336578,7.09069773663422
"1990","ya one",8.5792304621443,9,6,3,1.90930226336578,7.09069773663422
"1990","youre seeing",8.5792304621443,9,6,3,1.90930226336578,7.09069773663422
"1960","ill love",8.57847543755493,79,12,67,4.71813859803704,74.281861401963
"1970","dont ya",8.57725408371788,28,10,18,3.83174097160674,24.1682590283933
"1970","fox",8.57725408371788,28,10,18,3.83174097160674,24.1682590283933
"1970","let dont",8.57725408371788,28,10,18,3.83174097160674,24.1682590283933
"1970","ready cause",8.57725408371788,28,10,18,3.83174097160674,24.1682590283933
"1970","souls",8.57725408371788,28,10,18,3.83174097160674,24.1682590283933
"1970","virgin",8.57725408371788,28,10,18,3.83174097160674,24.1682590283933
"1970","way go",8.57299978175123,46,14,32,6.29500302478251,39.7049969752175
"1970","can remember",8.56329711579592,16,7,9,2.18956626948957,13.8104337305104
"1970","cant afford",8.56329711579592,16,7,9,2.18956626948957,13.8104337305104
"1970","captured",8.56329711579592,16,7,9,2.18956626948957,13.8104337305104
"1970","eyes tell",8.56329711579592,16,7,9,2.18956626948957,13.8104337305104
"1970","lets go lets go",8.56329711579592,16,7,9,2.18956626948957,13.8104337305104
"1970","lincoln",8.56329711579592,16,7,9,2.18956626948957,13.8104337305104
"1970","right give",8.56329711579592,16,7,9,2.18956626948957,13.8104337305104
"1970","suns",8.56329711579592,16,7,9,2.18956626948957,13.8104337305104
"2010","flight",8.55553289951024,50,16,34,7.69813619892281,42.3018638010772
"2010","alarm",8.5499365468971,18,8,10,2.77132903161221,15.2286709683878
"2010","club im",8.5499365468971,18,8,10,2.77132903161221,15.2286709683878
"2010","enough make",8.5499365468971,18,8,10,2.77132903161221,15.2286709683878
"2010","girl whats",8.5499365468971,18,8,10,2.77132903161221,15.2286709683878
"2010","hands touch",8.5499365468971,18,8,10,2.77132903161221,15.2286709683878
"2010","involved",8.5499365468971,18,8,10,2.77132903161221,15.2286709683878
"2010","new york new",8.5499365468971,18,8,10,2.77132903161221,15.2286709683878
"2010","oh dont know",8.5499365468971,18,8,10,2.77132903161221,15.2286709683878
"2010","quicker",8.5499365468971,18,8,10,2.77132903161221,15.2286709683878
"2010","right fuck",8.5499365468971,18,8,10,2.77132903161221,15.2286709683878
"2010","rock rock rock rock",8.5499365468971,18,8,10,2.77132903161221,15.2286709683878
"2010","tell see",8.5499365468971,18,8,10,2.77132903161221,15.2286709683878
"2010","tried tell",8.5499365468971,18,8,10,2.77132903161221,15.2286709683878
"2010","undo",8.5499365468971,18,8,10,2.77132903161221,15.2286709683878
"2010","worry dont",8.5499365468971,18,8,10,2.77132903161221,15.2286709683878
"2010","yeah party",8.5499365468971,18,8,10,2.77132903161221,15.2286709683878
"2010","yeah yeah yeah im",8.5499365468971,18,8,10,2.77132903161221,15.2286709683878
"2010","york new",8.5499365468971,18,8,10,2.77132903161221,15.2286709683878
"1960","cast",8.54894690955301,33,7,26,1.97086802196484,31.0291319780352
"1960","make little",8.54894690955301,33,7,26,1.97086802196484,31.0291319780352
"1960","stop loving",8.54894690955301,33,7,26,1.97086802196484,31.0291319780352
"1990","deep soul",8.5476503780333,14,8,6,2.97002574301344,11.0299742569866
"1990","define",8.5476503780333,14,8,6,2.97002574301344,11.0299742569866
"1990","dippin",8.5476503780333,14,8,6,2.97002574301344,11.0299742569866
"1990","dont stop get get",8.5476503780333,14,8,6,2.97002574301344,11.0299742569866
"1990","dreams im",8.5476503780333,14,8,6,2.97002574301344,11.0299742569866
"1990","every minute",8.5476503780333,14,8,6,2.97002574301344,11.0299742569866
"1990","fall will",8.5476503780333,14,8,6,2.97002574301344,11.0299742569866
"1990","hands love",8.5476503780333,14,8,6,2.97002574301344,11.0299742569866
"1990","ill forever",8.5476503780333,14,8,6,2.97002574301344,11.0299742569866
"1990","keep playin",8.5476503780333,14,8,6,2.97002574301344,11.0299742569866
"1990","knowand",8.5476503780333,14,8,6,2.97002574301344,11.0299742569866
"1990","like sound",8.5476503780333,14,8,6,2.97002574301344,11.0299742569866
"1990","love dark",8.5476503780333,14,8,6,2.97002574301344,11.0299742569866
"1990","love now im",8.5476503780333,14,8,6,2.97002574301344,11.0299742569866
"1990","make promise",8.5476503780333,14,8,6,2.97002574301344,11.0299742569866
"1990","thats fact",8.5476503780333,14,8,6,2.97002574301344,11.0299742569866
"1990","thinkin baby",8.5476503780333,14,8,6,2.97002574301344,11.0299742569866
"1990","try cant",8.5476503780333,14,8,6,2.97002574301344,11.0299742569866
"1990","trying catch",8.5476503780333,14,8,6,2.97002574301344,11.0299742569866
"1990","well oh",8.5476503780333,14,8,6,2.97002574301344,11.0299742569866
"1990","will learn",8.5476503780333,14,8,6,2.97002574301344,11.0299742569866
"1990","youre alright",8.5476503780333,14,8,6,2.97002574301344,11.0299742569866
"1970","slip",8.54562877832525,129,30,99,17.6533780477596,111.34662195224
"2000","save",8.54318749549591,304,105,199,81.8020489125885,222.197951087411
"1970","dont come",8.54315518102897,86,22,64,11.7689186985064,74.2310813014936
"2000","trip",8.54253108826748,129,50,79,34.7120536504076,94.2879463495924
"2000","gonna gonna",8.53982876488312,58,26,32,15.6069698583228,42.3930301416772
"2000","younger",8.53982876488312,58,26,32,15.6069698583228,42.3930301416772
"1990","mind cause",8.5246360487379,41,17,24,8.6979325331108,32.3020674668892
"1990","single day",8.5246360487379,41,17,24,8.6979325331108,32.3020674668892
"1970","hoo",8.52438472480966,157,35,122,21.4851190193664,135.514880980634
"2000","big girl",8.5144641249263,14,9,5,3.76719962097447,10.2328003790255
"2000","bit get",8.5144641249263,14,9,5,3.76719962097447,10.2328003790255
"2000","bump bump bump",8.5144641249263,14,9,5,3.76719962097447,10.2328003790255
"2000","call back",8.5144641249263,14,9,5,3.76719962097447,10.2328003790255
"2000","certified",8.5144641249263,14,9,5,3.76719962097447,10.2328003790255
"2000","cross line",8.5144641249263,14,9,5,3.76719962097447,10.2328003790255
"2000","dont mad",8.5144641249263,14,9,5,3.76719962097447,10.2328003790255
"2000","floor cause",8.5144641249263,14,9,5,3.76719962097447,10.2328003790255
"2000","gave now",8.5144641249263,14,9,5,3.76719962097447,10.2328003790255
"2000","give faith",8.5144641249263,14,9,5,3.76719962097447,10.2328003790255
"2000","got nigga",8.5144641249263,14,9,5,3.76719962097447,10.2328003790255
"2000","im sorry im",8.5144641249263,14,9,5,3.76719962097447,10.2328003790255
"2000","know boy",8.5144641249263,14,9,5,3.76719962097447,10.2328003790255
"2000","know hate",8.5144641249263,14,9,5,3.76719962097447,10.2328003790255
"2000","knows name",8.5144641249263,14,9,5,3.76719962097447,10.2328003790255
"2000","like back",8.5144641249263,14,9,5,3.76719962097447,10.2328003790255
"2000","look girl",8.5144641249263,14,9,5,3.76719962097447,10.2328003790255
"2000","make dont",8.5144641249263,14,9,5,3.76719962097447,10.2328003790255
"2000","mill",8.5144641249263,14,9,5,3.76719962097447,10.2328003790255
"2000","next thing know",8.5144641249263,14,9,5,3.76719962097447,10.2328003790255
"2000","now know youre",8.5144641249263,14,9,5,3.76719962097447,10.2328003790255
"2000","say think",8.5144641249263,14,9,5,3.76719962097447,10.2328003790255
"2000","see youre one",8.5144641249263,14,9,5,3.76719962097447,10.2328003790255
"2000","take top",8.5144641249263,14,9,5,3.76719962097447,10.2328003790255
"2000","tops",8.5144641249263,14,9,5,3.76719962097447,10.2328003790255
"2000","want anything",8.5144641249263,14,9,5,3.76719962097447,10.2328003790255
"2000","want piece",8.5144641249263,14,9,5,3.76719962097447,10.2328003790255
"2010","turn music",8.50374885371721,68,20,48,10.469465230535,57.530534769465
"2010","got real",8.48421808569199,59,18,41,9.08380071472892,49.9161992852711
"1970","will see",8.4834290293679,81,21,60,11.0846792392909,69.9153207607091
"2000","tongue",8.48061761872727,87,36,51,23.4104547874842,63.5895452125158
"1970","september",8.4710455979245,51,15,36,6.97924248399799,44.020757516002
"1970","love will",8.4706741258086,262,53,209,35.8541476628917,226.145852337108
"2000","gotta take",8.46865494635078,47,22,25,12.6470272989857,34.3529727010143
"2000","holding back",8.46812295378075,31,16,15,8.34165630358633,22.6583436964137
"2000","keep going",8.46812295378075,31,16,15,8.34165630358633,22.6583436964137
"2000","tattoo",8.46812295378075,31,16,15,8.34165630358633,22.6583436964137
"2000","beautiful youre",8.46553226419678,21,12,9,5.65079943146171,15.3492005685383
"2000","blunt",8.46553226419678,21,12,9,5.65079943146171,15.3492005685383
"2000","female",8.46553226419678,21,12,9,5.65079943146171,15.3492005685383
"2000","incomplete",8.46553226419678,21,12,9,5.65079943146171,15.3492005685383
"2000","noche",8.46553226419678,21,12,9,5.65079943146171,15.3492005685383
"2000","poke",8.46553226419678,21,12,9,5.65079943146171,15.3492005685383
"2000","said whatever",8.46553226419678,21,12,9,5.65079943146171,15.3492005685383
"2000","side dont",8.46553226419678,21,12,9,5.65079943146171,15.3492005685383
"2000","temperature",8.46553226419678,21,12,9,5.65079943146171,15.3492005685383
"2000","usually",8.46553226419678,21,12,9,5.65079943146171,15.3492005685383
"1970","dont walk",8.46508868251179,37,12,25,5.06337199819462,31.9366280018054
"1970","like fool",8.46508868251179,37,12,25,5.06337199819462,31.9366280018054
"1970","moon",8.46493782349024,268,54,214,36.6752350139502,231.32476498605
"1990","wants",8.46294749301673,557,147,410,118.164595632749,438.835404367251
"1970","afford",8.45982949088869,24,9,15,3.28434940423435,20.7156505957656
"1970","far cause",8.45982949088869,24,9,15,3.28434940423435,20.7156505957656
"1970","like long",8.45982949088869,24,9,15,3.28434940423435,20.7156505957656
"1970","oo oo",8.45982949088869,24,9,15,3.28434940423435,20.7156505957656
"2000","hear say",8.45571065254076,114,45,69,30.6757683422207,83.3242316577793
"1960","lane",8.45143054900717,60,10,50,3.58339640357244,56.4166035964276
"1980","hits",8.44748544045224,80,24,56,13.4588582114862,66.5411417885138
"1980","im gonna",8.44704725256562,1035,210,825,174.123978111103,860.876021888897
"2000","yeah know",8.4451422629455,111,44,67,29.8685112805833,81.1314887194167
"2000","chest",8.4434822426049,61,27,34,16.4142269199602,44.5857730800398
"2000","bump",8.43727114668702,108,43,65,29.0612542189459,78.9387457810541
"1970","believes",8.43364165518695,20,8,12,2.73695783686196,17.263042163138
"1970","come tonight",8.43364165518695,20,8,12,2.73695783686196,17.263042163138
"1970","keep loving",8.43364165518695,20,8,12,2.73695783686196,17.263042163138
"1970","light shine",8.43364165518695,20,8,12,2.73695783686196,17.263042163138
"1970","shine like",8.43364165518695,20,8,12,2.73695783686196,17.263042163138
"1970","stuck middle",8.43364165518695,20,8,12,2.73695783686196,17.263042163138
"2000","im still",8.4305658006661,214,77,137,57.5843370634669,156.415662936533
"2000","rap",8.4305541550493,102,41,61,27.4467400956712,74.5532599043289
"1970","dont say",8.42650986696634,124,29,95,16.9691385885441,107.030861411456
"1990","ghetto",8.42512681734492,79,28,51,16.759430978433,62.240569021567
"1990","neck",8.42512681734492,79,28,51,16.759430978433,62.240569021567
"1960","let tell",8.42133126570622,90,13,77,5.37509460535865,84.6249053946413
"2000","miss",8.41909945347398,717,228,489,192.934437731335,524.065562268665
"2010","needing",8.41094222185748,46,15,31,7.08228530300899,38.917714696991
"1990","reach",8.4085731242408,224,66,158,47.5204118882151,176.479588111785
"2010","skin",8.40334202534345,146,36,110,22.4785577008546,123.521442299145
"2010","type",8.40334202534345,146,36,110,22.4785577008546,123.521442299145
"1990","kinda",8.40025125643459,264,76,188,56.0061997253963,207.993800274604
"1980","last forever",8.39482467230116,63,20,43,10.5988508415454,52.4011491584546
"2010","hundred",8.3909448903475,121,31,90,18.6294896013932,102.370510398607
"2000","beep",8.38967342139073,26,14,12,6.99622786752402,19.003772132476
"2000","everyone knows",8.38967342139073,26,14,12,6.99622786752402,19.003772132476
"2000","idea",8.38967342139073,26,14,12,6.99622786752402,19.003772132476
"2000","oil",8.38967342139073,26,14,12,6.99622786752402,19.003772132476
"2000","yes youre",8.38967342139073,26,14,12,6.99622786752402,19.003772132476
"1990","lovely",8.38885742068802,127,41,86,26.9423763830505,100.057623616949
"1970","looks like",8.3838911545964,61,17,44,8.34772140242897,52.652278597571
"2000","dont lie",8.38209115389239,39,19,20,10.494341801286,28.505658198714
"1990","freeze",8.37913014475288,38,16,22,8.0614984453222,29.9385015546778
"1990","game play",8.37913014475288,38,16,22,8.0614984453222,29.9385015546778
"1990","partner",8.37913014475288,38,16,22,8.0614984453222,29.9385015546778
"1990","treated",8.37913014475288,38,16,22,8.0614984453222,29.9385015546778
"1990","want just",8.37797257600265,72,26,46,15.2744181069263,56.7255818930737
"1960","learning",8.37538021092749,42,8,34,2.50837748250071,39.4916225174993
"1960","ooo baby",8.37538021092749,42,8,34,2.50837748250071,39.4916225174993
"1960","sha",8.37538021092749,42,8,34,2.50837748250071,39.4916225174993
"2000","girl im",8.37536478658857,148,56,92,39.8246817074444,108.175318292556
"1960","many times",8.37437359915382,80,12,68,4.77786187142992,75.2221381285701
"1970","beautiful",8.36716534753624,515,94,421,70.4766642991954,444.523335700805
"1960","bang",8.35317680754297,239,26,213,14.2738623408969,224.726137659103
"1990","go ahead",8.35114974804079,101,34,67,21.4266142888827,79.5733857111173
"1960","wed",8.3510551565719,191,22,169,11.4071452180389,179.592854781961
"1960","hold hold",8.32731527052084,101,14,87,6.03205061268027,94.9679493873197
"1980","cause cant wait",8.32579132462685,17,8,9,2.86000736994083,14.1399926300592
"1980","dancing like",8.32579132462685,17,8,9,2.86000736994083,14.1399926300592
"1980","hand well",8.32579132462685,17,8,9,2.86000736994083,14.1399926300592
"1980","im givin",8.32579132462685,17,8,9,2.86000736994083,14.1399926300592
"1980","just talk",8.32579132462685,17,8,9,2.86000736994083,14.1399926300592
"1980","keep telling",8.32579132462685,17,8,9,2.86000736994083,14.1399926300592
"1980","keep thinking",8.32579132462685,17,8,9,2.86000736994083,14.1399926300592
"1980","lovewhen",8.32579132462685,17,8,9,2.86000736994083,14.1399926300592
"1980","now forever",8.32579132462685,17,8,9,2.86000736994083,14.1399926300592
"1980","relieve",8.32579132462685,17,8,9,2.86000736994083,14.1399926300592
"1980","say much",8.32579132462685,17,8,9,2.86000736994083,14.1399926300592
"1980","something cant",8.32579132462685,17,8,9,2.86000736994083,14.1399926300592
"1980","tonight come",8.32579132462685,17,8,9,2.86000736994083,14.1399926300592
"1980","walk alone",8.32579132462685,17,8,9,2.86000736994083,14.1399926300592
"2000","attitude",8.31778147172833,50,23,27,13.4542843606231,36.5457156393769
"2000","go take",8.31778147172833,50,23,27,13.4542843606231,36.5457156393769
"1990","come dance",8.30460540350194,48,19,29,10.1829454046175,37.8170545953825
"1980","fool",8.30266466160484,381,86,295,64.0978122322032,316.902187767797
"2010","yeah love",8.30125450505257,55,17,38,8.4679498188151,46.5320501811849
"2000","arm",8.29185651694338,67,29,38,18.028741043235,48.971258956765
"2000","white",8.28589637362797,315,108,207,84.7619914719256,230.238008528074
"2010","goi",8.28480718190056,42,14,28,6.46643440709516,35.5335655929048
"2010","yeah get",8.28480718190056,42,14,28,6.46643440709516,35.5335655929048
"1960","tell love",8.27941862159563,112,15,97,6.68900662000188,105.310993379998
"1980","crying",8.27770803130949,216,53,163,36.3389171710128,179.661082828987
"1970","ooo baby",8.27414216083613,42,13,29,5.74761145741011,36.2523885425899
"1970","things say",8.27414216083613,42,13,29,5.74761145741011,36.2523885425899
"1980","im never gonna",8.2673776491735,35,13,22,5.88825046752523,29.1117495324748
"1980","lake",8.2673776491735,35,13,22,5.88825046752523,29.1117495324748
"1980","shes gonna",8.2673776491735,35,13,22,5.88825046752523,29.1117495324748
"1980","time ill",8.2673776491735,35,13,22,5.88825046752523,29.1117495324748
"1980","woman can",8.2673776491735,35,13,22,5.88825046752523,29.1117495324748
"2010","tear",8.25886263344231,193,45,148,29.7148057278421,163.285194272158
"2010","can want",8.25865171173076,22,9,13,3.38717992752604,18.612820072474
"2010","give oh",8.25865171173076,22,9,13,3.38717992752604,18.612820072474
"2010","hey dont",8.25865171173076,22,9,13,3.38717992752604,18.612820072474
"2010","one life",8.25865171173076,22,9,13,3.38717992752604,18.612820072474
"2010","touch feel",8.25865171173076,22,9,13,3.38717992752604,18.612820072474
"1980","cure",8.25192672328765,55,18,37,9.25296502039679,45.7470349796032
"2010","chase",8.25013788838654,78,22,56,12.0090924703196,65.9909075296804
"1990","come oh",8.24866715612719,35,15,20,7.42506435753361,27.5749356424664
"1990","now like",8.24866715612719,35,15,20,7.42506435753361,27.5749356424664
"2000","across room",8.23493888758105,12,8,4,3.22902824654955,8.77097175345045
"2000","amaze",8.23493888758105,12,8,4,3.22902824654955,8.77097175345045
"2000","baby promise",8.23493888758105,12,8,4,3.22902824654955,8.77097175345045
"2000","better yet",8.23493888758105,12,8,4,3.22902824654955,8.77097175345045
"2000","bitch cant",8.23493888758105,12,8,4,3.22902824654955,8.77097175345045
"2000","burnt",8.23493888758105,12,8,4,3.22902824654955,8.77097175345045
"2000","buyin",8.23493888758105,12,8,4,3.22902824654955,8.77097175345045
"2000","come come baby",8.23493888758105,12,8,4,3.22902824654955,8.77097175345045
"2000","come spend",8.23493888758105,12,8,4,3.22902824654955,8.77097175345045
"2000","crazy got",8.23493888758105,12,8,4,3.22902824654955,8.77097175345045
"2000","deep breath",8.23493888758105,12,8,4,3.22902824654955,8.77097175345045
"2000","dot",8.23493888758105,12,8,4,3.22902824654955,8.77097175345045
"2000","even talk",8.23493888758105,12,8,4,3.22902824654955,8.77097175345045
"2000","ever tell",8.23493888758105,12,8,4,3.22902824654955,8.77097175345045
"2000","feelin alright",8.23493888758105,12,8,4,3.22902824654955,8.77097175345045
"2000","friendoh",8.23493888758105,12,8,4,3.22902824654955,8.77097175345045
"2000","give ya",8.23493888758105,12,8,4,3.22902824654955,8.77097175345045
"2000","got class",8.23493888758105,12,8,4,3.22902824654955,8.77097175345045
"2000","help feel",8.23493888758105,12,8,4,3.22902824654955,8.77097175345045
"2000","hoping youll",8.23493888758105,12,8,4,3.22902824654955,8.77097175345045
"2000","im just little",8.23493888758105,12,8,4,3.22902824654955,8.77097175345045
"2000","im love im",8.23493888758105,12,8,4,3.22902824654955,8.77097175345045
"2000","just gimme",8.23493888758105,12,8,4,3.22902824654955,8.77097175345045
"2000","light cause",8.23493888758105,12,8,4,3.22902824654955,8.77097175345045
"2000","make mistakes",8.23493888758105,12,8,4,3.22902824654955,8.77097175345045
"2000","mines",8.23493888758105,12,8,4,3.22902824654955,8.77097175345045
"2000","name aint",8.23493888758105,12,8,4,3.22902824654955,8.77097175345045
"2000","now done",8.23493888758105,12,8,4,3.22902824654955,8.77097175345045
"2000","really dont know",8.23493888758105,12,8,4,3.22902824654955,8.77097175345045
"2000","search find",8.23493888758105,12,8,4,3.22902824654955,8.77097175345045
"2000","see nigga",8.23493888758105,12,8,4,3.22902824654955,8.77097175345045
"2000","tim",8.23493888758105,12,8,4,3.22902824654955,8.77097175345045
"2000","will set",8.23493888758105,12,8,4,3.22902824654955,8.77097175345045
"2000","wont real",8.23493888758105,12,8,4,3.22902824654955,8.77097175345045
"1960","love ill",8.23434585126572,91,13,78,5.43481787875153,85.5651821212485
"2000","freaky",8.23311358049393,70,30,40,18.8359981048724,51.1640018951276
"2000","im gone",8.23311358049393,70,30,40,18.8359981048724,51.1640018951276
"1970","chance",8.22619719426455,510,93,417,69.7924248399799,440.20757516002
"1990","hop",8.22593100392924,120,39,81,25.4573635115438,94.5426364884562
"1970","chuck",8.22077168549008,33,11,22,4.51598043082223,28.4840195691778
"1970","turned around",8.22077168549008,33,11,22,4.51598043082223,28.4840195691778
"1990","bud",8.21566741002358,17,9,8,3.60645983080204,13.393540169198
"1990","caddy",8.21566741002358,17,9,8,3.60645983080204,13.393540169198
"1990","forever baby",8.21566741002358,17,9,8,3.60645983080204,13.393540169198
"1990","give can",8.21566741002358,17,9,8,3.60645983080204,13.393540169198
"1990","go find",8.21566741002358,17,9,8,3.60645983080204,13.393540169198
"1990","inside heart",8.21566741002358,17,9,8,3.60645983080204,13.393540169198
"1990","know ill make",8.21566741002358,17,9,8,3.60645983080204,13.393540169198
"1990","loveso",8.21566741002358,17,9,8,3.60645983080204,13.393540169198
"1990","make baby",8.21566741002358,17,9,8,3.60645983080204,13.393540169198
"1990","notes",8.21566741002358,17,9,8,3.60645983080204,13.393540169198
"1990","one get",8.21566741002358,17,9,8,3.60645983080204,13.393540169198
"1990","step back",8.21566741002358,17,9,8,3.60645983080204,13.393540169198
"1990","thee",8.21566741002358,17,9,8,3.60645983080204,13.393540169198
"1990","way life",8.21566741002358,17,9,8,3.60645983080204,13.393540169198
"1980","red red",8.21399009460038,72,22,50,12.1129723903376,59.8870276096624
"1960","billy",8.21324269565139,61,10,51,3.64311967696531,57.3568803230347
"1960","john",8.21324269565139,61,10,51,3.64311967696531,57.3568803230347
"1990","ah ah",8.20867559416116,213,63,150,45.1868202329902,167.81317976701
"1980","aware",8.20427981331867,24,10,14,4.03765746344587,19.9623425365541
"1980","divine",8.20427981331867,24,10,14,4.03765746344587,19.9623425365541
"1980","face face",8.20427981331867,24,10,14,4.03765746344587,19.9623425365541
"1980","get free",8.20427981331867,24,10,14,4.03765746344587,19.9623425365541
"1980","miss miss",8.20427981331867,24,10,14,4.03765746344587,19.9623425365541
"1980","weary",8.20427981331867,24,10,14,4.03765746344587,19.9623425365541
"1960","dont just",8.20326319362792,34,7,27,2.03059129535771,31.9694087046423
"1960","drums",8.20326319362792,34,7,27,2.03059129535771,31.9694087046423
"1960","old man",8.20326319362792,34,7,27,2.03059129535771,31.9694087046423
"1980","maybe can",8.20280759940235,51,17,34,8.58002210982247,42.4199778901775
"1980","will find",8.19722782465328,94,27,67,15.8141583984963,78.1858416015037
"1980","kiss kiss",8.19679429964313,39,14,25,6.56119337809954,32.4388066219005
"1980","master",8.19679429964313,39,14,25,6.56119337809954,32.4388066219005
"1980","never change",8.19679429964313,39,14,25,6.56119337809954,32.4388066219005
"2000","like ive",8.1902434786082,53,24,29,14.2615414222605,38.7384585777395
"1960","im gonna tell",8.18902882286262,26,6,20,1.55280510821472,24.4471948917853
"1960","sweet baby",8.18902882286262,26,6,20,1.55280510821472,24.4471948917853
"2010","gone gone",8.1826830478255,38,13,25,5.85058351118134,32.1494164888187
"2010","gonna show",8.1826830478255,38,13,25,5.85058351118134,32.1494164888187
"2010","like say",8.1826830478255,38,13,25,5.85058351118134,32.1494164888187
"2010","match",8.1826830478255,38,13,25,5.85058351118134,32.1494164888187
"1980","pop pop",8.17340848102816,47,16,31,7.90707919924816,39.0929208007518
"1980","maybe im",8.16897039180129,43,15,28,7.23413628867385,35.7658637113261
"2000","ice",8.16810965214967,215,77,138,57.8534227506794,157.146577249321
"1960","deep",8.16188148044441,606,54,552,36.1923036760816,569.807696323918
"2010","sip",8.15762243377277,83,23,60,12.7789060902119,70.2210939097881
"1970","baby love",8.15729660168716,270,54,216,36.9489307976364,233.051069202364
"2010","waitin",8.15704137231098,142,35,107,21.8627068049408,120.137293195059
"2000","ever see",8.15626321069218,34,17,17,9.14891336522372,24.8510866347763
"2000","remains",8.15626321069218,34,17,17,9.14891336522372,24.8510866347763
"2000","right now im",8.15626321069218,34,17,17,9.14891336522372,24.8510866347763
"2000","wearin",8.15626321069218,34,17,17,9.14891336522372,24.8510866347763
"1990","spending",8.15290991463696,69,25,44,14.6379840191377,54.3620159808623
"1970","hand hand",8.15086367225432,47,14,33,6.4318509166256,40.5681490833744
"1970","youd better",8.15086367225432,47,14,33,6.4318509166256,40.5681490833744
"2000","ill show",8.143140082323,76,32,44,20.4505122281471,55.5494877718529
"2010","already got",8.141997073653,15,7,8,2.30944085967684,12.6905591403232
"2010","baby know im",8.141997073653,15,7,8,2.30944085967684,12.6905591403232
"2010","buns",8.141997073653,15,7,8,2.30944085967684,12.6905591403232
"2010","cali",8.141997073653,15,7,8,2.30944085967684,12.6905591403232
"2010","care youre",8.141997073653,15,7,8,2.30944085967684,12.6905591403232
"2010","cooking",8.141997073653,15,7,8,2.30944085967684,12.6905591403232
"2010","corn",8.141997073653,15,7,8,2.30944085967684,12.6905591403232
"2010","dancing dark",8.141997073653,15,7,8,2.30944085967684,12.6905591403232
"2010","eighty degrees",8.141997073653,15,7,8,2.30944085967684,12.6905591403232
"2010","girl im gonna",8.141997073653,15,7,8,2.30944085967684,12.6905591403232
"2010","hold night",8.141997073653,15,7,8,2.30944085967684,12.6905591403232
"2010","itcause",8.141997073653,15,7,8,2.30944085967684,12.6905591403232
"2010","lady oh",8.141997073653,15,7,8,2.30944085967684,12.6905591403232
"2010","lighter",8.141997073653,15,7,8,2.30944085967684,12.6905591403232
"2010","like dog",8.141997073653,15,7,8,2.30944085967684,12.6905591403232
"2010","living like",8.141997073653,15,7,8,2.30944085967684,12.6905591403232
"2010","riddle",8.141997073653,15,7,8,2.30944085967684,12.6905591403232
"2010","three got",8.141997073653,15,7,8,2.30944085967684,12.6905591403232
"2010","tonightoh",8.141997073653,15,7,8,2.30944085967684,12.6905591403232
"2010","turn im",8.141997073653,15,7,8,2.30944085967684,12.6905591403232
"2010","want move",8.141997073653,15,7,8,2.30944085967684,12.6905591403232
"2010","will carry",8.141997073653,15,7,8,2.30944085967684,12.6905591403232
"2010","youoh oh",8.141997073653,15,7,8,2.30944085967684,12.6905591403232
"2010","youyeah",8.141997073653,15,7,8,2.30944085967684,12.6905591403232
"1990","can start",8.13738848010778,32,14,18,6.78863026974501,25.211369730255
"1990","need want",8.13738848010778,32,14,18,6.78863026974501,25.211369730255
"1990","thin",8.13738848010778,32,14,18,6.78863026974501,25.211369730255
"1960","good good",8.13298300202493,181,21,160,10.8099124841102,170.19008751589
"1970","hot",8.12735834985365,949,161,788,129.8686493591,819.1313506409
"1990","sometimes",8.12546953385146,442,119,323,93.767955600853,348.232044399147
"2010","back bring",8.12455563692562,26,10,16,4.00303082343986,21.9969691765601
"2010","ever love",8.12455563692562,26,10,16,4.00303082343986,21.9969691765601
"1980","cry never",8.12421380407904,14,7,7,2.35530018701009,11.6446998129899
"1980","dance oh",8.12421380407904,14,7,7,2.35530018701009,11.6446998129899
"1980","eyes look",8.12421380407904,14,7,7,2.35530018701009,11.6446998129899
"1980","falling falling",8.12421380407904,14,7,7,2.35530018701009,11.6446998129899
"1980","feelins",8.12421380407904,14,7,7,2.35530018701009,11.6446998129899
"1980","give take",8.12421380407904,14,7,7,2.35530018701009,11.6446998129899
"1980","gonna take time",8.12421380407904,14,7,7,2.35530018701009,11.6446998129899
"1980","gonna wanna",8.12421380407904,14,7,7,2.35530018701009,11.6446998129899
"1980","know youre one",8.12421380407904,14,7,7,2.35530018701009,11.6446998129899
"1980","mattered",8.12421380407904,14,7,7,2.35530018701009,11.6446998129899
"1980","never ask",8.12421380407904,14,7,7,2.35530018701009,11.6446998129899
"1980","one hold",8.12421380407904,14,7,7,2.35530018701009,11.6446998129899
"1980","running away",8.12421380407904,14,7,7,2.35530018701009,11.6446998129899
"1980","sad song",8.12421380407904,14,7,7,2.35530018701009,11.6446998129899
"1980","soon will",8.12421380407904,14,7,7,2.35530018701009,11.6446998129899
"1980","thief",8.12421380407904,14,7,7,2.35530018701009,11.6446998129899
"1980","took heart",8.12421380407904,14,7,7,2.35530018701009,11.6446998129899
"1990","cream",8.12313198617559,87,30,57,18.4565885458693,68.5434114541307
"2010","drums",8.11262784935573,34,12,22,5.23473261526751,28.7652673847325
"2010","now hold",8.11262784935573,34,12,22,5.23473261526751,28.7652673847325
"2010","ooh whoa ooh whoa",8.11262784935573,34,12,22,5.23473261526751,28.7652673847325
"2010","way make feel",8.11262784935573,34,12,22,5.23473261526751,28.7652673847325
"1980","know ive",8.10649627005895,68,21,47,11.4400294797633,56.5599705202367
"1960","advice",8.10447943275825,52,9,43,3.10561021642945,48.8943897835706
"2010","ya got",8.09801118367531,60,18,42,9.23776343870738,50.7622365612926
"2000","number",8.09620779517394,241,85,156,64.8496506182034,176.150349381797
"2000","somethin",8.09022463760414,293,101,192,78.8421063532514,214.157893646749
"2010","cell",8.08680962169235,30,11,19,4.61888171935369,25.3811182806463
"2010","crashing",8.08680962169235,30,11,19,4.61888171935369,25.3811182806463
"2010","healing",8.08680962169235,30,11,19,4.61888171935369,25.3811182806463
"2010","kiss lips",8.08680962169235,30,11,19,4.61888171935369,25.3811182806463
"1980","youll",8.08656543324052,1377,272,1105,231.660596965207,1145.33940303479
"1970","la la la la",8.08525537313774,1002,169,833,137.121587626784,864.878412373216
"1970","wife",8.08480189351388,131,30,101,17.9270738314458,113.072926168554
"2000","legs",8.0832524148707,82,34,48,22.0650263514219,59.9349736485781
"2000","im good",8.08233988001656,56,25,31,15.0687984838979,40.9312015161021
"1960","feel alright",8.08142894151353,43,8,35,2.56810075589358,40.4318992441064
"2000","love dont",8.07842415870387,280,97,183,75.3439924194894,204.656007580511
"1970","best can",8.07680406681661,52,15,37,7.11609037584109,44.8839096241589
"1970","hills",8.07680406681661,52,15,37,7.11609037584109,44.8839096241589
"1970","back home",8.07676327132891,72,19,53,9.85304821270305,62.146951787297
"1970","poor",8.07676327132891,72,19,53,9.85304821270305,62.146951787297
"1980","back cant",8.07252850941966,11,6,5,1.85059300407936,9.14940699592064
"1980","buy time",8.07252850941966,11,6,5,1.85059300407936,9.14940699592064
"1980","call anytime",8.07252850941966,11,6,5,1.85059300407936,9.14940699592064
"1980","can forget",8.07252850941966,11,6,5,1.85059300407936,9.14940699592064
"1980","cause words",8.07252850941966,11,6,5,1.85059300407936,9.14940699592064
"1980","day done",8.07252850941966,11,6,5,1.85059300407936,9.14940699592064
"1980","dont break heart",8.07252850941966,11,6,5,1.85059300407936,9.14940699592064
"1980","dont fool",8.07252850941966,11,6,5,1.85059300407936,9.14940699592064
"1980","dont wanna break",8.07252850941966,11,6,5,1.85059300407936,9.14940699592064
"1980","feelings right",8.07252850941966,11,6,5,1.85059300407936,9.14940699592064
"1980","forever ill",8.07252850941966,11,6,5,1.85059300407936,9.14940699592064
"1980","give one night",8.07252850941966,11,6,5,1.85059300407936,9.14940699592064
"1980","go dont wanna",8.07252850941966,11,6,5,1.85059300407936,9.14940699592064
"1980","gone ive",8.07252850941966,11,6,5,1.85059300407936,9.14940699592064
"1980","gonna say goodbye",8.07252850941966,11,6,5,1.85059300407936,9.14940699592064
"1980","goodbye never",8.07252850941966,11,6,5,1.85059300407936,9.14940699592064
"1980","hearts fire",8.07252850941966,11,6,5,1.85059300407936,9.14940699592064
"1980","hey say",8.07252850941966,11,6,5,1.85059300407936,9.14940699592064
"1980","hot girls",8.07252850941966,11,6,5,1.85059300407936,9.14940699592064
"1980","im gonna live",8.07252850941966,11,6,5,1.85059300407936,9.14940699592064
"1980","innocent man",8.07252850941966,11,6,5,1.85059300407936,9.14940699592064
"1980","just blows",8.07252850941966,11,6,5,1.85059300407936,9.14940699592064
"1980","knew right",8.07252850941966,11,6,5,1.85059300407936,9.14940699592064
"1980","little bit harder",8.07252850941966,11,6,5,1.85059300407936,9.14940699592064
"1980","live now",8.07252850941966,11,6,5,1.85059300407936,9.14940699592064
"1980","love need love love",8.07252850941966,11,6,5,1.85059300407936,9.14940699592064
"1980","make lose control",8.07252850941966,11,6,5,1.85059300407936,9.14940699592064
"1980","move gotta",8.07252850941966,11,6,5,1.85059300407936,9.14940699592064
"1980","much wanna",8.07252850941966,11,6,5,1.85059300407936,9.14940699592064
"1980","need change",8.07252850941966,11,6,5,1.85059300407936,9.14940699592064
"1980","nobodys gonna",8.07252850941966,11,6,5,1.85059300407936,9.14940699592064
"1980","ohand",8.07252850941966,11,6,5,1.85059300407936,9.14940699592064
"1980","show much",8.07252850941966,11,6,5,1.85059300407936,9.14940699592064
"1980","stay love",8.07252850941966,11,6,5,1.85059300407936,9.14940699592064
"1980","sugar ooh",8.07252850941966,11,6,5,1.85059300407936,9.14940699592064
"1980","youll just",8.07252850941966,11,6,5,1.85059300407936,9.14940699592064
"1980","youre part",8.07252850941966,11,6,5,1.85059300407936,9.14940699592064
"1990","friend",8.06815762743867,649,168,481,137.681907658266,511.318092341734
"1990","can believe",8.0526635659669,20,10,10,4.24289391859063,15.7571060814094
"1990","ive ever seen",8.0526635659669,20,10,10,4.24289391859063,15.7571060814094
"1990","like time",8.0526635659669,20,10,10,4.24289391859063,15.7571060814094
"1990","oh night oh",8.0526635659669,20,10,10,4.24289391859063,15.7571060814094
"1990","right one",8.0526635659669,20,10,10,4.24289391859063,15.7571060814094
"1990","time place",8.0526635659669,20,10,10,4.24289391859063,15.7571060814094
"1990","amor",8.05112527289948,29,13,16,6.15219618195642,22.8478038180436
"1990","find place",8.05112527289948,29,13,16,6.15219618195642,22.8478038180436
"1990","gave heart",8.05112527289948,29,13,16,6.15219618195642,22.8478038180436
"1990","na nana na",8.05112527289948,29,13,16,6.15219618195642,22.8478038180436
"1990","nana na",8.05112527289948,29,13,16,6.15219618195642,22.8478038180436
"1990","nobody knows",8.05112527289948,29,13,16,6.15219618195642,22.8478038180436
"1990","see like",8.05112527289948,29,13,16,6.15219618195642,22.8478038180436
"1990","tight dont",8.05112527289948,29,13,16,6.15219618195642,22.8478038180436
"1960","got get",8.05102370059155,92,13,79,5.4945411521444,86.5054588478556
"1960","surprise",8.05102370059155,92,13,79,5.4945411521444,86.5054588478556
"2000","never let go",8.04740120159163,88,36,52,23.6795404746967,64.3204595253033
"1980","walking",8.04718256988636,227,55,172,38.1895101750922,188.810489824908
"2010","talking",8.04674537444751,323,69,254,49.7299598450414,273.270040154959
"1970","promised",8.04493658194386,67,18,49,9.16880875348756,57.8311912465124
"2000","aint big",8.04162397445466,10,7,3,2.69085687212462,7.30914312787538
"2000","anyone know",8.04162397445466,10,7,3,2.69085687212462,7.30914312787538
"2000","baby alright",8.04162397445466,10,7,3,2.69085687212462,7.30914312787538
"2000","clothes im",8.04162397445466,10,7,3,2.69085687212462,7.30914312787538
"2000","cross mind",8.04162397445466,10,7,3,2.69085687212462,7.30914312787538
"2000","ever now",8.04162397445466,10,7,3,2.69085687212462,7.30914312787538
"2000","fancy clothes",8.04162397445466,10,7,3,2.69085687212462,7.30914312787538
"2000","five six",8.04162397445466,10,7,3,2.69085687212462,7.30914312787538
"2000","froze",8.04162397445466,10,7,3,2.69085687212462,7.30914312787538
"2000","getting high",8.04162397445466,10,7,3,2.69085687212462,7.30914312787538
"2000","good got",8.04162397445466,10,7,3,2.69085687212462,7.30914312787538
"2000","good thats",8.04162397445466,10,7,3,2.69085687212462,7.30914312787538
"2000","goodbye know",8.04162397445466,10,7,3,2.69085687212462,7.30914312787538
"2000","got bomb",8.04162397445466,10,7,3,2.69085687212462,7.30914312787538
"2000","got house",8.04162397445466,10,7,3,2.69085687212462,7.30914312787538
"2000","ill best",8.04162397445466,10,7,3,2.69085687212462,7.30914312787538
"2000","ill love forever",8.04162397445466,10,7,3,2.69085687212462,7.30914312787538
"2000","im take",8.04162397445466,10,7,3,2.69085687212462,7.30914312787538
"2000","ima keep",8.04162397445466,10,7,3,2.69085687212462,7.30914312787538
"2000","itso",8.04162397445466,10,7,3,2.69085687212462,7.30914312787538
"2000","just ride",8.04162397445466,10,7,3,2.69085687212462,7.30914312787538
"2000","keep rockin",8.04162397445466,10,7,3,2.69085687212462,7.30914312787538
"2000","last day",8.04162397445466,10,7,3,2.69085687212462,7.30914312787538
"2000","long sing",8.04162397445466,10,7,3,2.69085687212462,7.30914312787538
"2000","love baby know",8.04162397445466,10,7,3,2.69085687212462,7.30914312787538
"2000","now another",8.04162397445466,10,7,3,2.69085687212462,7.30914312787538
"2000","oh whats",8.04162397445466,10,7,3,2.69085687212462,7.30914312787538
"2000","quarters",8.04162397445466,10,7,3,2.69085687212462,7.30914312787538
"2000","side just",8.04162397445466,10,7,3,2.69085687212462,7.30914312787538
"2000","smarter",8.04162397445466,10,7,3,2.69085687212462,7.30914312787538
"2000","stay now",8.04162397445466,10,7,3,2.69085687212462,7.30914312787538
"2000","swing hips",8.04162397445466,10,7,3,2.69085687212462,7.30914312787538
"2000","tap",8.04162397445466,10,7,3,2.69085687212462,7.30914312787538
"2000","timbaland",8.04162397445466,10,7,3,2.69085687212462,7.30914312787538
"2000","time shes",8.04162397445466,10,7,3,2.69085687212462,7.30914312787538
"2000","understand baby",8.04162397445466,10,7,3,2.69085687212462,7.30914312787538
"2000","upim",8.04162397445466,10,7,3,2.69085687212462,7.30914312787538
"2000","want think",8.04162397445466,10,7,3,2.69085687212462,7.30914312787538
"2000","whered",8.04162397445466,10,7,3,2.69085687212462,7.30914312787538
"2000","wonder youre",8.04162397445466,10,7,3,2.69085687212462,7.30914312787538
"2000","wont put",8.04162397445466,10,7,3,2.69085687212462,7.30914312787538
"2000","youre acting",8.04162397445466,10,7,3,2.69085687212462,7.30914312787538
"1970","kissin",8.03970856239495,57,16,41,7.80032983505658,49.1996701649434
"1970","never will",8.03970856239495,57,16,41,7.80032983505658,49.1996701649434
"1990","voices",8.0336398144231,80,28,52,16.9715756743625,63.0284243256375
"1980","someone",8.03298408556701,862,177,685,145.019197228764,716.980802771236
"2000","baby im one",8.03138321062935,19,11,8,5.11262805703678,13.8873719429632
"2000","chi",8.03138321062935,19,11,8,5.11262805703678,13.8873719429632
"2000","even im",8.03138321062935,19,11,8,5.11262805703678,13.8873719429632
"2000","gon give",8.03138321062935,19,11,8,5.11262805703678,13.8873719429632
"2000","hated",8.03138321062935,19,11,8,5.11262805703678,13.8873719429632
"2000","one cause",8.03138321062935,19,11,8,5.11262805703678,13.8873719429632
"2000","said can",8.03138321062935,19,11,8,5.11262805703678,13.8873719429632
"2000","tried make",8.03138321062935,19,11,8,5.11262805703678,13.8873719429632
"2000","try love",8.03138321062935,19,11,8,5.11262805703678,13.8873719429632
"2000","talkin bout",8.03106268652481,94,38,56,25.2940545979715,68.7059454020285
"2010","roof",8.03014332184932,163,39,124,25.0959240084884,137.904075991512
"2010","runs",8.02366412297962,93,25,68,14.3185333299964,78.6814666700036
"1970","ive",8.02218643485359,2652,414,2238,362.920609167896,2289.0793908321
"2000","cant wait",8.01928839310672,146,55,91,39.2865103330195,106.71348966698
"2000","better",8.01278818921803,1655,497,1158,445.336812336625,1209.66318766337
"2000","ah got",8.00917879054757,8,6,2,2.1526854976997,5.8473145023003
"2000","ahyou",8.00917879054757,8,6,2,2.1526854976997,5.8473145023003
"2000","aint come",8.00917879054757,8,6,2,2.1526854976997,5.8473145023003
"2000","aint never seen",8.00917879054757,8,6,2,2.1526854976997,5.8473145023003
"2000","away much love",8.00917879054757,8,6,2,2.1526854976997,5.8473145023003
"2000","battlefield love",8.00917879054757,8,6,2,2.1526854976997,5.8473145023003
"2000","beat drum",8.00917879054757,8,6,2,2.1526854976997,5.8473145023003
"2000","better think twice",8.00917879054757,8,6,2,2.1526854976997,5.8473145023003
"2000","big green",8.00917879054757,8,6,2,2.1526854976997,5.8473145023003
"2000","breathe air",8.00917879054757,8,6,2,2.1526854976997,5.8473145023003
"2000","can friends",8.00917879054757,8,6,2,2.1526854976997,5.8473145023003
"2000","can make see",8.00917879054757,8,6,2,2.1526854976997,5.8473145023003
"2000","car keys",8.00917879054757,8,6,2,2.1526854976997,5.8473145023003
"2000","charming",8.00917879054757,8,6,2,2.1526854976997,5.8473145023003
"2000","chorus come",8.00917879054757,8,6,2,2.1526854976997,5.8473145023003
"2000","come club",8.00917879054757,8,6,2,2.1526854976997,5.8473145023003
"2000","complicate",8.00917879054757,8,6,2,2.1526854976997,5.8473145023003
"2000","dammit",8.00917879054757,8,6,2,2.1526854976997,5.8473145023003
"2000","dirty south",8.00917879054757,8,6,2,2.1526854976997,5.8473145023003
"2000","dj play",8.00917879054757,8,6,2,2.1526854976997,5.8473145023003
"2000","dont please",8.00917879054757,8,6,2,2.1526854976997,5.8473145023003
"2000","downand",8.00917879054757,8,6,2,2.1526854976997,5.8473145023003
"2000","dread",8.00917879054757,8,6,2,2.1526854976997,5.8473145023003
"2000","early mornin",8.00917879054757,8,6,2,2.1526854976997,5.8473145023003
"2000","eighteen years",8.00917879054757,8,6,2,2.1526854976997,5.8473145023003
"2000","every day baby",8.00917879054757,8,6,2,2.1526854976997,5.8473145023003
"2000","exchange",8.00917879054757,8,6,2,2.1526854976997,5.8473145023003
"2000","feeling alright",8.00917879054757,8,6,2,2.1526854976997,5.8473145023003
"2000","get big",8.00917879054757,8,6,2,2.1526854976997,5.8473145023003
"2000","get just gotta",8.00917879054757,8,6,2,2.1526854976997,5.8473145023003
"2000","get just gotta get",8.00917879054757,8,6,2,2.1526854976997,5.8473145023003
"2000","give long",8.00917879054757,8,6,2,2.1526854976997,5.8473145023003
"2000","go better",8.00917879054757,8,6,2,2.1526854976997,5.8473145023003
"2000","gonna go far",8.00917879054757,8,6,2,2.1526854976997,5.8473145023003
"2000","got going crazy",8.00917879054757,8,6,2,2.1526854976997,5.8473145023003
"2000","guess guess",8.00917879054757,8,6,2,2.1526854976997,5.8473145023003
"2000","hands sky",8.00917879054757,8,6,2,2.1526854976997,5.8473145023003
"2000","hold dont want",8.00917879054757,8,6,2,2.1526854976997,5.8473145023003
"2000","hurry im",8.00917879054757,8,6,2,2.1526854976997,5.8473145023003
"2000","id one",8.00917879054757,8,6,2,2.1526854976997,5.8473145023003
"2000","ill open",8.00917879054757,8,6,2,2.1526854976997,5.8473145023003
"2000","im burnin",8.00917879054757,8,6,2,2.1526854976997,5.8473145023003
"2000","ituh",8.00917879054757,8,6,2,2.1526854976997,5.8473145023003
"2000","just cant let",8.00917879054757,8,6,2,2.1526854976997,5.8473145023003
"2000","knows oh",8.00917879054757,8,6,2,2.1526854976997,5.8473145023003
"2000","knows think",8.00917879054757,8,6,2,2.1526854976997,5.8473145023003
"2000","laugh cry",8.00917879054757,8,6,2,2.1526854976997,5.8473145023003
"2000","letter wrote",8.00917879054757,8,6,2,2.1526854976997,5.8473145023003
"2000","like job",8.00917879054757,8,6,2,2.1526854976997,5.8473145023003
"2000","long cant",8.00917879054757,8,6,2,2.1526854976997,5.8473145023003
"2000","lost got",8.00917879054757,8,6,2,2.1526854976997,5.8473145023003
"2000","man gotta",8.00917879054757,8,6,2,2.1526854976997,5.8473145023003
"2000","mineso",8.00917879054757,8,6,2,2.1526854976997,5.8473145023003
"2000","minewhen",8.00917879054757,8,6,2,2.1526854976997,5.8473145023003
"2000","never looking back",8.00917879054757,8,6,2,2.1526854976997,5.8473145023003
"2000","nigga got",8.00917879054757,8,6,2,2.1526854976997,5.8473145023003
"2000","ooh ooh dont",8.00917879054757,8,6,2,2.1526854976997,5.8473145023003
"2000","ooh ooh ooh dont",8.00917879054757,8,6,2,2.1526854976997,5.8473145023003
"2000","ooh shell",8.00917879054757,8,6,2,2.1526854976997,5.8473145023003
"2000","pain will",8.00917879054757,8,6,2,2.1526854976997,5.8473145023003
"2000","persuasive",8.00917879054757,8,6,2,2.1526854976997,5.8473145023003
"2000","play come",8.00917879054757,8,6,2,2.1526854976997,5.8473145023003
"2000","real hard",8.00917879054757,8,6,2,2.1526854976997,5.8473145023003
"2000","rest im",8.00917879054757,8,6,2,2.1526854976997,5.8473145023003
"2000","rock dont",8.00917879054757,8,6,2,2.1526854976997,5.8473145023003
"2000","save world",8.00917879054757,8,6,2,2.1526854976997,5.8473145023003
"2000","say couldnt",8.00917879054757,8,6,2,2.1526854976997,5.8473145023003
"2000","shoved",8.00917879054757,8,6,2,2.1526854976997,5.8473145023003
"2000","somehow know",8.00917879054757,8,6,2,2.1526854976997,5.8473145023003
"2000","sos",8.00917879054757,8,6,2,2.1526854976997,5.8473145023003
"2000","spilling",8.00917879054757,8,6,2,2.1526854976997,5.8473145023003
"2000","stand just",8.00917879054757,8,6,2,2.1526854976997,5.8473145023003
"2000","stop go",8.00917879054757,8,6,2,2.1526854976997,5.8473145023003
"2000","stop looking",8.00917879054757,8,6,2,2.1526854976997,5.8473145023003
"2000","take advantage",8.00917879054757,8,6,2,2.1526854976997,5.8473145023003
"2000","take wheel",8.00917879054757,8,6,2,2.1526854976997,5.8473145023003
"2000","think days",8.00917879054757,8,6,2,2.1526854976997,5.8473145023003
"2000","time please",8.00917879054757,8,6,2,2.1526854976997,5.8473145023003
"2000","touch got",8.00917879054757,8,6,2,2.1526854976997,5.8473145023003
"2000","wanna throw",8.00917879054757,8,6,2,2.1526854976997,5.8473145023003
"2000","wit girl",8.00917879054757,8,6,2,2.1526854976997,5.8473145023003
"2000","worlds got",8.00917879054757,8,6,2,2.1526854976997,5.8473145023003
"2000","youre oh",8.00917879054757,8,6,2,2.1526854976997,5.8473145023003
"2000","youre phone",8.00917879054757,8,6,2,2.1526854976997,5.8473145023003
"2000","youre touchin",8.00917879054757,8,6,2,2.1526854976997,5.8473145023003
"1970","give little bit",8.00717513502326,29,10,19,3.96858886344984,25.0314111365502
"1970","like lady",8.00717513502326,29,10,19,3.96858886344984,25.0314111365502
"1980","girl oh",8.00665577235718,64,20,44,10.767086569189,53.232913430811
"1980","love tonight",8.00665577235718,64,20,44,10.767086569189,53.232913430811
"1990","dont waste",7.99836911410509,26,12,14,5.51576209416782,20.4842379058322
"1990","eatin",7.99836911410509,26,12,14,5.51576209416782,20.4842379058322
"1990","helping",7.99836911410509,26,12,14,5.51576209416782,20.4842379058322
"1990","just girl",7.99836911410509,26,12,14,5.51576209416782,20.4842379058322
"1990","make wish",7.99836911410509,26,12,14,5.51576209416782,20.4842379058322
"1990","scent",7.99836911410509,26,12,14,5.51576209416782,20.4842379058322
"1960","wouldnt",7.99407931352754,421,40,381,25.1434980983999,395.8565019016
"1990","call mr",7.99200919145908,23,11,12,4.87932800637923,18.1206719936208
"1990","came home",7.99200919145908,23,11,12,4.87932800637923,18.1206719936208
"1990","get inside",7.99200919145908,23,11,12,4.87932800637923,18.1206719936208
"1990","ill back",7.99200919145908,23,11,12,4.87932800637923,18.1206719936208
"1990","long time ago",7.99200919145908,23,11,12,4.87932800637923,18.1206719936208
"1990","love will find",7.99200919145908,23,11,12,4.87932800637923,18.1206719936208
"1990","see cause",7.99200919145908,23,11,12,4.87932800637923,18.1206719936208
"2000","screamin",7.99111897554198,59,26,33,15.8760555455353,43.1239444544647
"2000","give ill",7.99056869909455,29,15,14,7.80348492916141,21.1965150708386
"2000","pill",7.99056869909455,29,15,14,7.80348492916141,21.1965150708386
"2000","putting",7.99056869909455,29,15,14,7.80348492916141,21.1965150708386
"1970","love little",7.98802350933275,38,12,26,5.20021989003772,32.7997801099623
"1970","need just",7.98802350933275,38,12,26,5.20021989003772,32.7997801099623
"1990","heart just",7.98672349187466,52,20,32,11.0315241883356,40.9684758116644
"1990","troubles",7.98672349187466,52,20,32,11.0315241883356,40.9684758116644
"1990","want take",7.98672349187466,52,20,32,11.0315241883356,40.9684758116644
"1970","bad girls",7.9820962818857,13,6,7,1.77902259396027,11.2209774060397
"1970","gloom",7.9820962818857,13,6,7,1.77902259396027,11.2209774060397
"1970","got first",7.9820962818857,13,6,7,1.77902259396027,11.2209774060397
"1970","got lover",7.9820962818857,13,6,7,1.77902259396027,11.2209774060397
"1970","hot love",7.9820962818857,13,6,7,1.77902259396027,11.2209774060397
"1970","im losin",7.9820962818857,13,6,7,1.77902259396027,11.2209774060397
"1970","just wouldnt",7.9820962818857,13,6,7,1.77902259396027,11.2209774060397
"1970","makes smile",7.9820962818857,13,6,7,1.77902259396027,11.2209774060397
"1970","matter anyway",7.9820962818857,13,6,7,1.77902259396027,11.2209774060397
"1970","sing love",7.9820962818857,13,6,7,1.77902259396027,11.2209774060397
"1970","summer summer",7.9820962818857,13,6,7,1.77902259396027,11.2209774060397
"1970","time keeps",7.9820962818857,13,6,7,1.77902259396027,11.2209774060397
"1970","used run",7.9820962818857,13,6,7,1.77902259396027,11.2209774060397
"1970","wind blowing",7.9820962818857,13,6,7,1.77902259396027,11.2209774060397
"1990","can love",7.96656305092094,73,26,47,15.4865628028558,57.5134371971442
"1990","cant cant",7.96656305092094,73,26,47,15.4865628028558,57.5134371971442
"1990","can get",7.96095468193584,356,98,258,75.5235117509133,280.476488249087
"1980","right oh",7.95506922402765,28,11,17,4.71060037402018,23.2893996259798
"1980","say yeah yeah",7.95506922402765,28,11,17,4.71060037402018,23.2893996259798
"1960","love much",7.95001215107316,72,11,61,4.30007568428692,67.6999243157131
"2000","bag",7.94984451882382,140,53,87,37.6719962097447,102.328003790255
"2010","hurts",7.94847666119088,148,36,112,22.7864831488115,125.213516851188
"1990","know let",7.9473866299195,42,17,25,8.91007722904033,33.0899227709597
"2010","beer",7.93469641590601,65,19,46,10.0075770585997,54.9924229414003
"1990","love true",7.93041174480541,59,22,37,12.5165370598424,46.4834629401576
"1990","need one",7.93041174480541,59,22,37,12.5165370598424,46.4834629401576
"1990","need someone",7.93041174480541,59,22,37,12.5165370598424,46.4834629401576
"1990","baby wanna",7.92879762649879,66,24,42,14.0015499313491,51.9984500686509
"1990","huh huh",7.92879762649879,66,24,42,14.0015499313491,51.9984500686509
"2000","beautiful girl",7.92275510212724,24,13,11,6.45805649309909,17.5419435069009
"2000","charm",7.92275510212724,24,13,11,6.45805649309909,17.5419435069009
"2000","girli",7.92275510212724,24,13,11,6.45805649309909,17.5419435069009
"2000","hope know",7.92275510212724,24,13,11,6.45805649309909,17.5419435069009
"2000","like think",7.92275510212724,24,13,11,6.45805649309909,17.5419435069009
"2000","love like love",7.92275510212724,24,13,11,6.45805649309909,17.5419435069009
"2000","popping",7.92275510212724,24,13,11,6.45805649309909,17.5419435069009
"2000","rides",7.92275510212724,24,13,11,6.45805649309909,17.5419435069009
"2000","smile like",7.92275510212724,24,13,11,6.45805649309909,17.5419435069009
"2010","quick",7.91657292119022,108,28,80,16.6279741896733,91.3720258103267
"1970","feelin",7.91200924335642,494,90,404,67.6028585704904,426.39714142951
"2000","ill never let",7.90369744733047,37,18,19,9.9561704268611,27.0438295731389
"1960","learned",7.89778803464941,148,18,130,8.83904446214534,139.160955537855
"1980","guys",7.89731721087629,127,34,93,21.3659374107344,105.634062589266
"1990","ask",7.8968098647571,498,132,366,105.648058572907,392.351941427093
"1970","world",7.89209038883267,2103,333,1770,287.791116546035,1815.20888345396
"1980","part",7.89022906517956,338,77,261,56.8636759435293,281.136324056471
"2010","poppin",7.89000350989563,118,30,88,18.1676014294578,99.8323985705422
"1970","belong",7.88969395660169,302,59,243,41.3280633366156,260.671936663384
"1990","none",7.88015789938143,95,32,63,20.1537461133055,74.8462538866945
"1970","aint nothin",7.87721473639007,99,24,75,13.5479412924667,85.4520587075333
"1960","million",7.87488210159577,207,23,184,12.3627175923249,194.637282407675
"1960","love better",7.87283848291507,35,7,28,2.09031456875059,32.9096854312494
"1960","maybe ill",7.87283848291507,35,7,28,2.09031456875059,32.9096854312494
"1960","mind youre",7.87283848291507,35,7,28,2.09031456875059,32.9096854312494
"1970","new",7.86763021662348,1223,202,1021,167.364971724109,1055.63502827589
"2010","damn",7.86464196694234,486,98,388,74.8258838535298,411.17411614647
"1960","eyes",7.86435273561105,1714,131,1583,102.365690595386,1611.63430940461
"1960","die",7.85526945957162,516,47,469,30.817209070723,485.182790929277
"1970","please",7.85504070153095,1038,174,864,142.048111733136,895.951888266864
"1960","ooh love",7.85152327793189,53,9,44,3.16533348982232,49.8346665101777
"1960","wanting",7.85152327793189,53,9,44,3.16533348982232,49.8346665101777
"1960","will know",7.85152327793189,53,9,44,3.16533348982232,49.8346665101777
"2010","wont come",7.84758880253402,84,23,61,12.9328688141903,71.0671311858097
"1960","may",7.84357967917755,476,44,432,28.428278135008,447.571721864992
"1970","honey im",7.83828387943338,25,9,16,3.42119729607745,21.5788027039226
"1970","life got",7.83828387943338,25,9,16,3.42119729607745,21.5788027039226
"1970","sam",7.83828387943338,25,9,16,3.42119729607745,21.5788027039226
"1980","keep movin",7.83622274965574,56,18,38,9.42120074804036,46.5787992519596
"1980","nothing left",7.83622274965574,56,18,38,9.42120074804036,46.5787992519596
"1990","know really",7.83360282669835,110,36,74,23.3359165522485,86.6640834477515
"2000","dont mean",7.82502170162359,128,49,79,34.4429679631952,93.5570320368048
"2010","boca",7.82330706829565,12,6,6,1.84755268774148,10.1524473122585
"2010","call girl",7.82330706829565,12,6,6,1.84755268774148,10.1524473122585
"2010","cameras",7.82330706829565,12,6,6,1.84755268774148,10.1524473122585
"2010","else can see",7.82330706829565,12,6,6,1.84755268774148,10.1524473122585
"2010","face theres",7.82330706829565,12,6,6,1.84755268774148,10.1524473122585
"2010","fall fall",7.82330706829565,12,6,6,1.84755268774148,10.1524473122585
"2010","gon go",7.82330706829565,12,6,6,1.84755268774148,10.1524473122585
"2010","just left",7.82330706829565,12,6,6,1.84755268774148,10.1524473122585
"2010","left say",7.82330706829565,12,6,6,1.84755268774148,10.1524473122585
"2010","love let love let",7.82330706829565,12,6,6,1.84755268774148,10.1524473122585
"2010","lump",7.82330706829565,12,6,6,1.84755268774148,10.1524473122585
"2010","niggas know",7.82330706829565,12,6,6,1.84755268774148,10.1524473122585
"2010","oh oh know",7.82330706829565,12,6,6,1.84755268774148,10.1524473122585
"2010","put like",7.82330706829565,12,6,6,1.84755268774148,10.1524473122585
"2010","raising",7.82330706829565,12,6,6,1.84755268774148,10.1524473122585
"2010","saying im",7.82330706829565,12,6,6,1.84755268774148,10.1524473122585
"2010","something something",7.82330706829565,12,6,6,1.84755268774148,10.1524473122585
"2010","time put",7.82330706829565,12,6,6,1.84755268774148,10.1524473122585
"2010","world mine",7.82330706829565,12,6,6,1.84755268774148,10.1524473122585
"2010","write name",7.82330706829565,12,6,6,1.84755268774148,10.1524473122585
"2010","wrote song",7.82330706829565,12,6,6,1.84755268774148,10.1524473122585
"2010","youll make",7.82330706829565,12,6,6,1.84755268774148,10.1524473122585
"2010","youll remember",7.82330706829565,12,6,6,1.84755268774148,10.1524473122585
"1980","baby rock",7.82181307964073,21,9,12,3.53295028051514,17.4670497194849
"1980","falter",7.82181307964073,21,9,12,3.53295028051514,17.4670497194849
"1980","finer",7.82181307964073,21,9,12,3.53295028051514,17.4670497194849
"1980","heart oh",7.82181307964073,21,9,12,3.53295028051514,17.4670497194849
"1980","leave dont",7.82181307964073,21,9,12,3.53295028051514,17.4670497194849
"1980","love got got",7.82181307964073,21,9,12,3.53295028051514,17.4670497194849
"1980","make well",7.82181307964073,21,9,12,3.53295028051514,17.4670497194849
"1980","nobody ever",7.82181307964073,21,9,12,3.53295028051514,17.4670497194849
"1980","said yeah",7.82181307964073,21,9,12,3.53295028051514,17.4670497194849
"1980","tiger",7.82181307964073,21,9,12,3.53295028051514,17.4670497194849
"1980","will always love",7.82181307964073,21,9,12,3.53295028051514,17.4670497194849
"1980","youre living",7.82181307964073,21,9,12,3.53295028051514,17.4670497194849
"2010","fault",7.81993445517203,43,14,29,6.62039713107362,36.3796028689264
"2010","get lost",7.81993445517203,43,14,29,6.62039713107362,36.3796028689264
"2010","im way",7.81993445517203,43,14,29,6.62039713107362,36.3796028689264
"2010","know girl",7.81993445517203,43,14,29,6.62039713107362,36.3796028689264
"2010","look good",7.81993445517203,43,14,29,6.62039713107362,36.3796028689264
"2010","real good",7.81993445517203,43,14,29,6.62039713107362,36.3796028689264
"1970","didnt",7.8144568161946,868,148,720,118.783970119809,749.216029880191
"1980","loves",7.8136473976102,514,111,403,86.4731640087991,427.526835991201
"1980","come true",7.81183026511916,132,35,97,22.2071160489523,109.792883951048
"1980","baby time",7.80554036570439,32,12,20,5.38354328459449,26.6164567154055
"1980","heart youre",7.80554036570439,32,12,20,5.38354328459449,26.6164567154055
"1980","ive heard",7.80554036570439,32,12,20,5.38354328459449,26.6164567154055
"1980","lisa",7.80554036570439,32,12,20,5.38354328459449,26.6164567154055
"1990","bad boy",7.80182166218625,77,27,50,16.3351415865739,60.6648584134261
"1990","gettin",7.80176507098577,440,118,322,93.3436662089939,346.656333791006
"1960","accept",7.79867159203954,27,6,21,1.6125283816076,25.3874716183924
"1960","gonna right",7.79867159203954,27,6,21,1.6125283816076,25.3874716183924
"1960","got take",7.79867159203954,27,6,21,1.6125283816076,25.3874716183924
"1960","mellow",7.79867159203954,27,6,21,1.6125283816076,25.3874716183924
"1960","say shes",7.79867159203954,27,6,21,1.6125283816076,25.3874716183924
"1960","sweet sweet sweet",7.79867159203954,27,6,21,1.6125283816076,25.3874716183924
"1960","world can",7.79811248500336,44,8,36,2.62782402928645,41.3721759707135
"2000","moves",7.79440905436797,175,64,111,47.0899952621809,127.910004737819
"1990","anything need",7.79058384701342,12,7,5,2.54573635115438,9.45426364884562
"1990","awayits",7.79058384701342,12,7,5,2.54573635115438,9.45426364884562
"1990","cancer",7.79058384701342,12,7,5,2.54573635115438,9.45426364884562
"1990","get ill",7.79058384701342,12,7,5,2.54573635115438,9.45426364884562
"1990","girl heart",7.79058384701342,12,7,5,2.54573635115438,9.45426364884562
"1990","girl yo",7.79058384701342,12,7,5,2.54573635115438,9.45426364884562
"1990","gone ill",7.79058384701342,12,7,5,2.54573635115438,9.45426364884562
"1990","gonna man",7.79058384701342,12,7,5,2.54573635115438,9.45426364884562
"1990","ill share",7.79058384701342,12,7,5,2.54573635115438,9.45426364884562
"1990","just cant go",7.79058384701342,12,7,5,2.54573635115438,9.45426364884562
"1990","know know love",7.79058384701342,12,7,5,2.54573635115438,9.45426364884562
"1990","loud clear",7.79058384701342,12,7,5,2.54573635115438,9.45426364884562
"1990","loud just",7.79058384701342,12,7,5,2.54573635115438,9.45426364884562
"1990","love ya baby",7.79058384701342,12,7,5,2.54573635115438,9.45426364884562
"1990","make call",7.79058384701342,12,7,5,2.54573635115438,9.45426364884562
"1990","noon",7.79058384701342,12,7,5,2.54573635115438,9.45426364884562
"1990","oh baby baby baby",7.79058384701342,12,7,5,2.54573635115438,9.45426364884562
"1990","one take",7.79058384701342,12,7,5,2.54573635115438,9.45426364884562
"1990","play wanna",7.79058384701342,12,7,5,2.54573635115438,9.45426364884562
"1990","power power",7.79058384701342,12,7,5,2.54573635115438,9.45426364884562
"1990","put heart",7.79058384701342,12,7,5,2.54573635115438,9.45426364884562
"1990","something missing",7.79058384701342,12,7,5,2.54573635115438,9.45426364884562
"1990","true oh baby",7.79058384701342,12,7,5,2.54573635115438,9.45426364884562
"1990","true will",7.79058384701342,12,7,5,2.54573635115438,9.45426364884562
"1990","words dont",7.79058384701342,12,7,5,2.54573635115438,9.45426364884562
"1960","makes feel",7.78807523086437,83,12,71,4.95703169160854,78.0429683083915
"2010","crew",7.78474516389402,89,24,65,13.7026824340826,75.2973175659174
"1990","like uh",7.7816175313434,39,16,23,8.27364314125173,30.7263568587483
"1980","steppin",7.7699364447754,52,17,35,8.74825783746605,43.251742162534
"1980","treat right",7.7699364447754,52,17,35,8.74825783746605,43.251742162534
"1970","cant cant",7.76326889103918,73,19,54,9.98989610454615,63.0101038954538
"1990","gotta get",7.7615164887853,227,66,161,48.1568459760037,178.843154023996
"2010","baby oh",7.7554317958432,154,37,117,23.7102594926823,130.289740507318
"1970","babe just",7.75287069403318,17,7,10,2.32641416133266,14.6735858386673
"1970","dont fall",7.75287069403318,17,7,10,2.32641416133266,14.6735858386673
"1970","im makin",7.75287069403318,17,7,10,2.32641416133266,14.6735858386673
"1970","knowing love",7.75287069403318,17,7,10,2.32641416133266,14.6735858386673
"1970","leave leave",7.75287069403318,17,7,10,2.32641416133266,14.6735858386673
"1970","lord knows",7.75287069403318,17,7,10,2.32641416133266,14.6735858386673
"1970","love wont let",7.75287069403318,17,7,10,2.32641416133266,14.6735858386673
"1970","man youre",7.75287069403318,17,7,10,2.32641416133266,14.6735858386673
"1970","said son",7.75287069403318,17,7,10,2.32641416133266,14.6735858386673
"1970","seed",7.75287069403318,17,7,10,2.32641416133266,14.6735858386673
"1970","sleep alone",7.75287069403318,17,7,10,2.32641416133266,14.6735858386673
"1970","sunday morning",7.75287069403318,17,7,10,2.32641416133266,14.6735858386673
"1970","take us",7.75287069403318,17,7,10,2.32641416133266,14.6735858386673
"1970","thats lost",7.75287069403318,17,7,10,2.32641416133266,14.6735858386673
"1970","took hand",7.75287069403318,17,7,10,2.32641416133266,14.6735858386673
"1970","woman got",7.75287069403318,17,7,10,2.32641416133266,14.6735858386673
"2010","cause body",7.75101648222835,19,8,11,2.92529175559067,16.0747082444093
"2010","finna",7.75101648222835,19,8,11,2.92529175559067,16.0747082444093
"2010","incredible",7.75101648222835,19,8,11,2.92529175559067,16.0747082444093
"2010","know now im",7.75101648222835,19,8,11,2.92529175559067,16.0747082444093
"2010","like hold",7.75101648222835,19,8,11,2.92529175559067,16.0747082444093
"2010","night need",7.75101648222835,19,8,11,2.92529175559067,16.0747082444093
"2010","oh gonna",7.75101648222835,19,8,11,2.92529175559067,16.0747082444093
"2010","ooh hoo",7.75101648222835,19,8,11,2.92529175559067,16.0747082444093
"2010","remember said",7.75101648222835,19,8,11,2.92529175559067,16.0747082444093
"2010","systems",7.75101648222835,19,8,11,2.92529175559067,16.0747082444093
"2010","time gonna",7.75101648222835,19,8,11,2.92529175559067,16.0747082444093
"2010","touch now",7.75101648222835,19,8,11,2.92529175559067,16.0747082444093
"2010","trying",7.74801445954817,504,101,403,77.597212885142,426.402787114858
"1970","said dont",7.74678649960023,48,14,34,6.5686988084687,41.4313011915313
"1960","exactly",7.7440693122369,73,11,62,4.3597989576798,68.6402010423202
"1970","baby baby ooo",7.73824260869742,21,8,13,2.87380572870506,18.1261942712949
"1970","gonna turn",7.73824260869742,21,8,13,2.87380572870506,18.1261942712949
"1970","hold head",7.73824260869742,21,8,13,2.87380572870506,18.1261942712949
"1970","just came",7.73824260869742,21,8,13,2.87380572870506,18.1261942712949
"1970","just game",7.73824260869742,21,8,13,2.87380572870506,18.1261942712949
"1970","thing ever",7.73824260869742,21,8,13,2.87380572870506,18.1261942712949
"1970","treat like lady",7.73824260869742,21,8,13,2.87380572870506,18.1261942712949
"1970","world go",7.73824260869742,21,8,13,2.87380572870506,18.1261942712949
"2000","bedroom",7.72904737278327,51,23,28,13.7233700478356,37.2766299521644
"2000","maybe can",7.72904737278327,51,23,28,13.7233700478356,37.2766299521644
"2000","mom",7.72904737278327,51,23,28,13.7233700478356,37.2766299521644
"2000","yeah hey",7.72904737278327,51,23,28,13.7233700478356,37.2766299521644
"2010","sick",7.72759410022068,149,36,113,22.94044587279,126.05955412721
"1970","makes",7.72736177353,739,128,611,101.130592072049,637.869407927951
"2010","bop bop bop bop",7.72609295273767,61,18,43,9.39172616268583,51.6082738373142
"1970","called",7.72494464057676,231,47,184,31.6118630157556,199.388136984244
"1980","lets talk",7.72365677916781,36,13,23,6.05648619516881,29.9435138048312
"1980","like first time",7.72365677916781,36,13,23,6.05648619516881,29.9435138048312
"1980","want im",7.72365677916781,36,13,23,6.05648619516881,29.9435138048312
"1970","im gonna find",7.71894975000044,34,11,23,4.65282832266533,29.3471716773347
"1970","mend",7.71894975000044,34,11,23,4.65282832266533,29.3471716773347
"2010","paint",7.71810204021896,52,16,36,8.00606164687973,43.9939383531203
"1990","jimmy",7.7162172291887,56,21,35,11.8801029720538,44.1198970279462
"1970","tried",7.71475782703748,408,76,332,55.833939871984,352.166060128016
"1990","hat",7.70576977864621,63,23,40,13.3651158435605,49.6348841564395
"1990","listening",7.70576977864621,63,23,40,13.3651158435605,49.6348841564395
"2000","stupid",7.70292274241486,113,44,69,30.4066826550082,82.5933173449918
"1970","right get",7.69815926293952,53,15,38,7.25293826768419,45.7470617323158
"2000","felt like",7.69711275565794,40,19,21,10.7634274884985,29.2365725115015
"2010","dont lie",7.69303524033625,39,13,26,6.0045462351598,32.9954537648402
"2010","just trying",7.69303524033625,39,13,26,6.0045462351598,32.9954537648402
"2010","someone like",7.69303524033625,39,13,26,6.0045462351598,32.9954537648402
"1980","go come",7.69161053564503,44,15,29,7.40237201631743,36.5976279836826
"1980","often",7.69161053564503,44,15,29,7.40237201631743,36.5976279836826
"1980","time well",7.69161053564503,44,15,29,7.40237201631743,36.5976279836826
"1980","made feel",7.68988751194797,40,14,26,6.72942910574312,33.2705708942569
"2000","super",7.68642722544372,77,32,45,20.7195979153596,56.2804020846404
"1970","know im gonna",7.68183103484538,58,16,42,7.93717772689968,50.0628222731003
"2000","brush",7.67648302182794,32,16,16,8.61074199079879,23.3892580092012
"2000","get chance",7.67648302182794,32,16,16,8.61074199079879,23.3892580092012
"2000","hottest",7.67648302182794,32,16,16,8.61074199079879,23.3892580092012
"2000","indeed",7.67648302182794,32,16,16,8.61074199079879,23.3892580092012
"2000","life ill",7.67648302182794,32,16,16,8.61074199079879,23.3892580092012
"2000","month",7.67648302182794,32,16,16,8.61074199079879,23.3892580092012
"2000","ah ah ah",7.66783279626703,107,42,65,28.7921685317335,78.2078314682665
"2010","dirty",7.66707073112345,244,54,190,37.5669046507433,206.433095349257
"1980","doesnt matter",7.6453904197205,78,23,55,13.1223867561991,64.8776132438009
"1980","message",7.6453904197205,78,23,55,13.1223867561991,64.8776132438009
"1990","friday",7.64467718980908,92,31,61,19.5173120255169,72.4826879744831
"1980","fall love",7.64321007931076,254,60,194,42.7318748214688,211.268125178531
"2000","east",7.64265970190778,101,40,61,27.1776544084587,73.8223455915413
"2000","making love",7.64265970190778,101,40,61,27.1776544084587,73.8223455915413
"1970","bop bop",7.63049547840812,150,33,117,20.5271837764647,129.472816223535
"2000","else can",7.62992093203547,89,36,53,23.9486261619091,65.0513738380909
"1990","now everybody",7.62720099429298,36,15,21,7.63720905346314,28.3627909465369
"1990","praying",7.62720099429298,36,15,21,7.63720905346314,28.3627909465369
"1980","fire",7.61749019036087,674,141,533,113.390880431772,560.609119568228
"2010","bound",7.61322060061133,80,22,58,12.3170179182765,67.6829820817235
"2000","blank",7.60812508815248,17,10,7,4.57445668261186,12.4255433173881
"2000","doe",7.60812508815248,17,10,7,4.57445668261186,12.4255433173881
"2000","everything youre",7.60812508815248,17,10,7,4.57445668261186,12.4255433173881
"2000","follow follow follow",7.60812508815248,17,10,7,4.57445668261186,12.4255433173881
"2000","girls got",7.60812508815248,17,10,7,4.57445668261186,12.4255433173881
"2000","hide cant",7.60812508815248,17,10,7,4.57445668261186,12.4255433173881
"2000","im youre",7.60812508815248,17,10,7,4.57445668261186,12.4255433173881
"2000","ive around",7.60812508815248,17,10,7,4.57445668261186,12.4255433173881
"2000","jewels",7.60812508815248,17,10,7,4.57445668261186,12.4255433173881
"2000","know world",7.60812508815248,17,10,7,4.57445668261186,12.4255433173881
"2000","lips like",7.60812508815248,17,10,7,4.57445668261186,12.4255433173881
"2000","money im",7.60812508815248,17,10,7,4.57445668261186,12.4255433173881
"2000","right next",7.60812508815248,17,10,7,4.57445668261186,12.4255433173881
"2000","seen nothing",7.60812508815248,17,10,7,4.57445668261186,12.4255433173881
"2000","show ya",7.60812508815248,17,10,7,4.57445668261186,12.4255433173881
"2000","sun will",7.60812508815248,17,10,7,4.57445668261186,12.4255433173881
"2000","take get",7.60812508815248,17,10,7,4.57445668261186,12.4255433173881
"2000","tho",7.60812508815248,17,10,7,4.57445668261186,12.4255433173881
"1960","life dont",7.60628749410645,54,9,45,3.22505676321519,50.7749432367848
"1970","precious",7.6035840292473,84,21,63,11.4952229148202,72.5047770851798
"1970","silly",7.6035840292473,84,21,63,11.4952229148202,72.5047770851798
"2000","started",7.60264990351371,315,107,208,84.7619914719256,230.238008528074
"1960","precious",7.60093463193757,84,12,72,5.01675496500141,78.9832450349986
"1970","yeah oh",7.6002022493596,214,44,170,29.285448854423,184.714551145577
"1990","want hold",7.59203540135937,46,18,28,9.75865601275846,36.2413439872415
"1990","way way",7.59203540135937,46,18,28,9.75865601275846,36.2413439872415
"2010","babe dont",7.59202892168156,35,12,23,5.38869533924597,29.611304660754
"2010","get little bit",7.59202892168156,35,12,23,5.38869533924597,29.611304660754
"2010","im running",7.59202892168156,35,12,23,5.38869533924597,29.611304660754
"2010","now will",7.59202892168156,35,12,23,5.38869533924597,29.611304660754
"2010","yeah yeah oh",7.59202892168156,35,12,23,5.38869533924597,29.611304660754
"2010","day every day",7.57109137969388,23,9,14,3.5411426515045,19.4588573484955
"2010","didnt need",7.57109137969388,23,9,14,3.5411426515045,19.4588573484955
"2010","good now",7.57109137969388,23,9,14,3.5411426515045,19.4588573484955
"2010","head like",7.57109137969388,23,9,14,3.5411426515045,19.4588573484955
"2010","im cause",7.57109137969388,23,9,14,3.5411426515045,19.4588573484955
"2010","now put",7.57109137969388,23,9,14,3.5411426515045,19.4588573484955
"2010","pain im",7.57109137969388,23,9,14,3.5411426515045,19.4588573484955
"2010","por",7.57109137969388,23,9,14,3.5411426515045,19.4588573484955
"2010","stop cause",7.57109137969388,23,9,14,3.5411426515045,19.4588573484955
"2010","worldwide",7.57109137969388,23,9,14,3.5411426515045,19.4588573484955
"1990","meyou",7.57031181130357,74,26,48,15.6987074987853,58.3012925012147
"1990","father",7.56581027044557,126,40,86,26.730231687121,99.269768312879
"1990","closer",7.55536994567449,232,67,165,49.2175694556513,182.782430544349
"1990","chorus",7.55190637490637,224,65,159,47.5204118882151,176.479588111785
"1960","sea",7.54775374458092,174,20,154,10.3918495703601,163.60815042964
"2010","killing",7.54653343901509,85,23,62,13.0868315381688,71.9131684618312
"2010","pants",7.54653343901509,85,23,62,13.0868315381688,71.9131684618312
"1960","tall",7.54298781949614,74,11,63,4.41952223107267,69.5804777689273
"1960","thrill",7.54298781949614,74,11,63,4.41952223107267,69.5804777689273
"1970","thing",7.5415079614847,1697,272,1425,232.230872457737,1464.76912754226
"2010","calling",7.53754205559204,218,49,169,33.5638738273035,184.436126172697
"1960","wont tell",7.53636828802623,64,10,54,3.82228949714393,60.1777105028561
"1970","feel can",7.535262734189,39,12,27,5.33706778188082,33.6629322181192
"1970","fifty",7.535262734189,39,12,27,5.33706778188082,33.6629322181192
"1980","dont play",7.53042632656088,61,19,42,10.2623793862583,50.7376206137417
"2000","black white",7.52694741896645,43,20,23,11.5706845501359,31.4293154498641
"2010","wanna fall",7.52643929488833,31,11,20,4.77284444333215,26.2271555566679
"1960","mind mind",7.52490027138373,45,8,37,2.68754730267933,42.3124526973207
"1980","better watch",7.52338564004938,25,10,15,4.20589319108945,20.7941068089106
"1980","chance take",7.52338564004938,25,10,15,4.20589319108945,20.7941068089106
"1980","draggin",7.52338564004938,25,10,15,4.20589319108945,20.7941068089106
"1980","felt way",7.52338564004938,25,10,15,4.20589319108945,20.7941068089106
"1980","im asking",7.52338564004938,25,10,15,4.20589319108945,20.7941068089106
"1980","move make",7.52338564004938,25,10,15,4.20589319108945,20.7941068089106
"1980","stays",7.52338564004938,25,10,15,4.20589319108945,20.7941068089106
"2010","gotta let",7.52263597281685,57,17,40,8.77587526677201,48.224124733228
"2000","pay",7.52079831447558,322,109,213,86.6455912824129,235.354408717587
"1990","enjoy",7.5136041010042,130,41,89,27.5788104708391,102.421189529161
"2000","can anything",7.51334442390589,27,14,13,7.26531355473648,19.7346864452635
"2000","dont cha",7.51334442390589,27,14,13,7.26531355473648,19.7346864452635
"2000","im make",7.51334442390589,27,14,13,7.26531355473648,19.7346864452635
"2000","pretty face",7.51334442390589,27,14,13,7.26531355473648,19.7346864452635
"2000","sudden",7.51334442390589,27,14,13,7.26531355473648,19.7346864452635
"2000","wanna talk",7.51334442390589,27,14,13,7.26531355473648,19.7346864452635
"2010","flew",7.51118315375808,27,10,17,4.15699354741832,22.8430064525817
"2010","glitter",7.51118315375808,27,10,17,4.15699354741832,22.8430064525817
"2010","im addicted",7.51118315375808,27,10,17,4.15699354741832,22.8430064525817
"2010","ooh girl",7.51118315375808,27,10,17,4.15699354741832,22.8430064525817
"2010","solve",7.51118315375808,27,10,17,4.15699354741832,22.8430064525817
"2010","swear ill",7.51118315375808,27,10,17,4.15699354741832,22.8430064525817
"2010","uh dont",7.51118315375808,27,10,17,4.15699354741832,22.8430064525817
"1980","love youre",7.50676528076577,110,30,80,18.5059300407936,91.4940699592064
"2000","know just",7.50623958983302,237,83,154,63.7733078693536,173.226692130646
"1990","ladies night",7.48716678708802,33,14,19,7.00077496567454,25.9992250343255
"1990","let just",7.48716678708802,33,14,19,7.00077496567454,25.9992250343255
"2000","clap",7.48212437408333,154,57,97,41.4391958307192,112.560804169281
"1970","day ill",7.47342880499097,30,10,20,4.10543675529294,25.8945632447071
"1970","roll come",7.47342880499097,30,10,20,4.10543675529294,25.8945632447071
"1980","aint bad",7.47173361570553,18,8,10,3.0282430975844,14.9717569024156
"1980","alive im",7.47173361570553,18,8,10,3.0282430975844,14.9717569024156
"1980","feel time",7.47173361570553,18,8,10,3.0282430975844,14.9717569024156
"1980","game give",7.47173361570553,18,8,10,3.0282430975844,14.9717569024156
"1980","get car",7.47173361570553,18,8,10,3.0282430975844,14.9717569024156
"1980","im hungry",7.47173361570553,18,8,10,3.0282430975844,14.9717569024156
"1980","jamaica",7.47173361570553,18,8,10,3.0282430975844,14.9717569024156
"1980","know just feel",7.47173361570553,18,8,10,3.0282430975844,14.9717569024156
"1980","mind oh",7.47173361570553,18,8,10,3.0282430975844,14.9717569024156
"1980","nothin good",7.47173361570553,18,8,10,3.0282430975844,14.9717569024156
"1980","one time one",7.47173361570553,18,8,10,3.0282430975844,14.9717569024156
"1980","tin",7.47173361570553,18,8,10,3.0282430975844,14.9717569024156
"1980","tonight can",7.47173361570553,18,8,10,3.0282430975844,14.9717569024156
"1980","wind wind",7.47173361570553,18,8,10,3.0282430975844,14.9717569024156
"2000","hes",7.47130633752067,841,262,579,226.301062945681,614.698937054319
"1990","anyone",7.46627606324535,134,42,92,28.4273892545572,105.572610745443
"1980","rock",7.46351184624892,1320,260,1060,222.071160489523,1097.92883951048
"1970","thrill",7.45941554776397,74,19,55,10.1267439963892,63.8732560036107
"2000","cause know im",7.45818425918752,22,12,10,5.91988511867417,16.0801148813258
"2000","deepest",7.45818425918752,22,12,10,5.91988511867417,16.0801148813258
"2000","dont know got",7.45818425918752,22,12,10,5.91988511867417,16.0801148813258
"2000","gonna get get",7.45818425918752,22,12,10,5.91988511867417,16.0801148813258
"2000","got music",7.45818425918752,22,12,10,5.91988511867417,16.0801148813258
"2000","im need",7.45818425918752,22,12,10,5.91988511867417,16.0801148813258
"2000","just forget",7.45818425918752,22,12,10,5.91988511867417,16.0801148813258
"2000","life go",7.45818425918752,22,12,10,5.91988511867417,16.0801148813258
"2000","milky",7.45818425918752,22,12,10,5.91988511867417,16.0801148813258
"1980","dreaming",7.44682012118972,162,41,121,27.2541878782596,134.74581212174
"1980","lay",7.43229668947622,465,101,364,78.2296133542637,386.770386645736
"1970","now baby",7.42977231704628,151,33,118,20.6640316683078,130.335968331692
"1960","love id",7.4294974639135,28,6,22,1.67225165500047,26.3277483449995
"1960","right yeah",7.4294974639135,28,6,22,1.67225165500047,26.3277483449995
"1960","world around",7.4294974639135,28,6,22,1.67225165500047,26.3277483449995
"1960","world love",7.4294974639135,28,6,22,1.67225165500047,26.3277483449995
"1970","friends",7.42848902698166,762,131,631,104.278093584441,657.721906415559
"2000","hold us",7.4254622572267,35,17,18,9.41799905243618,25.5820009475638
"2000","romeo",7.4254622572267,35,17,18,9.41799905243618,25.5820009475638
"2000","theres nowhere",7.4254622572267,35,17,18,9.41799905243618,25.5820009475638
"1970","fun",7.42486034918196,423,78,345,57.8866582496304,365.11334175037
"2010","taste",7.42335611567315,224,50,174,34.4876501711742,189.512349828826
"1970","id love",7.42240824398894,44,13,31,6.02130724109631,37.9786927589037
"1970","station",7.42240824398894,44,13,31,6.02130724109631,37.9786927589037
"1990","around world",7.4220753196665,78,27,51,16.5472862825035,61.4527137174965
"1970","let tell",7.41847749768368,90,22,68,12.3163102658788,77.6836897341212
"1990","always around",7.41825969075459,15,8,7,3.18217043894297,11.817829561057
"1990","babyif",7.41825969075459,15,8,7,3.18217043894297,11.817829561057
"1990","can like",7.41825969075459,15,8,7,3.18217043894297,11.817829561057
"1990","days love",7.41825969075459,15,8,7,3.18217043894297,11.817829561057
"1990","dedicated",7.41825969075459,15,8,7,3.18217043894297,11.817829561057
"1990","dont stop get",7.41825969075459,15,8,7,3.18217043894297,11.817829561057
"1990","falling star",7.41825969075459,15,8,7,3.18217043894297,11.817829561057
"1990","feel much",7.41825969075459,15,8,7,3.18217043894297,11.817829561057
"1990","gonna pay",7.41825969075459,15,8,7,3.18217043894297,11.817829561057
"1990","health",7.41825969075459,15,8,7,3.18217043894297,11.817829561057
"1990","help sing",7.41825969075459,15,8,7,3.18217043894297,11.817829561057
"1990","im wishing",7.41825969075459,15,8,7,3.18217043894297,11.817829561057
"1990","love leave",7.41825969075459,15,8,7,3.18217043894297,11.817829561057
"1990","man wanna",7.41825969075459,15,8,7,3.18217043894297,11.817829561057
"1990","many years",7.41825969075459,15,8,7,3.18217043894297,11.817829561057
"1990","microphone",7.41825969075459,15,8,7,3.18217043894297,11.817829561057
"1990","thick thin",7.41825969075459,15,8,7,3.18217043894297,11.817829561057
"1990","turn walk",7.41825969075459,15,8,7,3.18217043894297,11.817829561057
"1990","wayand",7.41825969075459,15,8,7,3.18217043894297,11.817829561057
"1990","youre somebody",7.41825969075459,15,8,7,3.18217043894297,11.817829561057
"1990","dee da",7.4092079885337,89,30,59,18.8808779377283,70.1191220622717
"2010","american",7.40503587733978,125,31,94,19.245340497307,105.754659502693
"1970","everytime",7.40353266224464,69,18,51,9.44250453717376,59.5574954628262
"1980","theres one",7.39916534284481,129,34,95,21.7024088660216,107.297591133978
"2000","pick",7.39089748987593,186,67,119,50.049937821518,135.950062178482
"2010","hating",7.37752509823604,44,14,30,6.77435985505208,37.2256401449479
"1980","learned",7.37433545212089,148,38,110,24.8988876912495,123.10111230875
"2010","ever",7.37323661345901,2130,374,1756,327.940602074112,1802.05939792589
"2010","knows",7.37301588758866,496,99,397,76.3655110933143,419.634488906686
"1960","gonna see",7.36846065921373,55,9,46,3.28478003660807,51.7152199633919
"1960","joe",7.36846065921373,55,9,46,3.28478003660807,51.7152199633919
"1990","feel alone",7.36573675914661,30,13,17,6.36434087788595,23.6356591221141
"1990","get hot",7.36573675914661,30,13,17,6.36434087788595,23.6356591221141
"1990","know youd",7.36573675914661,30,13,17,6.36434087788595,23.6356591221141
"1990","left right",7.36573675914661,30,13,17,6.36434087788595,23.6356591221141
"1970","mamas",7.35987165892298,49,14,35,6.7055467003118,42.2944532996882
"1990","bit",7.35986357254956,540,141,399,114.558135801947,425.441864198053
"1990","everywhere",7.35749972356272,237,68,169,50.278292935299,186.721707064701
"1980","decide",7.3557520149002,53,17,36,8.91649356510963,44.0835064348904
"1980","go like",7.3557520149002,53,17,36,8.91649356510963,44.0835064348904
"1970","eyes",7.3502923319499,1714,274,1440,234.55728661907,1479.44271338093
"1980","eternal",7.34790565057446,29,11,18,4.87883610166376,24.1211638983362
"1980","every moment",7.34790565057446,29,11,18,4.87883610166376,24.1211638983362
"1980","every step",7.34790565057446,29,11,18,4.87883610166376,24.1211638983362
"1980","live without love",7.34790565057446,29,11,18,4.87883610166376,24.1211638983362
"1980","look now",7.34790565057446,29,11,18,4.87883610166376,24.1211638983362
"1980","make every",7.34790565057446,29,11,18,4.87883610166376,24.1211638983362
"1980","never lose",7.34790565057446,29,11,18,4.87883610166376,24.1211638983362
"1980","toy",7.34790565057446,29,11,18,4.87883610166376,24.1211638983362
"1980","want yeah",7.34790565057446,29,11,18,4.87883610166376,24.1211638983362
"1970","across",7.34059357699247,192,40,152,26.2747952338748,165.725204766125
"1970","funny",7.34059357699247,192,40,152,26.2747952338748,165.725204766125
"1970","foolish",7.3370925878452,59,16,43,8.07402561874278,50.9259743812572
"1970","youre love",7.33441402607655,54,15,39,7.38978615952729,46.6102138404727
"1970","memories",7.32758696956112,163,35,128,22.306206370425,140.693793629575
"1980","twice",7.32709675726996,134,35,99,22.5435875042394,111.456412495761
"1960","time know",7.32259333233103,65,10,55,3.88201277053681,61.1179872294632
"2000","addicted",7.32161425190846,69,29,40,18.5669124176599,50.4330875823401
"1970","feel like",7.31601699168584,506,91,415,69.2450332726075,436.754966727392
"2010","dirt",7.30913196669836,81,22,59,12.470980642255,68.529019357745
"1960","youll never",7.30862856440435,176,20,156,10.5112961171458,165.488703882854
"1990","lyrics",7.2954137677537,50,19,31,10.6072347964766,39.3927652035234
"1990","ive ever",7.29063842842507,82,28,54,17.3958650662216,64.6041349337784
"1980","poppa",7.28801102484146,49,16,33,8.24355065453532,40.7564493454647
"1980","wanna show",7.28801102484146,49,16,33,8.24355065453532,40.7564493454647
"2010","art",7.27402543793169,16,7,9,2.4634035836553,13.5365964163447
"2010","castle",7.27402543793169,16,7,9,2.4634035836553,13.5365964163447
"2010","commit",7.27402543793169,16,7,9,2.4634035836553,13.5365964163447
"2010","dont even try",7.27402543793169,16,7,9,2.4634035836553,13.5365964163447
"2010","dont really need",7.27402543793169,16,7,9,2.4634035836553,13.5365964163447
"2010","everything see",7.27402543793169,16,7,9,2.4634035836553,13.5365964163447
"2010","hear calling",7.27402543793169,16,7,9,2.4634035836553,13.5365964163447
"2010","im around",7.27402543793169,16,7,9,2.4634035836553,13.5365964163447
"2010","lost mind",7.27402543793169,16,7,9,2.4634035836553,13.5365964163447
"2010","love think",7.27402543793169,16,7,9,2.4634035836553,13.5365964163447
"2010","moment im",7.27402543793169,16,7,9,2.4634035836553,13.5365964163447
"2010","picking",7.27402543793169,16,7,9,2.4634035836553,13.5365964163447
"2010","remember name",7.27402543793169,16,7,9,2.4634035836553,13.5365964163447
"2010","two dont",7.27402543793169,16,7,9,2.4634035836553,13.5365964163447
"1980","beneath",7.27241000629734,66,20,46,11.1035580244761,54.8964419755239
"1990","da da la",7.26898079135007,27,12,15,5.72790679009735,21.2720932099026
"1990","da da la da",7.26898079135007,27,12,15,5.72790679009735,21.2720932099026
"1990","fall asleep",7.26898079135007,27,12,15,5.72790679009735,21.2720932099026
"1990","feeling yeah",7.26898079135007,27,12,15,5.72790679009735,21.2720932099026
"1990","give cause",7.26898079135007,27,12,15,5.72790679009735,21.2720932099026
"1990","heart beating",7.26898079135007,27,12,15,5.72790679009735,21.2720932099026
"1990","one make",7.26898079135007,27,12,15,5.72790679009735,21.2720932099026
"1990","peeps",7.26898079135007,27,12,15,5.72790679009735,21.2720932099026
"1990","whats gonna",7.26898079135007,27,12,15,5.72790679009735,21.2720932099026
"1990","wit wit",7.26898079135007,27,12,15,5.72790679009735,21.2720932099026
"2000","lifetime",7.26604885373522,75,31,44,20.1814265409347,54.8185734590653
"1960","went",7.26375051717953,378,36,342,22.5753973425063,355.424602657494
"1990","dance lets",7.2636429834903,57,21,36,12.0922476679833,44.9077523320167
"1970","cowboy",7.26179842861135,26,9,17,3.55804518792055,22.4419548120795
"1970","everybody dance",7.26179842861135,26,9,17,3.55804518792055,22.4419548120795
"1970","gonna need",7.26179842861135,26,9,17,3.55804518792055,22.4419548120795
"1970","sometime",7.26179842861135,26,9,17,3.55804518792055,22.4419548120795
"1970","thieves",7.26179842861135,26,9,17,3.55804518792055,22.4419548120795
"1960","bringin",7.25399180955829,37,7,30,2.20976111553634,34.7902388844637
"1960","island",7.25399180955829,37,7,30,2.20976111553634,34.7902388844637
"1960","life will",7.25399180955829,37,7,30,2.20976111553634,34.7902388844637
"1960","make mind",7.25399180955829,37,7,30,2.20976111553634,34.7902388844637
"1980","stop loving",7.25220293992361,33,12,21,5.55177901223807,27.4482209877619
"1980","sweet dreams",7.25220293992361,33,12,21,5.55177901223807,27.4482209877619
"1980","theyve got",7.25220293992361,33,12,21,5.55177901223807,27.4482209877619
"1980","touch touch",7.25220293992361,33,12,21,5.55177901223807,27.4482209877619
"1970","come back",7.25093031261076,240,48,192,32.8434940423435,207.156505957657
"1990","anybody else",7.2473972093702,18,9,9,3.81860452673157,14.1813954732684
"1990","bliss",7.2473972093702,18,9,9,3.81860452673157,14.1813954732684
"1990","go round round",7.2473972093702,18,9,9,3.81860452673157,14.1813954732684
"1990","many nights",7.2473972093702,18,9,9,3.81860452673157,14.1813954732684
"1990","need cant",7.2473972093702,18,9,9,3.81860452673157,14.1813954732684
"1990","round round go",7.2473972093702,18,9,9,3.81860452673157,14.1813954732684
"1990","spare",7.2473972093702,18,9,9,3.81860452673157,14.1813954732684
"1990","thing cause",7.2473972093702,18,9,9,3.81860452673157,14.1813954732684
"1990","yougirl",7.2473972093702,18,9,9,3.81860452673157,14.1813954732684
"2010","arm",7.2452865095318,67,19,48,10.3155025065566,56.6844974934434
"1970","just begun",7.2452797402476,35,11,24,4.78967621450843,30.2103237854916
"1970","ringin",7.2452797402476,35,11,24,4.78967621450843,30.2103237854916
"1980","think youre",7.2337025635812,163,41,122,27.4224236059032,135.577576394097
"2000","sippin",7.23290260268708,93,37,56,25.024968910759,67.975031089241
"2010","give im",7.22904181416128,40,13,27,6.15850895913825,33.8414910408617
"2010","wanna play",7.22904181416128,40,13,27,6.15850895913825,33.8414910408617
"2000","admit",7.22770636786931,90,36,54,24.2177118491216,65.7822881508784
"1960","near",7.22176122653841,213,23,190,12.7210572326821,200.278942767318
"1990","know heart",7.21980118482405,40,16,24,8.48578783718126,31.5142121628187
"1990","seek",7.21980118482405,40,16,24,8.48578783718126,31.5142121628187
"1980","open heart",7.21135714589593,37,13,24,6.22472192281238,30.7752780771876
"1990","away want",7.20596462710916,24,11,13,5.09147270230876,18.9085272976912
"1990","come love",7.20596462710916,24,11,13,5.09147270230876,18.9085272976912
"1990","heart like",7.20596462710916,24,11,13,5.09147270230876,18.9085272976912
"1990","holy",7.20596462710916,24,11,13,5.09147270230876,18.9085272976912
"1990","let hair",7.20596462710916,24,11,13,5.09147270230876,18.9085272976912
"1990","move move move",7.20596462710916,24,11,13,5.09147270230876,18.9085272976912
"2000","away far away",7.20021591802681,15,9,6,4.03628530818693,10.9637146918131
"2000","bad youre",7.20021591802681,15,9,6,4.03628530818693,10.9637146918131
"2000","body go",7.20021591802681,15,9,6,4.03628530818693,10.9637146918131
"2000","boy lets",7.20021591802681,15,9,6,4.03628530818693,10.9637146918131
"2000","dirt road",7.20021591802681,15,9,6,4.03628530818693,10.9637146918131
"2000","guess whos",7.20021591802681,15,9,6,4.03628530818693,10.9637146918131
"2000","heartless",7.20021591802681,15,9,6,4.03628530818693,10.9637146918131
"2000","like dont know",7.20021591802681,15,9,6,4.03628530818693,10.9637146918131
"2000","live way",7.20021591802681,15,9,6,4.03628530818693,10.9637146918131
"2000","oh man",7.20021591802681,15,9,6,4.03628530818693,10.9637146918131
"2000","patron",7.20021591802681,15,9,6,4.03628530818693,10.9637146918131
"2000","promises made",7.20021591802681,15,9,6,4.03628530818693,10.9637146918131
"2000","said yes",7.20021591802681,15,9,6,4.03628530818693,10.9637146918131
"2000","shake make",7.20021591802681,15,9,6,4.03628530818693,10.9637146918131
"2000","side can",7.20021591802681,15,9,6,4.03628530818693,10.9637146918131
"2000","soon well",7.20021591802681,15,9,6,4.03628530818693,10.9637146918131
"2000","sugar baby",7.20021591802681,15,9,6,4.03628530818693,10.9637146918131
"2000","talk girl",7.20021591802681,15,9,6,4.03628530818693,10.9637146918131
"2000","thing think",7.20021591802681,15,9,6,4.03628530818693,10.9637146918131
"2000","well always together",7.20021591802681,15,9,6,4.03628530818693,10.9637146918131
"2000","ya back",7.20021591802681,15,9,6,4.03628530818693,10.9637146918131
"2000","get cause",7.19670283296369,30,15,15,8.07257061637387,21.9274293836261
"2000","said done",7.19670283296369,30,15,15,8.07257061637387,21.9274293836261
"2000","singer",7.19670283296369,30,15,15,8.07257061637387,21.9274293836261
"1990","dream im",7.19088792594864,21,10,11,4.45503861452016,16.5449613854798
"1990","dum",7.19088792594864,21,10,11,4.45503861452016,16.5449613854798
"1990","ever ever ever",7.19088792594864,21,10,11,4.45503861452016,16.5449613854798
"1990","every move make",7.19088792594864,21,10,11,4.45503861452016,16.5449613854798
"1990","got made",7.19088792594864,21,10,11,4.45503861452016,16.5449613854798
"1990","heart hes",7.19088792594864,21,10,11,4.45503861452016,16.5449613854798
"1990","laid back",7.19088792594864,21,10,11,4.45503861452016,16.5449613854798
"1990","lets give",7.19088792594864,21,10,11,4.45503861452016,16.5449613854798
"1990","nobody baby",7.19088792594864,21,10,11,4.45503861452016,16.5449613854798
"1990","rubbin",7.19088792594864,21,10,11,4.45503861452016,16.5449613854798
"1990","watching us",7.19088792594864,21,10,11,4.45503861452016,16.5449613854798
"1990","will always love",7.19088792594864,21,10,11,4.45503861452016,16.5449613854798
"1990","youwhat",7.19088792594864,21,10,11,4.45503861452016,16.5449613854798
"2010","anybody",7.18998198967055,131,32,99,20.1691168411778,110.830883158822
"1990","sweeter",7.18870240328063,75,26,49,15.9108521947149,59.0891478052851
"1960","kissed",7.18646413419343,97,13,84,5.79315751910877,91.2068424808912
"1980","danced",7.18457372497701,75,22,53,12.6176795732683,62.3823204267317
"1980","nobodys",7.18457372497701,75,22,53,12.6176795732683,62.3823204267317
"1990","hook",7.17375149764215,86,29,57,18.2444438499397,67.7555561500603
"1980","cant hurry",7.17304798994326,15,7,8,2.52353591465367,12.4764640853463
"1980","crazy like",7.17304798994326,15,7,8,2.52353591465367,12.4764640853463
"1980","crimson",7.17304798994326,15,7,8,2.52353591465367,12.4764640853463
"1980","damage",7.17304798994326,15,7,8,2.52353591465367,12.4764640853463
"1980","end way",7.17304798994326,15,7,8,2.52353591465367,12.4764640853463
"1980","even just",7.17304798994326,15,7,8,2.52353591465367,12.4764640853463
"1980","eyes oh",7.17304798994326,15,7,8,2.52353591465367,12.4764640853463
"1980","ive never seen",7.17304798994326,15,7,8,2.52353591465367,12.4764640853463
"1980","just time",7.17304798994326,15,7,8,2.52353591465367,12.4764640853463
"1980","like whole",7.17304798994326,15,7,8,2.52353591465367,12.4764640853463
"1980","much care",7.17304798994326,15,7,8,2.52353591465367,12.4764640853463
"1980","never take",7.17304798994326,15,7,8,2.52353591465367,12.4764640853463
"1980","night wanna",7.17304798994326,15,7,8,2.52353591465367,12.4764640853463
"1980","put love",7.17304798994326,15,7,8,2.52353591465367,12.4764640853463
"1980","take hand well",7.17304798994326,15,7,8,2.52353591465367,12.4764640853463
"1980","talk let",7.17304798994326,15,7,8,2.52353591465367,12.4764640853463
"1980","want dont want dont",7.17304798994326,15,7,8,2.52353591465367,12.4764640853463
"1980","will mine",7.17304798994326,15,7,8,2.52353591465367,12.4764640853463
"1980","young girls",7.17304798994326,15,7,8,2.52353591465367,12.4764640853463
"1980","youre kind",7.17304798994326,15,7,8,2.52353591465367,12.4764640853463
"2010","raise",7.17200370619548,126,31,95,19.3993032212855,106.600696778715
"1970","soul",7.16649705501607,642,112,530,87.8563465632689,554.143653436731
"1980","bullet",7.15974843355722,62,19,43,10.4306151139018,51.5693848860982
"1980","guide",7.15974843355722,62,19,43,10.4306151139018,51.5693848860982
"1970","beg",7.15576639818263,91,22,69,12.4531581577219,78.5468418422781
"1990","freak",7.15562196868837,186,55,131,39.4589134428929,146.541086557107
"1980","thats just",7.1541920931409,93,26,67,15.6459226708527,77.3540773291473
"1960","shall",7.13774987026706,56,9,47,3.34450331000094,52.6554966899991
"1960","tell whats",7.13774987026706,56,9,47,3.34450331000094,52.6554966899991
"1970","lifes",7.12283717611724,102,24,78,13.958484967996,88.041515032004
"1960","round round",7.11336401160129,154,18,136,9.19738410250259,144.802615897497
"2010","pretty",7.11146341433367,487,97,390,74.9798465775082,412.020153422492
"1990","feels good",7.10837884008575,68,24,44,14.4258393232082,53.5741606767919
"1970","breath away",7.10530530541081,40,12,28,5.47391567372392,34.5260843262761
"1980","aint afraid",7.10522362494684,22,9,13,3.70118600815871,18.2988139918413
"1980","can sure",7.10522362494684,22,9,13,3.70118600815871,18.2988139918413
"1980","cry dont cry",7.10522362494684,22,9,13,3.70118600815871,18.2988139918413
"1980","dont want dont want",7.10522362494684,22,9,13,3.70118600815871,18.2988139918413
"1980","im begging",7.10522362494684,22,9,13,3.70118600815871,18.2988139918413
"1980","now seems",7.10522362494684,22,9,13,3.70118600815871,18.2988139918413
"1980","till morning",7.10522362494684,22,9,13,3.70118600815871,18.2988139918413
"1990","dont see",7.10177248163336,120,38,82,25.4573635115438,94.5426364884562
"1970","come yeah",7.10156767718921,22,8,14,3.01065362054815,18.9893463794518
"1970","dont care say",7.10156767718921,22,8,14,3.01065362054815,18.9893463794518
"1970","dont wanna see",7.10156767718921,22,8,14,3.01065362054815,18.9893463794518
"1970","drowning",7.10156767718921,22,8,14,3.01065362054815,18.9893463794518
"1970","every way",7.10156767718921,22,8,14,3.01065362054815,18.9893463794518
"1970","feel now",7.10156767718921,22,8,14,3.01065362054815,18.9893463794518
"1970","go lets go",7.10156767718921,22,8,14,3.01065362054815,18.9893463794518
"1970","heart belongs",7.10156767718921,22,8,14,3.01065362054815,18.9893463794518
"1970","im begging",7.10156767718921,22,8,14,3.01065362054815,18.9893463794518
"1970","spoil",7.10156767718921,22,8,14,3.01065362054815,18.9893463794518
"1970","will find way",7.10156767718921,22,8,14,3.01065362054815,18.9893463794518
"1970","winters",7.10156767718921,22,8,14,3.01065362054815,18.9893463794518
"2010","well go",7.1012632987719,36,12,24,5.54265806322443,30.4573419367756
"2010","whoa ooh whoa",7.1012632987719,36,12,24,5.54265806322443,30.4573419367756
"1970","always thought",7.09982562340805,14,6,8,1.91587048580337,12.0841295141966
"1970","cant cant cant stand",7.09982562340805,14,6,8,1.91587048580337,12.0841295141966
"1970","cant cant stand",7.09982562340805,14,6,8,1.91587048580337,12.0841295141966
"1970","fall love fall",7.09982562340805,14,6,8,1.91587048580337,12.0841295141966
"1970","im love girl",7.09982562340805,14,6,8,1.91587048580337,12.0841295141966
"1970","know can know",7.09982562340805,14,6,8,1.91587048580337,12.0841295141966
"1970","let feel",7.09982562340805,14,6,8,1.91587048580337,12.0841295141966
"1970","let wait",7.09982562340805,14,6,8,1.91587048580337,12.0841295141966
"1970","like made",7.09982562340805,14,6,8,1.91587048580337,12.0841295141966
"1970","make love cant",7.09982562340805,14,6,8,1.91587048580337,12.0841295141966
"1970","matter matter",7.09982562340805,14,6,8,1.91587048580337,12.0841295141966
"1970","take lot",7.09982562340805,14,6,8,1.91587048580337,12.0841295141966
"1970","bow",7.09835730099002,70,18,52,9.57935242901686,60.4206475709831
"1970","dont look",7.09835730099002,70,18,52,9.57935242901686,60.4206475709831
"1990","cops",7.08975654753732,47,18,29,9.97080070868799,37.029199291312
"1990","know better",7.08975654753732,47,18,29,9.97080070868799,37.029199291312
"1990","make hot",7.08975654753732,47,18,29,9.97080070868799,37.029199291312
"1960","end time",7.0798199935539,29,6,23,1.73197492839334,27.2680250716067
"1960","mind love",7.0798199935539,29,6,23,1.73197492839334,27.2680250716067
"1960","theres time",7.0798199935539,29,6,23,1.73197492839334,27.2680250716067
"1960","times ive",7.0798199935539,29,6,23,1.73197492839334,27.2680250716067
"2010","know id",7.0726648072018,77,21,56,11.8551297463411,65.1448702536589
"2000","go lets",7.05740326894565,41,19,22,11.032513175711,29.9674868242891
"2000","keep keep",7.05740326894565,41,19,22,11.032513175711,29.9674868242891
"1970","go way",7.05709823371364,86,21,65,11.7689186985064,74.2310813014936
"1990","im tryin",7.05686488002141,61,22,39,12.9408264517014,48.0591735482986
"1990","just call",7.05686488002141,61,22,39,12.9408264517014,48.0591735482986
"1990","want make",7.05590544856328,79,27,52,16.759430978433,62.240569021567
"2000","open",7.05550514706091,519,167,352,139.655471663268,379.344528336732
"2010","memory",7.05504040192793,147,35,112,22.6325204248331,124.367479575167
"1970","can make",7.05395482281899,370,69,301,50.6337199819462,319.366280018054
"1990","back someday",7.05313381178844,10,6,4,2.12144695929532,7.87855304070468
"1990","bad enough",7.05313381178844,10,6,4,2.12144695929532,7.87855304070468
"1990","body oh",7.05313381178844,10,6,4,2.12144695929532,7.87855304070468
"1990","can hardly wait",7.05313381178844,10,6,4,2.12144695929532,7.87855304070468
"1990","can see want",7.05313381178844,10,6,4,2.12144695929532,7.87855304070468
"1990","care world",7.05313381178844,10,6,4,2.12144695929532,7.87855304070468
"1990","cause doesnt",7.05313381178844,10,6,4,2.12144695929532,7.87855304070468
"1990","city love",7.05313381178844,10,6,4,2.12144695929532,7.87855304070468
"1990","come feel",7.05313381178844,10,6,4,2.12144695929532,7.87855304070468
"1990","creation",7.05313381178844,10,6,4,2.12144695929532,7.87855304070468
"1990","del",7.05313381178844,10,6,4,2.12144695929532,7.87855304070468
"1990","dont know feels",7.05313381178844,10,6,4,2.12144695929532,7.87855304070468
"1990","eyes cant",7.05313381178844,10,6,4,2.12144695929532,7.87855304070468
"1990","feel let know",7.05313381178844,10,6,4,2.12144695929532,7.87855304070468
"1990","feeling strong",7.05313381178844,10,6,4,2.12144695929532,7.87855304070468
"1990","fool wanna",7.05313381178844,10,6,4,2.12144695929532,7.87855304070468
"1990","get getting",7.05313381178844,10,6,4,2.12144695929532,7.87855304070468
"1990","go walking",7.05313381178844,10,6,4,2.12144695929532,7.87855304070468
"1990","gone away dont",7.05313381178844,10,6,4,2.12144695929532,7.87855304070468
"1990","got hand",7.05313381178844,10,6,4,2.12144695929532,7.87855304070468
"1990","hair can",7.05313381178844,10,6,4,2.12144695929532,7.87855304070468
"1990","hey ill",7.05313381178844,10,6,4,2.12144695929532,7.87855304070468
"1990","im near",7.05313381178844,10,6,4,2.12144695929532,7.87855304070468
"1990","ive never known",7.05313381178844,10,6,4,2.12144695929532,7.87855304070468
"1990","keep love alive",7.05313381178844,10,6,4,2.12144695929532,7.87855304070468
"1990","know everybody",7.05313381178844,10,6,4,2.12144695929532,7.87855304070468
"1990","know wanna know",7.05313381178844,10,6,4,2.12144695929532,7.87855304070468
"1990","love smile",7.05313381178844,10,6,4,2.12144695929532,7.87855304070468
"1990","love thing",7.05313381178844,10,6,4,2.12144695929532,7.87855304070468
"1990","medo",7.05313381178844,10,6,4,2.12144695929532,7.87855304070468
"1990","must take",7.05313381178844,10,6,4,2.12144695929532,7.87855304070468
"1990","night without",7.05313381178844,10,6,4,2.12144695929532,7.87855304070468
"1990","now must",7.05313381178844,10,6,4,2.12144695929532,7.87855304070468
"1990","now want back",7.05313381178844,10,6,4,2.12144695929532,7.87855304070468
"1990","one time say",7.05313381178844,10,6,4,2.12144695929532,7.87855304070468
"1990","papi",7.05313381178844,10,6,4,2.12144695929532,7.87855304070468
"1990","place heart",7.05313381178844,10,6,4,2.12144695929532,7.87855304070468
"1990","real oh",7.05313381178844,10,6,4,2.12144695929532,7.87855304070468
"1990","say youll love",7.05313381178844,10,6,4,2.12144695929532,7.87855304070468
"1990","tears away",7.05313381178844,10,6,4,2.12144695929532,7.87855304070468
"1990","tell want tell",7.05313381178844,10,6,4,2.12144695929532,7.87855304070468
"1990","theres turning",7.05313381178844,10,6,4,2.12144695929532,7.87855304070468
"1990","theres turning back",7.05313381178844,10,6,4,2.12144695929532,7.87855304070468
"1990","want know just",7.05313381178844,10,6,4,2.12144695929532,7.87855304070468
"1990","want lady",7.05313381178844,10,6,4,2.12144695929532,7.87855304070468
"1990","way talkin",7.05313381178844,10,6,4,2.12144695929532,7.87855304070468
"1990","wish bad",7.05313381178844,10,6,4,2.12144695929532,7.87855304070468
"1990","without doubt",7.05313381178844,10,6,4,2.12144695929532,7.87855304070468
"1990","yeah know im",7.05313381178844,10,6,4,2.12144695929532,7.87855304070468
"1990","yeah yeah baby",7.05313381178844,10,6,4,2.12144695929532,7.87855304070468
"1980","baby aint",7.05266484501266,71,21,50,11.944736662694,59.055263337306
"1980","uptown",7.05266484501266,71,21,50,11.944736662694,59.055263337306
"1990","make way",7.04544625136506,37,15,22,7.84935374939267,29.1506462506073
"1990","thing thing",7.04544625136506,37,15,22,7.84935374939267,29.1506462506073
"1970","hung",7.04408154624468,65,17,48,8.89511296980137,56.1048870301986
"2000","babybaby",7.03652939931037,25,13,12,6.72714218031156,18.2728578196884
"2000","boys girls",7.03652939931037,25,13,12,6.72714218031156,18.2728578196884
"2000","can save",7.03652939931037,25,13,12,6.72714218031156,18.2728578196884
"2000","cause see",7.03652939931037,25,13,12,6.72714218031156,18.2728578196884
"2000","fulfill",7.03652939931037,25,13,12,6.72714218031156,18.2728578196884
"2000","lose im",7.03652939931037,25,13,12,6.72714218031156,18.2728578196884
"2000","man know",7.03652939931037,25,13,12,6.72714218031156,18.2728578196884
"2000","much im",7.03652939931037,25,13,12,6.72714218031156,18.2728578196884
"2000","pushin",7.03652939931037,25,13,12,6.72714218031156,18.2728578196884
"2000","soul dont",7.03652939931037,25,13,12,6.72714218031156,18.2728578196884
"2000","starin",7.03652939931037,25,13,12,6.72714218031156,18.2728578196884
"2010","can take time",7.02885405945212,20,8,12,3.07925447956913,16.9207455204309
"2010","cause everything",7.02885405945212,20,8,12,3.07925447956913,16.9207455204309
"2010","dont dance",7.02885405945212,20,8,12,3.07925447956913,16.9207455204309
"2010","girl really",7.02885405945212,20,8,12,3.07925447956913,16.9207455204309
"2010","intro",7.02885405945212,20,8,12,3.07925447956913,16.9207455204309
"2010","mind ill",7.02885405945212,20,8,12,3.07925447956913,16.9207455204309
"2010","need somebody lean",7.02885405945212,20,8,12,3.07925447956913,16.9207455204309
"2010","nigga im",7.02885405945212,20,8,12,3.07925447956913,16.9207455204309
"2010","real im",7.02885405945212,20,8,12,3.07925447956913,16.9207455204309
"2010","really good",7.02885405945212,20,8,12,3.07925447956913,16.9207455204309
"2010","somebody lean",7.02885405945212,20,8,12,3.07925447956913,16.9207455204309
"2010","take like",7.02885405945212,20,8,12,3.07925447956913,16.9207455204309
"1980","secrets",7.02840225186042,98,27,71,16.4871013090706,81.5128986909294
"1970","come easy",7.02569174721723,45,13,32,6.15815513293941,38.8418448670606
"1970","roads",7.02569174721723,45,13,32,6.15815513293941,38.8418448670606
"1970","ache",7.02506394601248,18,7,11,2.46326205317576,15.5367379468242
"1970","aint bad",7.02506394601248,18,7,11,2.46326205317576,15.5367379468242
"1970","away make",7.02506394601248,18,7,11,2.46326205317576,15.5367379468242
"1970","borrow",7.02506394601248,18,7,11,2.46326205317576,15.5367379468242
"1970","come running",7.02506394601248,18,7,11,2.46326205317576,15.5367379468242
"1970","feel feel feel",7.02506394601248,18,7,11,2.46326205317576,15.5367379468242
"1970","good god",7.02506394601248,18,7,11,2.46326205317576,15.5367379468242
"1970","hide away",7.02506394601248,18,7,11,2.46326205317576,15.5367379468242
"1970","ill always love",7.02506394601248,18,7,11,2.46326205317576,15.5367379468242
"1970","lion",7.02506394601248,18,7,11,2.46326205317576,15.5367379468242
"1970","pipe",7.02506394601248,18,7,11,2.46326205317576,15.5367379468242
"1970","sailing",7.02506394601248,18,7,11,2.46326205317576,15.5367379468242
"1970","sha la",7.02506394601248,18,7,11,2.46326205317576,15.5367379468242
"1970","sha la la",7.02506394601248,18,7,11,2.46326205317576,15.5367379468242
"1970","sha la la la",7.02506394601248,18,7,11,2.46326205317576,15.5367379468242
"1970","sunny day",7.02506394601248,18,7,11,2.46326205317576,15.5367379468242
"1970","toot",7.02506394601248,18,7,11,2.46326205317576,15.5367379468242
"1970","way back home",7.02506394601248,18,7,11,2.46326205317576,15.5367379468242
"1970","ya need",7.02506394601248,18,7,11,2.46326205317576,15.5367379468242
"1960","arms",7.02467803938067,556,49,507,33.2061400064379,522.793859993562
"2010","actin",7.02291042165256,63,18,45,9.69965161064275,53.3003483893573
"1960","whisper",7.02171501726298,109,14,95,6.50983679982326,102.490163200177
"1980","angel",7.02086865869217,288,66,222,48.4518895613504,239.54811043865
"1990","weak",7.0064109724023,128,40,88,27.15452107898,100.84547892102
"1970","strange",7.0045313248526,108,25,83,14.7795723190546,93.2204276809454
"2010","back right",7.00158335371983,32,11,21,4.9268071673106,27.0731928326894
"2010","can move",7.00158335371983,32,11,21,4.9268071673106,27.0731928326894
"2010","feeling like",7.00158335371983,32,11,21,4.9268071673106,27.0731928326894
"2010","hey girl",7.00158335371983,32,11,21,4.9268071673106,27.0731928326894
"2010","hey im",7.00158335371983,32,11,21,4.9268071673106,27.0731928326894
"2010","pulling",7.00158335371983,32,11,21,4.9268071673106,27.0731928326894
"2010","stones",7.00158335371983,32,11,21,4.9268071673106,27.0731928326894
"1990","can feel",6.99762159053344,300,83,217,63.6434087788595,236.356591221141
"2000","broad",6.99666929251293,20,11,9,5.38171374424925,14.6182862557508
"2000","can one",6.99666929251293,20,11,9,5.38171374424925,14.6182862557508
"2000","cause everything",6.99666929251293,20,11,9,5.38171374424925,14.6182862557508
"2000","cause im gonna",6.99666929251293,20,11,9,5.38171374424925,14.6182862557508
"2000","christmas",6.99666929251293,20,11,9,5.38171374424925,14.6182862557508
"1960","come back",6.99298943281214,240,25,215,14.3335856142897,225.66641438571
"1970","lover lover",6.98928829217739,50,14,36,6.8423945921549,43.1576054078451
"1970","shore",6.98928829217739,50,14,36,6.8423945921549,43.1576054078451
"2000","singing",6.98903932688636,223,78,145,60.0061082483791,162.993891751621
"1970","ticket",6.98491730709551,55,15,40,7.52663405137039,47.4733659486296
"1980","blame",6.9845223566836,263,61,202,44.245996370261,218.754003629739
"1980","youi",6.97788948258301,233,55,178,39.1989245409537,193.801075459046
"1980","took",6.97365714920024,553,117,436,93.0343573868986,459.965642613101
"1970","around around",6.97304516551201,31,10,21,4.24228464713604,26.757715352864
"1970","come im",6.97304516551201,31,10,21,4.24228464713604,26.757715352864
"1970","sucker",6.97304516551201,31,10,21,4.24228464713604,26.757715352864
"1970","wont see",6.97304516551201,31,10,21,4.24228464713604,26.757715352864
"1960","night day",6.96752341260944,77,11,66,4.59869205125129,72.4013079487487
"1960","treated",6.9638950984448,38,7,31,2.26948438892921,35.7305156110708
"1980","can win",6.96361183206775,12,6,6,2.01882873172294,9.98117126827706
"1980","colours",6.96361183206775,12,6,6,2.01882873172294,9.98117126827706
"1980","comes time",6.96361183206775,12,6,6,2.01882873172294,9.98117126827706
"1980","dont feel right",6.96361183206775,12,6,6,2.01882873172294,9.98117126827706
"1980","fatal",6.96361183206775,12,6,6,2.01882873172294,9.98117126827706
"1980","happy im",6.96361183206775,12,6,6,2.01882873172294,9.98117126827706
"1980","ill anything want",6.96361183206775,12,6,6,2.01882873172294,9.98117126827706
"1980","know yes",6.96361183206775,12,6,6,2.01882873172294,9.98117126827706
"1980","lettin go",6.96361183206775,12,6,6,2.01882873172294,9.98117126827706
"1980","light oh",6.96361183206775,12,6,6,2.01882873172294,9.98117126827706
"1980","living without",6.96361183206775,12,6,6,2.01882873172294,9.98117126827706
"1980","look will",6.96361183206775,12,6,6,2.01882873172294,9.98117126827706
"1980","love love need",6.96361183206775,12,6,6,2.01882873172294,9.98117126827706
"1980","mine will",6.96361183206775,12,6,6,2.01882873172294,9.98117126827706
"1980","need love love love",6.96361183206775,12,6,6,2.01882873172294,9.98117126827706
"1980","never took",6.96361183206775,12,6,6,2.01882873172294,9.98117126827706
"1980","new dont",6.96361183206775,12,6,6,2.01882873172294,9.98117126827706
"1980","oh heard",6.96361183206775,12,6,6,2.01882873172294,9.98117126827706
"1980","oh yea",6.96361183206775,12,6,6,2.01882873172294,9.98117126827706
"1980","play part",6.96361183206775,12,6,6,2.01882873172294,9.98117126827706
"1980","play rules",6.96361183206775,12,6,6,2.01882873172294,9.98117126827706
"1980","someday will",6.96361183206775,12,6,6,2.01882873172294,9.98117126827706
"1980","stop us now",6.96361183206775,12,6,6,2.01882873172294,9.98117126827706
"1980","talk can",6.96361183206775,12,6,6,2.01882873172294,9.98117126827706
"1980","theres nothing else",6.96361183206775,12,6,6,2.01882873172294,9.98117126827706
"1980","til morning",6.96361183206775,12,6,6,2.01882873172294,9.98117126827706
"1980","town get",6.96361183206775,12,6,6,2.01882873172294,9.98117126827706
"1980","traveling",6.96361183206775,12,6,6,2.01882873172294,9.98117126827706
"1980","tremble",6.96361183206775,12,6,6,2.01882873172294,9.98117126827706
"1980","try know",6.96361183206775,12,6,6,2.01882873172294,9.98117126827706
"1980","want new",6.96361183206775,12,6,6,2.01882873172294,9.98117126827706
"1980","way come",6.96361183206775,12,6,6,2.01882873172294,9.98117126827706
"1980","youll feel",6.96361183206775,12,6,6,2.01882873172294,9.98117126827706
"1980","baby will",6.95939219891647,54,17,37,9.08472929275321,44.9152707072468
"1980","glamorous",6.95939219891647,54,17,37,9.08472929275321,44.9152707072468
"1980","life dont",6.95939219891647,54,17,37,9.08472929275321,44.9152707072468
"2000","got one",6.95166713820606,109,42,67,29.3303399061584,79.6696600938416
"1970","chorus",6.95082040287175,224,45,179,30.6539277728539,193.346072227146
"2010","just good",6.9491237495328,54,16,38,8.31398709483664,45.6860129051634
"2010","oh know",6.9491237495328,54,16,38,8.31398709483664,45.6860129051634
"2010","right cause",6.9491237495328,54,16,38,8.31398709483664,45.6860129051634
"2010","yes yes",6.9491237495328,54,16,38,8.31398709483664,45.6860129051634
"2000","man want",6.94741442100501,33,16,17,8.87982767801125,24.1201723219887
"2010","comes back",6.94143465224183,28,10,18,4.31095627139678,23.6890437286032
"2010","oh let",6.94143465224183,28,10,18,4.31095627139678,23.6890437286032
"2010","tour",6.94143465224183,28,10,18,4.31095627139678,23.6890437286032
"2010","youd never",6.94143465224183,28,10,18,4.31095627139678,23.6890437286032
"2010","brave",6.93952597728325,24,9,15,3.69510537548295,20.3048946245171
"2010","call want",6.93952597728325,24,9,15,3.69510537548295,20.3048946245171
"2010","drip",6.93952597728325,24,9,15,3.69510537548295,20.3048946245171
"2010","feel alive",6.93952597728325,24,9,15,3.69510537548295,20.3048946245171
"2010","numb",6.93952597728325,24,9,15,3.69510537548295,20.3048946245171
"2010","popping",6.93952597728325,24,9,15,3.69510537548295,20.3048946245171
"2010","tripping",6.93952597728325,24,9,15,3.69510537548295,20.3048946245171
"2010","want somebody",6.93952597728325,24,9,15,3.69510537548295,20.3048946245171
"2000","want got",6.92922313511627,64,27,37,17.2214839815976,46.7785160184024
"1990","bop",6.92712531490422,284,79,205,60.249093643987,223.750906356013
"2010","hey baby",6.92579366858023,122,30,92,18.7834523253717,103.216547674628
"1980","can never",6.92530344874512,67,20,47,11.2717937521197,55.7282062478803
"2000","dis",6.92223759831025,44,20,24,11.8397702373483,32.1602297626517
"2000","pockets",6.92223759831025,44,20,24,11.8397702373483,32.1602297626517
"2010","gave",6.9194474616,466,93,373,71.7466293739606,394.253370626039
"2010","like oh",6.91852548936541,68,19,49,10.469465230535,57.530534769465
"1980","sweet love",6.91722071519691,103,28,75,17.3282799472885,85.6717200527115
"1960","back im",6.91164580608031,67,10,57,4.00145931732255,62.9985406826774
"1960","crying",6.91070353770379,216,23,193,12.9002270528608,203.099772947139
"1960","come come come",6.90127071346204,144,17,127,8.60015136857385,135.399848631426
"1980","words",6.90085015187671,612,128,484,102.96026531787,509.03973468213
"1980","dance can",6.89590239454934,26,10,16,4.37412891873303,21.625871081267
"1980","driving crazy",6.89590239454934,26,10,16,4.37412891873303,21.625871081267
"1980","ive enough",6.89590239454934,26,10,16,4.37412891873303,21.625871081267
"1980","let live",6.89590239454934,26,10,16,4.37412891873303,21.625871081267
"1980","love even",6.89590239454934,26,10,16,4.37412891873303,21.625871081267
"1980","mewhen",6.89590239454934,26,10,16,4.37412891873303,21.625871081267
"1980","nature",6.89590239454934,26,10,16,4.37412891873303,21.625871081267
"1980","upon time",6.89590239454934,26,10,16,4.37412891873303,21.625871081267
"2000","think time",6.89487847643022,67,28,39,18.028741043235,48.971258956765
"1990","fellas",6.89323688777502,98,32,66,20.7901802010941,77.2098197989059
"1960","dont know dont",6.89107253093821,88,12,76,5.25564805857291,82.7443519414271
"1990","friend mine",6.88810962278442,44,17,27,9.33436662089939,34.6656333791006
"1990","go come",6.88810962278442,44,17,27,9.33436662089939,34.6656333791006
"1990","yous",6.88810962278442,44,17,27,9.33436662089939,34.6656333791006
"1970","bridge",6.87943316931896,76,19,57,10.4004397800754,65.5995602199246
"2010","girl",6.8733763913763,4804,806,3998,739.636925992504,4064.3630740075
"2000","difference",6.86844923060225,70,29,41,18.8359981048724,51.1640018951276
"1980","awhile",6.86406963391825,76,22,54,12.7859153009119,63.2140846990881
"1990","everything",6.86278989641846,1269,308,961,269.211619134576,999.788380865424
"1980","glory",6.85031749972824,85,24,61,14.3000368497041,70.6999631502959
"2010","back every",6.84839554295624,13,6,7,2.00151541171993,10.9984845882801
"2010","bitches dont",6.84839554295624,13,6,7,2.00151541171993,10.9984845882801
"2010","blazin",6.84839554295624,13,6,7,2.00151541171993,10.9984845882801
"2010","cage",6.84839554295624,13,6,7,2.00151541171993,10.9984845882801
"2010","cities",6.84839554295624,13,6,7,2.00151541171993,10.9984845882801
"2010","enough take",6.84839554295624,13,6,7,2.00151541171993,10.9984845882801
"2010","eyes ill",6.84839554295624,13,6,7,2.00151541171993,10.9984845882801
"2010","first sight",6.84839554295624,13,6,7,2.00151541171993,10.9984845882801
"2010","ghosts",6.84839554295624,13,6,7,2.00151541171993,10.9984845882801
"2010","got sex",6.84839554295624,13,6,7,2.00151541171993,10.9984845882801
"2010","gotta let go",6.84839554295624,13,6,7,2.00151541171993,10.9984845882801
"2010","ive sleeping",6.84839554295624,13,6,7,2.00151541171993,10.9984845882801
"2010","life gonna",6.84839554295624,13,6,7,2.00151541171993,10.9984845882801
"2010","money got",6.84839554295624,13,6,7,2.00151541171993,10.9984845882801
"2010","need try",6.84839554295624,13,6,7,2.00151541171993,10.9984845882801
"2010","oh yeah thats",6.84839554295624,13,6,7,2.00151541171993,10.9984845882801
"2010","rounds",6.84839554295624,13,6,7,2.00151541171993,10.9984845882801
"2010","spinning around",6.84839554295624,13,6,7,2.00151541171993,10.9984845882801
"2010","swear youre",6.84839554295624,13,6,7,2.00151541171993,10.9984845882801
"2010","thats come",6.84839554295624,13,6,7,2.00151541171993,10.9984845882801
"2010","wont miss",6.84839554295624,13,6,7,2.00151541171993,10.9984845882801
"1980","caught",6.83850334563905,330,74,256,55.5177901223807,274.482209877619
"2010","sin",6.83728272792408,73,20,53,11.2392788504273,61.7607211495727
"1990","go can",6.8315419205997,58,21,37,12.3043923639128,45.6956076360872
"1990","kissing",6.8315419205997,58,21,37,12.3043923639128,45.6956076360872
"1990","better love",6.82827253431313,51,19,32,10.8193794924061,40.1806205075939
"1990","confess",6.82827253431313,51,19,32,10.8193794924061,40.1806205075939
"1960","baby baby baby",6.82380651495431,267,27,240,15.9461139958973,251.053886004103
"2000","alive can",6.81495751441889,13,8,5,3.49811393376201,9.50188606623799
"2000","approach",6.81495751441889,13,8,5,3.49811393376201,9.50188606623799
"2000","away im gonna",6.81495751441889,13,8,5,3.49811393376201,9.50188606623799
"2000","baby ah",6.81495751441889,13,8,5,3.49811393376201,9.50188606623799
"2000","braids",6.81495751441889,13,8,5,3.49811393376201,9.50188606623799
"2000","cause mind",6.81495751441889,13,8,5,3.49811393376201,9.50188606623799
"2000","closer closer",6.81495751441889,13,8,5,3.49811393376201,9.50188606623799
"2000","day goes",6.81495751441889,13,8,5,3.49811393376201,9.50188606623799
"2000","divide",6.81495751441889,13,8,5,3.49811393376201,9.50188606623799
"2000","easy way",6.81495751441889,13,8,5,3.49811393376201,9.50188606623799
"2000","everything cant",6.81495751441889,13,8,5,3.49811393376201,9.50188606623799
"2000","feather",6.81495751441889,13,8,5,3.49811393376201,9.50188606623799
"2000","find girl",6.81495751441889,13,8,5,3.49811393376201,9.50188606623799
"2000","get whats",6.81495751441889,13,8,5,3.49811393376201,9.50188606623799
"2000","gigolo",6.81495751441889,13,8,5,3.49811393376201,9.50188606623799
"2000","give time life",6.81495751441889,13,8,5,3.49811393376201,9.50188606623799
"2000","gotta right",6.81495751441889,13,8,5,3.49811393376201,9.50188606623799
"2000","hit hit",6.81495751441889,13,8,5,3.49811393376201,9.50188606623799
"2000","ill follow",6.81495751441889,13,8,5,3.49811393376201,9.50188606623799
"2000","keep lookin",6.81495751441889,13,8,5,3.49811393376201,9.50188606623799
"2000","kiss away",6.81495751441889,13,8,5,3.49811393376201,9.50188606623799
"2000","misses",6.81495751441889,13,8,5,3.49811393376201,9.50188606623799
"2000","money yeah",6.81495751441889,13,8,5,3.49811393376201,9.50188606623799
"2000","provide",6.81495751441889,13,8,5,3.49811393376201,9.50188606623799
"2000","realize just",6.81495751441889,13,8,5,3.49811393376201,9.50188606623799
"2000","road long",6.81495751441889,13,8,5,3.49811393376201,9.50188606623799
"2000","spend cash",6.81495751441889,13,8,5,3.49811393376201,9.50188606623799
"2000","take tears",6.81495751441889,13,8,5,3.49811393376201,9.50188606623799
"2000","time kiss",6.81495751441889,13,8,5,3.49811393376201,9.50188606623799
"2000","unlike",6.81495751441889,13,8,5,3.49811393376201,9.50188606623799
"2000","vibes",6.81495751441889,13,8,5,3.49811393376201,9.50188606623799
"2000","watch go",6.81495751441889,13,8,5,3.49811393376201,9.50188606623799
"1970","wow",6.81305042950291,120,27,93,16.4217470211718,103.578252978828
"2000","make hot",6.81142538665947,47,21,26,12.6470272989857,34.3529727010143
"1980","never gonna",6.8087983763322,239,56,183,40.2083389068151,198.791661093185
"1980","way go",6.80616320151944,46,15,31,7.73884347160458,38.2611565283954
"2010","faster",6.80372116719034,59,17,42,9.08380071472892,49.9161992852711
"2010","mistakes",6.80372116719034,59,17,42,9.08380071472892,49.9161992852711
"2010","sell",6.80372116719034,59,17,42,9.08380071472892,49.9161992852711
"2010","yeah dont",6.80372116719034,59,17,42,9.08380071472892,49.9161992852711
"1980","brighter",6.80332689857638,63,19,44,10.5988508415454,52.4011491584546
"1970","anytime",6.8030734487366,71,18,53,9.71620032085995,61.2837996791401
"1990","tears",6.79972281593121,502,131,371,106.496637356625,395.503362643375
"1970","got give",6.79781655902193,36,11,25,4.92652410635153,31.0734758936485
"1970","laying",6.79781655902193,36,11,25,4.92652410635153,31.0734758936485
"1970","think gonna",6.79781655902193,36,11,25,4.92652410635153,31.0734758936485
"1970","bop bop bop",6.79523010112139,87,21,66,11.9057665903495,75.0942334096505
"1970","gonna find",6.79523010112139,87,21,66,11.9057665903495,75.0942334096505
"2010","bent",6.78913419681139,41,13,28,6.31247168311671,34.6875283168833
"2010","dont act",6.78913419681139,41,13,28,6.31247168311671,34.6875283168833
"2010","just enough",6.78913419681139,41,13,28,6.31247168311671,34.6875283168833
"2010","oh come",6.78913419681139,41,13,28,6.31247168311671,34.6875283168833
"1960","oh can",6.7845285794712,78,11,67,4.65841532464417,73.3415846753558
"1960","time come",6.7845285794712,78,11,67,4.65841532464417,73.3415846753558
"1980","make last",6.78293122372373,30,11,19,5.04707182930734,24.9529281706927
"1980","stands",6.78293122372373,30,11,19,5.04707182930734,24.9529281706927
"1980","take good",6.78293122372373,30,11,19,5.04707182930734,24.9529281706927
"1990","push",6.76567886953243,164,49,115,34.7917301324432,129.208269867557
"1990","cant stop",6.76418432565207,236,67,169,50.0661482393695,185.933851760631
"1960","strangers",6.76114443920573,48,8,40,2.86671712285795,45.1332828771421
"1970","worry",6.76050104893914,292,56,236,39.9595844181846,252.040415581815
"1980","want see",6.75608875268919,99,27,72,16.6553370367142,82.3446629632858
"1980","gotta move",6.75525331715489,42,14,28,7.06590056103027,34.9340994389697
"1990","wanna say",6.75192464075263,106,34,72,22.4873377685304,83.5126622314696
"2000","boy im",6.74867900725245,36,17,19,9.68708473964864,26.3129152603514
"2000","just one night",6.74867900725245,36,17,19,9.68708473964864,26.3129152603514
"2000","knee",6.74867900725245,36,17,19,9.68708473964864,26.3129152603514
"2000","talk like",6.74867900725245,36,17,19,9.68708473964864,26.3129152603514
"2010","lover lover",6.74834265306277,50,15,35,7.69813619892281,42.3018638010772
"1960","cant dance",6.74814727107005,30,6,24,1.79169820178622,28.2083017982138
"1960","ended",6.74814727107005,30,6,24,1.79169820178622,28.2083017982138
"1960","kiss lips",6.74814727107005,30,6,24,1.79169820178622,28.2083017982138
"1960","lonesome",6.74814727107005,30,6,24,1.79169820178622,28.2083017982138
"1960","pretty little",6.74814727107005,30,6,24,1.79169820178622,28.2083017982138
"1970","fine",6.74763004732858,608,106,502,83.2035182406035,524.796481759396
"1990","know well",6.74100798410222,91,30,61,19.3051673295874,71.6948326704126
"1990","repeat",6.74100798410222,91,30,61,19.3051673295874,71.6948326704126
"1960","aint got",6.73416939927777,268,27,241,16.0058372692902,251.99416273071
"1980","cared",6.73352429579475,34,12,22,5.72001473988165,28.2799852601184
"1980","drives",6.73352429579475,34,12,22,5.72001473988165,28.2799852601184
"1980","everyones",6.73352429579475,34,12,22,5.72001473988165,28.2799852601184
"1980","find someone",6.73352429579475,34,12,22,5.72001473988165,28.2799852601184
"1980","hearted",6.73352429579475,34,12,22,5.72001473988165,28.2799852601184
"1980","shock",6.73352429579475,34,12,22,5.72001473988165,28.2799852601184
"1990","im free",6.73138422767008,31,13,18,6.57648557381548,24.4235144261845
"1990","now weve",6.73138422767008,31,13,18,6.57648557381548,24.4235144261845
"1990","tape",6.73138422767008,31,13,18,6.57648557381548,24.4235144261845
"1980","chances",6.72835433867215,38,13,25,6.39295765045596,31.607042349544
"1980","guess thats",6.72835433867215,38,13,25,6.39295765045596,31.607042349544
"1980","hopes",6.72835433867215,38,13,25,6.39295765045596,31.607042349544
"1980","life aint",6.72835433867215,38,13,25,6.39295765045596,31.607042349544
"1970","gonna dance",6.72608592449188,27,9,18,3.69489307976364,23.3051069202364
"1970","heart let",6.72608592449188,27,9,18,3.69489307976364,23.3051069202364
"1960","sweet sweet",6.72280742279616,89,12,77,5.31537133196578,83.6846286680342
"2000","day life",6.7206445623148,50,22,28,13.4542843606231,36.5457156393769
"2000","wasting",6.7206445623148,50,22,28,13.4542843606231,36.5457156393769
"2000","bei",6.71692264409944,28,14,14,7.53439924194894,20.4656007580511
"2000","brown eyes",6.71692264409944,28,14,14,7.53439924194894,20.4656007580511
"2000","far im",6.71692264409944,28,14,14,7.53439924194894,20.4656007580511
"2000","lit",6.71692264409944,28,14,14,7.53439924194894,20.4656007580511
"2000","superstar",6.71692264409944,28,14,14,7.53439924194894,20.4656007580511
"1980","ask just",6.70684224292626,19,8,11,3.19647882522798,15.803521174772
"1980","cant control",6.70684224292626,19,8,11,3.19647882522798,15.803521174772
"1980","dedicate",6.70684224292626,19,8,11,3.19647882522798,15.803521174772
"1980","dim",6.70684224292626,19,8,11,3.19647882522798,15.803521174772
"1980","feel magic",6.70684224292626,19,8,11,3.19647882522798,15.803521174772
"1980","friend im",6.70684224292626,19,8,11,3.19647882522798,15.803521174772
"1980","fuss",6.70684224292626,19,8,11,3.19647882522798,15.803521174772
"1980","go time",6.70684224292626,19,8,11,3.19647882522798,15.803521174772
"1980","love youve",6.70684224292626,19,8,11,3.19647882522798,15.803521174772
"1980","nothing can say",6.70684224292626,19,8,11,3.19647882522798,15.803521174772
"1980","oh gonna",6.70684224292626,19,8,11,3.19647882522798,15.803521174772
"1980","put arms around",6.70684224292626,19,8,11,3.19647882522798,15.803521174772
"1980","risin",6.70684224292626,19,8,11,3.19647882522798,15.803521174772
"1980","shallow",6.70684224292626,19,8,11,3.19647882522798,15.803521174772
"1980","systems",6.70684224292626,19,8,11,3.19647882522798,15.803521174772
"1980","tell wont",6.70684224292626,19,8,11,3.19647882522798,15.803521174772
"1980","theres nobody",6.70684224292626,19,8,11,3.19647882522798,15.803521174772
"1980","wont hurt",6.70684224292626,19,8,11,3.19647882522798,15.803521174772
"1980","youre lost",6.70684224292626,19,8,11,3.19647882522798,15.803521174772
"1960","pieces",6.70663354866078,100,13,87,5.97232733928739,94.0276726607126
"1970","doggone",6.69678643082319,41,12,29,5.61076356556702,35.389236434433
"1970","take breath",6.69678643082319,41,12,29,5.61076356556702,35.389236434433
"1960","gentle",6.69658889145401,58,9,49,3.46394985678669,54.5360501432133
"1960","twice",6.69354541410802,134,16,118,8.00291863464511,125.997081365355
"1990","hittin",6.69133709141699,41,16,25,8.6979325331108,32.3020674668892
"1980","foolish",6.68779229046637,59,18,41,9.9259079309711,49.0740920690289
"1960","ill try",6.68568805471062,39,7,32,2.32920766232208,36.6707923376779
"1960","youre doin",6.68568805471062,39,7,32,2.32920766232208,36.6707923376779
"2010","forget",6.68018068369211,491,97,394,75.595697473422,415.404302526578
"2010","wanna take",6.67960741533757,118,29,89,18.1676014294578,99.8323985705422
"2010","look like",6.6571068265258,108,27,81,16.6279741896733,91.3720258103267
"1970","lost",6.64742800852297,635,110,525,86.8984113203672,548.101588679633
"1970","aint right",6.64703732380111,46,13,33,6.29500302478251,39.7049969752175
"1970","la da da",6.64703732380111,46,13,33,6.29500302478251,39.7049969752175
"1970","lonely nights",6.64703732380111,46,13,33,6.29500302478251,39.7049969752175
"1970","want want want",6.64703732380111,46,13,33,6.29500302478251,39.7049969752175
"2010","hey yeah",6.63829243635869,37,12,25,5.69662078720288,31.3033792127971
"1970","gonna stay",6.6342649605901,51,14,37,6.97924248399799,44.020757516002
"1970","table",6.6342649605901,51,14,37,6.97924248399799,44.020757516002
"1990","air dont",6.62327631484376,13,7,6,2.75788104708391,10.2421189529161
"1990","always ill",6.62327631484376,13,7,6,2.75788104708391,10.2421189529161
"1990","beat now",6.62327631484376,13,7,6,2.75788104708391,10.2421189529161
"1990","better let go",6.62327631484376,13,7,6,2.75788104708391,10.2421189529161
"1990","buggin",6.62327631484376,13,7,6,2.75788104708391,10.2421189529161
"1990","can man",6.62327631484376,13,7,6,2.75788104708391,10.2421189529161
"1990","cant help im",6.62327631484376,13,7,6,2.75788104708391,10.2421189529161
"1990","chinese",6.62327631484376,13,7,6,2.75788104708391,10.2421189529161
"1990","day id",6.62327631484376,13,7,6,2.75788104708391,10.2421189529161
"1990","dayand",6.62327631484376,13,7,6,2.75788104708391,10.2421189529161
"1990","demanding",6.62327631484376,13,7,6,2.75788104708391,10.2421189529161
"1990","eclipse",6.62327631484376,13,7,6,2.75788104708391,10.2421189529161
"1990","girl looked",6.62327631484376,13,7,6,2.75788104708391,10.2421189529161
"1990","give back",6.62327631484376,13,7,6,2.75788104708391,10.2421189529161
"1990","got live",6.62327631484376,13,7,6,2.75788104708391,10.2421189529161
"1990","know going",6.62327631484376,13,7,6,2.75788104708391,10.2421189529161
"1990","light dont",6.62327631484376,13,7,6,2.75788104708391,10.2421189529161
"1990","might take",6.62327631484376,13,7,6,2.75788104708391,10.2421189529161
"1990","place dont",6.62327631484376,13,7,6,2.75788104708391,10.2421189529161
"1990","tearing apart",6.62327631484376,13,7,6,2.75788104708391,10.2421189529161
"1990","tears will",6.62327631484376,13,7,6,2.75788104708391,10.2421189529161
"1990","total eclipse",6.62327631484376,13,7,6,2.75788104708391,10.2421189529161
"1990","walk right",6.62327631484376,13,7,6,2.75788104708391,10.2421189529161
"1990","whys",6.62327631484376,13,7,6,2.75788104708391,10.2421189529161
"1990","will feel",6.62327631484376,13,7,6,2.75788104708391,10.2421189529161
"1990","wrong gonna",6.62327631484376,13,7,6,2.75788104708391,10.2421189529161
"1980","just cant",6.61550628789387,493,105,388,82.9402137282839,410.059786271716
"1990","day",6.61340993585695,2215,520,1695,469.900501483913,1745.09949851609
"2000","hoe",6.6109799859328,110,42,68,29.5994255933708,80.4005744066291
"1990","id give",6.60733135541566,55,20,35,11.6679582761242,43.3320417238758
"1990","joe",6.60733135541566,55,20,35,11.6679582761242,43.3320417238758
"1960","come home",6.60574387288867,79,11,68,4.71813859803704,74.281861401963
"1960","jesus",6.60574387288867,79,11,68,4.71813859803704,74.281861401963
"2010","dont really",6.60521835952534,144,34,110,22.1706322528977,121.829367747102
"2010","stood",6.60317080457815,69,19,50,10.6234279545135,58.3765720454865
"1980","wanna dance",6.5957998707767,95,26,69,15.9823941261399,79.0176058738601
"1980","look around",6.59090143919637,68,20,48,11.4400294797633,56.5599705202367
"2000","trick",6.58649086439514,56,24,32,15.0687984838979,40.9312015161021
"1990","fat",6.58439909198226,99,32,67,21.0023248970236,77.9976751029764
"2000","away dont know",6.56023050643969,23,12,11,6.18897080588663,16.8110291941134
"2000","back know",6.56023050643969,23,12,11,6.18897080588663,16.8110291941134
"2000","floatin",6.56023050643969,23,12,11,6.18897080588663,16.8110291941134
"2000","goin nowhere",6.56023050643969,23,12,11,6.18897080588663,16.8110291941134
"2000","one one one",6.56023050643969,23,12,11,6.18897080588663,16.8110291941134
"2000","really really really",6.56023050643969,23,12,11,6.18897080588663,16.8110291941134
"2000","ringing",6.56023050643969,23,12,11,6.18897080588663,16.8110291941134
"1960","jack",6.55804468784781,90,12,78,5.37509460535865,84.6249053946413
"2000","walk away",6.55555308146186,170,61,109,45.7445668261186,124.255433173881
"2010","life like",6.55522672092109,46,14,32,7.08228530300899,38.917714696991
"2010","thing know",6.55522672092109,46,14,32,7.08228530300899,38.917714696991
"2000","quite",6.55487459496241,104,40,64,27.9849114700961,76.0150885299039
"1970","dreamin",6.54067714640252,88,21,67,12.0426144821926,75.9573855178074
"1970","dry",6.54067714640252,88,21,67,12.0426144821926,75.9573855178074
"2000","can let",6.5392361724488,18,10,8,4.84354236982432,13.1564576301757
"2000","chips",6.5392361724488,18,10,8,4.84354236982432,13.1564576301757
"2000","even youre",6.5392361724488,18,10,8,4.84354236982432,13.1564576301757
"2000","every time see",6.5392361724488,18,10,8,4.84354236982432,13.1564576301757
"2000","girls say",6.5392361724488,18,10,8,4.84354236982432,13.1564576301757
"2000","gonna catch",6.5392361724488,18,10,8,4.84354236982432,13.1564576301757
"2000","know want want",6.5392361724488,18,10,8,4.84354236982432,13.1564576301757
"2000","night young",6.5392361724488,18,10,8,4.84354236982432,13.1564576301757
"2000","obvious",6.5392361724488,18,10,8,4.84354236982432,13.1564576301757
"2000","van",6.5392361724488,18,10,8,4.84354236982432,13.1564576301757
"2000","wanna see ya",6.5392361724488,18,10,8,4.84354236982432,13.1564576301757
"2000","work harder",6.5392361724488,18,10,8,4.84354236982432,13.1564576301757
"2000","ah ah ah ah",6.53837412893003,59,25,34,15.8760555455353,43.1239444544647
"2000","breathing",6.53837412893003,59,25,34,15.8760555455353,43.1239444544647
"2010","im talking",6.53644525149958,74,20,54,11.3932415744058,62.6067584255942
"2000","job",6.52963135733646,101,39,62,27.1776544084587,73.8223455915413
"1970","got time",6.52817370517728,99,23,76,13.5479412924667,85.4520587075333
"1960","afternoon",6.52376752622967,49,8,41,2.92644039625082,46.0735596037492
"1960","oh sweet",6.52376752622967,49,8,41,2.92644039625082,46.0735596037492
"1960","tell ya",6.52165724592311,69,10,59,4.1209058641083,64.8790941358917
"1960","thought id",6.52165724592311,69,10,59,4.1209058641083,64.8790941358917
"1990","near",6.52121809078092,213,61,152,45.1868202329902,167.81317976701
"1970","dont come easy",6.51693119269994,23,8,15,3.14750151239125,19.8524984876087
"1970","em know",6.51693119269994,23,8,15,3.14750151239125,19.8524984876087
"1970","feel baby",6.51693119269994,23,8,15,3.14750151239125,19.8524984876087
"1970","free soul",6.51693119269994,23,8,15,3.14750151239125,19.8524984876087
"1970","love deep love",6.51693119269994,23,8,15,3.14750151239125,19.8524984876087
"1970","never loved",6.51693119269994,23,8,15,3.14750151239125,19.8524984876087
"1970","ringing",6.51693119269994,23,8,15,3.14750151239125,19.8524984876087
"1970","way take",6.51693119269994,23,8,15,3.14750151239125,19.8524984876087
"1970","summer",6.51321168214352,331,62,269,45.2966522000654,285.703347799935
"1990","let see",6.51160104455669,177,52,125,37.5496111795271,139.450388820473
"1990","baby just",6.51061458978233,205,59,146,43.489662665554,161.510337334446
"2010","flex",6.50949135720759,33,11,22,5.08076989128906,27.9192301087109
"2010","security",6.50949135720759,33,11,22,5.08076989128906,27.9192301087109
"2010","touch touch",6.50949135720759,33,11,22,5.08076989128906,27.9192301087109
"1980","win",6.5069557231601,196,47,149,32.9742026181413,163.025797381859
"2000","later",6.50648640034445,98,38,60,26.3703973468213,71.6296026531787
"2000","que",6.50406961610943,167,60,107,44.9373097644812,122.062690235519
"2010","aint trying",6.50365403723312,17,7,10,2.61736630763376,14.3826336923662
"2010","belt",6.50365403723312,17,7,10,2.61736630763376,14.3826336923662
"2010","bored",6.50365403723312,17,7,10,2.61736630763376,14.3826336923662
"2010","deep love deep love",6.50365403723312,17,7,10,2.61736630763376,14.3826336923662
"2010","dont know oh",6.50365403723312,17,7,10,2.61736630763376,14.3826336923662
"2010","everybody loves",6.50365403723312,17,7,10,2.61736630763376,14.3826336923662
"2010","first kiss",6.50365403723312,17,7,10,2.61736630763376,14.3826336923662
"2010","heart girl",6.50365403723312,17,7,10,2.61736630763376,14.3826336923662
"2010","id anything",6.50365403723312,17,7,10,2.61736630763376,14.3826336923662
"2010","inside head",6.50365403723312,17,7,10,2.61736630763376,14.3826336923662
"2010","look sky",6.50365403723312,17,7,10,2.61736630763376,14.3826336923662
"2010","oh make",6.50365403723312,17,7,10,2.61736630763376,14.3826336923662
"2010","one get",6.50365403723312,17,7,10,2.61736630763376,14.3826336923662
"2010","rays",6.50365403723312,17,7,10,2.61736630763376,14.3826336923662
"2010","take stand",6.50365403723312,17,7,10,2.61736630763376,14.3826336923662
"1970","lonely days",6.50340832443736,32,10,22,4.37913253897913,27.6208674610209
"1970","love bad",6.50340832443736,32,10,22,4.37913253897913,27.6208674610209
"1970","yeah oh yeah oh",6.50340832443736,32,10,22,4.37913253897913,27.6208674610209
"2000","know gotta",6.50049239450948,62,26,36,16.6833126071727,45.3166873928273
"2000","now see",6.50049239450948,62,26,36,16.6833126071727,45.3166873928273
"1990","dance cant",6.49056083615043,25,11,14,5.30361739823829,19.6963826017617
"1990","going back",6.49056083615043,25,11,14,5.30361739823829,19.6963826017617
"1990","move make",6.49056083615043,25,11,14,5.30361739823829,19.6963826017617
"1990","time ago",6.49056083615043,25,11,14,5.30361739823829,19.6963826017617
"2000","man just",6.46959022376455,31,15,16,8.34165630358633,22.6583436964137
"2000","explain",6.46631241805701,126,47,79,33.9047965887702,92.0952034112297
"2000","boy cause",6.46522908026581,11,7,4,2.95994255933709,8.04005744066292
"2000","break like",6.46522908026581,11,7,4,2.95994255933709,8.04005744066292
"2000","come check",6.46522908026581,11,7,4,2.95994255933709,8.04005744066292
"2000","control cause",6.46522908026581,11,7,4,2.95994255933709,8.04005744066292
"2000","cry dont know",6.46522908026581,11,7,4,2.95994255933709,8.04005744066292
"2000","dealin",6.46522908026581,11,7,4,2.95994255933709,8.04005744066292
"2000","doc",6.46522908026581,11,7,4,2.95994255933709,8.04005744066292
"2000","dont show",6.46522908026581,11,7,4,2.95994255933709,8.04005744066292
"2000","eye can",6.46522908026581,11,7,4,2.95994255933709,8.04005744066292
"2000","flashin",6.46522908026581,11,7,4,2.95994255933709,8.04005744066292
"2000","girlfriend shes",6.46522908026581,11,7,4,2.95994255933709,8.04005744066292
"2000","happy now",6.46522908026581,11,7,4,2.95994255933709,8.04005744066292
"2000","heals",6.46522908026581,11,7,4,2.95994255933709,8.04005744066292
"2000","hug kiss",6.46522908026581,11,7,4,2.95994255933709,8.04005744066292
"2000","ill call",6.46522908026581,11,7,4,2.95994255933709,8.04005744066292
"2000","im broken",6.46522908026581,11,7,4,2.95994255933709,8.04005744066292
"2000","inside want",6.46522908026581,11,7,4,2.95994255933709,8.04005744066292
"2000","jag",6.46522908026581,11,7,4,2.95994255933709,8.04005744066292
"2000","kiss got",6.46522908026581,11,7,4,2.95994255933709,8.04005744066292
"2000","knock door",6.46522908026581,11,7,4,2.95994255933709,8.04005744066292
"2000","know inside",6.46522908026581,11,7,4,2.95994255933709,8.04005744066292
"2000","know know let",6.46522908026581,11,7,4,2.95994255933709,8.04005744066292
"2000","know stay",6.46522908026581,11,7,4,2.95994255933709,8.04005744066292
"2000","leave can",6.46522908026581,11,7,4,2.95994255933709,8.04005744066292
"2000","lets turn",6.46522908026581,11,7,4,2.95994255933709,8.04005744066292
"2000","loss",6.46522908026581,11,7,4,2.95994255933709,8.04005744066292
"2000","lovenow",6.46522908026581,11,7,4,2.95994255933709,8.04005744066292
"2000","makes laugh",6.46522908026581,11,7,4,2.95994255933709,8.04005744066292
"2000","night day im",6.46522908026581,11,7,4,2.95994255933709,8.04005744066292
"2000","outfit",6.46522908026581,11,7,4,2.95994255933709,8.04005744066292
"2000","people know",6.46522908026581,11,7,4,2.95994255933709,8.04005744066292
"2000","poster",6.46522908026581,11,7,4,2.95994255933709,8.04005744066292
"2000","shit get",6.46522908026581,11,7,4,2.95994255933709,8.04005744066292
"2000","talk cant",6.46522908026581,11,7,4,2.95994255933709,8.04005744066292
"2000","theres gotta",6.46522908026581,11,7,4,2.95994255933709,8.04005744066292
"2000","time come around",6.46522908026581,11,7,4,2.95994255933709,8.04005744066292
"2000","true got",6.46522908026581,11,7,4,2.95994255933709,8.04005744066292
"2000","tryin keep",6.46522908026581,11,7,4,2.95994255933709,8.04005744066292
"2000","uh now",6.46522908026581,11,7,4,2.95994255933709,8.04005744066292
"2000","us say",6.46522908026581,11,7,4,2.95994255933709,8.04005744066292
"2000","wanna start",6.46522908026581,11,7,4,2.95994255933709,8.04005744066292
"2000","words got",6.46522908026581,11,7,4,2.95994255933709,8.04005744066292
"2010","let em",6.46513781296739,60,17,43,9.23776343870738,50.7622365612926
"2000","sha",6.45984887841486,42,19,23,11.3015988629234,30.6984011370766
"1960","alright",6.45415345757284,705,59,646,42.1049077419761,662.895092258024
"2000","fucking",6.45172312985504,89,35,54,23.9486261619091,65.0513738380909
"1980","away baby",6.45169198479944,23,9,14,3.86942173580229,19.1305782641977
"1980","true im",6.45169198479944,23,9,14,3.86942173580229,19.1305782641977
"2000","like yeah",6.45010759241555,68,28,40,18.2978267304474,49.7021732695526
"2000","notice",6.45010759241555,68,28,40,18.2978267304474,49.7021732695526
"2010","half",6.44382974214564,230,50,180,35.4114265150449,194.588573484955
"1990","account",6.44213085277351,16,8,8,3.39431513487251,12.6056848651275
"1990","body move",6.44213085277351,16,8,8,3.39431513487251,12.6056848651275
"1990","cheatin",6.44213085277351,16,8,8,3.39431513487251,12.6056848651275
"1990","dont know baby",6.44213085277351,16,8,8,3.39431513487251,12.6056848651275
"1990","ease pain",6.44213085277351,16,8,8,3.39431513487251,12.6056848651275
"1990","heart break heart",6.44213085277351,16,8,8,3.39431513487251,12.6056848651275
"1990","hey yo",6.44213085277351,16,8,8,3.39431513487251,12.6056848651275
"1990","just close eyes",6.44213085277351,16,8,8,3.39431513487251,12.6056848651275
"1990","just sure",6.44213085277351,16,8,8,3.39431513487251,12.6056848651275
"1990","keep tryin",6.44213085277351,16,8,8,3.39431513487251,12.6056848651275
"1990","man wants",6.44213085277351,16,8,8,3.39431513487251,12.6056848651275
"1990","put put put",6.44213085277351,16,8,8,3.39431513487251,12.6056848651275
"1990","see wonder",6.44213085277351,16,8,8,3.39431513487251,12.6056848651275
"1990","seei",6.44213085277351,16,8,8,3.39431513487251,12.6056848651275
"1990","someday youll",6.44213085277351,16,8,8,3.39431513487251,12.6056848651275
"1990","talk baby",6.44213085277351,16,8,8,3.39431513487251,12.6056848651275
"1990","things way",6.44213085277351,16,8,8,3.39431513487251,12.6056848651275
"1990","think found",6.44213085277351,16,8,8,3.39431513487251,12.6056848651275
"1990","turning back",6.44213085277351,16,8,8,3.39431513487251,12.6056848651275
"1990","wanna dont",6.44213085277351,16,8,8,3.39431513487251,12.6056848651275
"1990","well feelin",6.44213085277351,16,8,8,3.39431513487251,12.6056848651275
"1970","stars",6.4399770179102,313,59,254,42.8333901468896,270.16660985311
"2000","early",6.43549713423932,71,29,42,19.1050837920848,51.8949162079152
"1970","cat",6.43484340148991,83,20,63,11.3583750229771,71.6416249770229
"1960","add",6.43315299349845,31,6,25,1.85142147517909,29.1485785248209
"1960","ba ba ba",6.43315299349845,31,6,25,1.85142147517909,29.1485785248209
"1960","happening",6.43315299349845,31,6,25,1.85142147517909,29.1485785248209
"1960","smiled",6.43315299349845,31,6,25,1.85142147517909,29.1485785248209
"1960","till end",6.43315299349845,31,6,25,1.85142147517909,29.1485785248209
"1960","yeah think",6.43315299349845,31,6,25,1.85142147517909,29.1485785248209
"2000","movie",6.42462788255047,80,32,48,21.526854976997,58.473145023003
"1990","baby need",6.41901702716477,59,21,38,12.5165370598424,46.4834629401576
"1990","cats",6.41901702716477,59,21,38,12.5165370598424,46.4834629401576
"1960","ears",6.41870351538282,40,7,33,2.38893093571496,37.611069064285
"1990","day come",6.41590761643699,22,10,12,4.6671833104497,17.3328166895503
"1990","day without",6.41590761643699,22,10,12,4.6671833104497,17.3328166895503
"1990","fades",6.41590761643699,22,10,12,4.6671833104497,17.3328166895503
"1990","feel just",6.41590761643699,22,10,12,4.6671833104497,17.3328166895503
"1990","french",6.41590761643699,22,10,12,4.6671833104497,17.3328166895503
"1990","let slip",6.41590761643699,22,10,12,4.6671833104497,17.3328166895503
"1990","matter time",6.41590761643699,22,10,12,4.6671833104497,17.3328166895503
"1990","please believe",6.41590761643699,22,10,12,4.6671833104497,17.3328166895503
"1990","real feel",6.41590761643699,22,10,12,4.6671833104497,17.3328166895503
"1990","will find way",6.41590761643699,22,10,12,4.6671833104497,17.3328166895503
"1990","youre far",6.41590761643699,22,10,12,4.6671833104497,17.3328166895503
"2010","smell",6.41350729848567,94,24,70,14.4724960539749,79.5275039460251
"2010","darkest",6.41141072461137,29,10,19,4.46491899537523,24.5350810046248
"2010","ill know",6.41141072461137,29,10,19,4.46491899537523,24.5350810046248
"2010","said want",6.41141072461137,29,10,19,4.46491899537523,24.5350810046248
"2010","sit back",6.41141072461137,29,10,19,4.46491899537523,24.5350810046248
"2010","yeah let",6.41141072461137,29,10,19,4.46491899537523,24.5350810046248
"2010","ever ever",6.41054731443225,104,26,78,16.0121232937595,87.9878767062406
"1970","dont love",6.40898711131874,94,22,72,12.8637018332512,81.1362981667488
"1970","wrote",6.40898711131874,94,22,72,12.8637018332512,81.1362981667488
"1990","gonna rock",6.40231679436292,45,17,28,9.54651131682892,35.4534886831711
"1990","got make",6.40231679436292,45,17,28,9.54651131682892,35.4534886831711
"1990","just remember",6.40231679436292,45,17,28,9.54651131682892,35.4534886831711
"1990","mind mind",6.40231679436292,45,17,28,9.54651131682892,35.4534886831711
"1990","recall",6.40231679436292,45,17,28,9.54651131682892,35.4534886831711
"1990","serious",6.40231679436292,45,17,28,9.54651131682892,35.4534886831711
"1980","time oh",6.39560062847441,47,15,32,7.90707919924816,39.0929208007518
"1960","im gonna",6.39457008437765,1035,82,953,61.8135879616245,973.186412038375
"1960","happen",6.39366141124336,172,19,153,10.2724030235743,161.727596976426
"1990","always like",6.39064041365899,19,9,10,4.0307492226611,14.9692507773389
"1990","central",6.39064041365899,19,9,10,4.0307492226611,14.9692507773389
"1990","flashy",6.39064041365899,19,9,10,4.0307492226611,14.9692507773389
"1990","helpless",6.39064041365899,19,9,10,4.0307492226611,14.9692507773389
"1990","know keep",6.39064041365899,19,9,10,4.0307492226611,14.9692507773389
"1990","like eagle",6.39064041365899,19,9,10,4.0307492226611,14.9692507773389
"1990","love need love need",6.39064041365899,19,9,10,4.0307492226611,14.9692507773389
"1990","need give",6.39064041365899,19,9,10,4.0307492226611,14.9692507773389
"1990","said id",6.39064041365899,19,9,10,4.0307492226611,14.9692507773389
"1990","serve",6.39064041365899,19,9,10,4.0307492226611,14.9692507773389
"2000","hop",6.38896655808296,120,45,75,32.2902824654955,87.7097175345045
"1980","heaven",6.38805761456195,432,93,339,72.6778343420257,359.322165657974
"1990","need oh",6.38442327785374,52,19,33,11.0315241883356,40.9684758116644
"1970","along",6.38399958704706,401,73,328,54.8760046290823,346.123995370918
"1980","voice",6.38000013177812,177,43,134,29.7777237929133,147.222276207087
"1970","oughta",6.37481202254292,37,11,26,5.06337199819462,31.9366280018054
"1990","faith",6.37476793508131,146,44,102,30.9731256057116,115.026874394288
"2010","bucks",6.37351003402675,21,8,13,3.23321720354758,17.7667827964524
"2010","day know",6.37351003402675,21,8,13,3.23321720354758,17.7667827964524
"2010","haha",6.37351003402675,21,8,13,3.23321720354758,17.7667827964524
"2010","never felt way",6.37351003402675,21,8,13,3.23321720354758,17.7667827964524
"2010","night life",6.37351003402675,21,8,13,3.23321720354758,17.7667827964524
"2010","right need",6.37351003402675,21,8,13,3.23321720354758,17.7667827964524
"2010","show youre",6.37351003402675,21,8,13,3.23321720354758,17.7667827964524
"2010","stop wont",6.37351003402675,21,8,13,3.23321720354758,17.7667827964524
"2010","tiger",6.37351003402675,21,8,13,3.23321720354758,17.7667827964524
"2010","wont stay",6.37351003402675,21,8,13,3.23321720354758,17.7667827964524
"2010","yeah ooh yeah",6.37351003402675,21,8,13,3.23321720354758,17.7667827964524
"2010","note",6.37188501787659,42,13,29,6.46643440709516,35.5335655929048
"2010","wreck",6.37188501787659,42,13,29,6.46643440709516,35.5335655929048
"1960","dont let",6.37113347042744,324,31,293,19.3503405792912,304.649659420709
"2010","baby get",6.37055877739119,65,18,47,10.0075770585997,54.9924229414003
"2010","know know know know",6.37055877739119,65,18,47,10.0075770585997,54.9924229414003
"1970","baby baby ooo baby",6.36815831194418,19,7,12,2.60010994501886,16.3998900549811
"1970","baby ooo baby",6.36815831194418,19,7,12,2.60010994501886,16.3998900549811
"1970","baby ooo baby baby",6.36815831194418,19,7,12,2.60010994501886,16.3998900549811
"1970","everybodys got",6.36815831194418,19,7,12,2.60010994501886,16.3998900549811
"1970","ill play",6.36815831194418,19,7,12,2.60010994501886,16.3998900549811
"1970","know weve",6.36815831194418,19,7,12,2.60010994501886,16.3998900549811
"1970","make whole",6.36815831194418,19,7,12,2.60010994501886,16.3998900549811
"1970","place go",6.36815831194418,19,7,12,2.60010994501886,16.3998900549811
"1970","risin",6.36815831194418,19,7,12,2.60010994501886,16.3998900549811
"1970","trapped",6.36815831194418,19,7,12,2.60010994501886,16.3998900549811
"1970","yeah feel",6.36815831194418,19,7,12,2.60010994501886,16.3998900549811
"1990","since",6.36017891240876,497,129,368,105.435913876977,391.564086123023
"2010","cause dont wanna",6.35803538689211,25,9,16,3.84906809946141,21.1509319005386
"2010","felt way",6.35803538689211,25,9,16,3.84906809946141,21.1509319005386
"2010","fire light",6.35803538689211,25,9,16,3.84906809946141,21.1509319005386
"2010","honest",6.35803538689211,25,9,16,3.84906809946141,21.1509319005386
"2010","im done",6.35803538689211,25,9,16,3.84906809946141,21.1509319005386
"1990","fade",6.35708756253091,150,45,105,31.8217043894297,118.17829561057
"2000","take higher",6.35542678104103,45,20,25,12.1088559245608,32.8911440754392
"2000","one one",6.35158241541341,158,57,101,42.515538579569,115.484461420431
"1990","make wanna",6.35018290438735,96,31,65,20.365890809235,75.634109190765
"1980","can remember",6.33910504611144,16,7,9,2.69177164229725,13.3082283577028
"1980","dance im",6.33910504611144,16,7,9,2.69177164229725,13.3082283577028
"1980","dont bother",6.33910504611144,16,7,9,2.69177164229725,13.3082283577028
"1980","ever told",6.33910504611144,16,7,9,2.69177164229725,13.3082283577028
"1980","everything gonna",6.33910504611144,16,7,9,2.69177164229725,13.3082283577028
"1980","eyes like",6.33910504611144,16,7,9,2.69177164229725,13.3082283577028
"1980","far just",6.33910504611144,16,7,9,2.69177164229725,13.3082283577028
"1980","found way",6.33910504611144,16,7,9,2.69177164229725,13.3082283577028
"1980","girl shes",6.33910504611144,16,7,9,2.69177164229725,13.3082283577028
"1980","going theres",6.33910504611144,16,7,9,2.69177164229725,13.3082283577028
"1980","know shed",6.33910504611144,16,7,9,2.69177164229725,13.3082283577028
"1980","make new",6.33910504611144,16,7,9,2.69177164229725,13.3082283577028
"1980","need love love",6.33910504611144,16,7,9,2.69177164229725,13.3082283577028
"1980","need youre",6.33910504611144,16,7,9,2.69177164229725,13.3082283577028
"1980","never look",6.33910504611144,16,7,9,2.69177164229725,13.3082283577028
"1980","point view",6.33910504611144,16,7,9,2.69177164229725,13.3082283577028
"1980","want around",6.33910504611144,16,7,9,2.69177164229725,13.3082283577028
"1980","youive",6.33910504611144,16,7,9,2.69177164229725,13.3082283577028
"1980","youre much",6.33910504611144,16,7,9,2.69177164229725,13.3082283577028
"1960","hours",6.33411219328131,70,10,60,4.18062913750118,65.8193708624988
"1970","dancer",6.32627214950992,57,15,42,7.80032983505658,49.1996701649434
"1970","dreams come",6.32627214950992,57,15,42,7.80032983505658,49.1996701649434
"1970","got thing",6.32627214950992,57,15,42,7.80032983505658,49.1996701649434
"1970","behind cause",6.32523124139021,15,6,9,2.05271837764647,12.9472816223535
"1970","cause know dont",6.32523124139021,15,6,9,2.05271837764647,12.9472816223535
"1970","dance wanna dance",6.32523124139021,15,6,9,2.05271837764647,12.9472816223535
"1970","feel brand",6.32523124139021,15,6,9,2.05271837764647,12.9472816223535
"1970","get oh",6.32523124139021,15,6,9,2.05271837764647,12.9472816223535
"1970","just kiss",6.32523124139021,15,6,9,2.05271837764647,12.9472816223535
"1970","knew id",6.32523124139021,15,6,9,2.05271837764647,12.9472816223535
"1970","love weve",6.32523124139021,15,6,9,2.05271837764647,12.9472816223535
"1970","make feel brand",6.32523124139021,15,6,9,2.05271837764647,12.9472816223535
"1970","mend broken heart",6.32523124139021,15,6,9,2.05271837764647,12.9472816223535
"1970","mind made",6.32523124139021,15,6,9,2.05271837764647,12.9472816223535
"1970","oh give",6.32523124139021,15,6,9,2.05271837764647,12.9472816223535
"1970","oh oh love",6.32523124139021,15,6,9,2.05271837764647,12.9472816223535
"1970","smile face",6.32523124139021,15,6,9,2.05271837764647,12.9472816223535
"1970","suitcase",6.32523124139021,15,6,9,2.05271837764647,12.9472816223535
"1970","woman aint",6.32523124139021,15,6,9,2.05271837764647,12.9472816223535
"1980","away take",6.32440928231582,43,14,29,7.23413628867385,35.7658637113261
"1980","ive found",6.32440928231582,43,14,29,7.23413628867385,35.7658637113261
"1980","know just",6.31844177651962,237,55,182,39.871867451528,197.128132548472
"1990","babyyou",6.31732603672105,35,14,21,7.42506435753361,27.5749356424664
"1990","just want know",6.31732603672105,35,14,21,7.42506435753361,27.5749356424664
"2010","work",6.3167575803471,844,157,687,129.944539037817,714.055460962183
"1980","aint getting",6.31655860327128,27,10,17,4.5423646463766,22.4576353536234
"1980","baby good",6.31655860327128,27,10,17,4.5423646463766,22.4576353536234
"1980","baby look",6.31655860327128,27,10,17,4.5423646463766,22.4576353536234
"1980","find one",6.31655860327128,27,10,17,4.5423646463766,22.4576353536234
"1980","love right now",6.31655860327128,27,10,17,4.5423646463766,22.4576353536234
"1980","upon",6.31613590423485,207,49,158,34.8247956222206,172.175204377779
"1980","just like",6.31099856773915,618,128,490,103.969679683731,514.030320316269
"1960","just keep",6.30906512676898,137,16,121,8.18208845482373,128.817911545176
"1970","growing",6.30846142193399,42,12,30,5.74761145741011,36.2523885425899
"2000","even though",6.30147035923296,155,56,99,41.7082815179316,113.291718482068
"1970","burnin",6.30132923181687,157,33,124,21.4851190193664,135.514880980634
"2010","keys",6.29883226486713,70,19,51,10.7773906784919,59.2226093215081
"1960","freedom",6.29554547313431,114,14,100,6.80845316678763,107.191546833212
"1970","beginning",6.29408406618223,52,14,38,7.11609037584109,44.8839096241589
"1990","youre still",6.28521078709649,100,32,68,21.2144695929532,78.7855304070468
"1990","call name",6.2818413612939,123,38,85,26.0937975993324,96.9062024006676
"1990","paradise",6.2818413612939,123,38,85,26.0937975993324,96.9062024006676
"1960","oh now",6.28078019936535,60,9,51,3.58339640357244,56.4166035964276
"1960","many",6.27653875544591,541,47,494,32.3102909055448,508.689709094455
"2000","know feels",6.27544548078821,34,16,18,9.14891336522372,24.8510866347763
"2000","mention",6.27544548078821,34,16,18,9.14891336522372,24.8510866347763
"2000","take baby",6.27544548078821,34,16,18,9.14891336522372,24.8510866347763
"1980","forgotten",6.27273522307238,39,13,26,6.56119337809954,32.4388066219005
"1980","knocking",6.27273522307238,39,13,26,6.56119337809954,32.4388066219005
"1980","want hear",6.27273522307238,39,13,26,6.56119337809954,32.4388066219005
"1980","youll know",6.27273522307238,39,13,26,6.56119337809954,32.4388066219005
"1980","addicted",6.26875628600928,69,20,49,11.6082652074069,57.3917347925931
"1980","know will",6.26875628600928,69,20,49,11.6082652074069,57.3917347925931
"1980","youve gone",6.26875628600928,69,20,49,11.6082652074069,57.3917347925931
"2010","know want",6.26570965684125,253,54,199,38.9525691665494,214.047430833451
"1980","looking",6.2627941104727,769,156,613,129.373274557911,639.626725442089
"1960","will see",6.26035171684169,81,11,70,4.83758514482279,76.1624148551772
"1970","face",6.25906819873419,869,145,724,118.920818011652,750.079181988348
"1980","fine youre",6.25658958880918,31,11,20,5.21530755695092,25.7846924430491
"1980","just leave",6.25658958880918,31,11,20,5.21530755695092,25.7846924430491
"1980","looking good",6.25658958880918,31,11,20,5.21530755695092,25.7846924430491
"1980","square",6.25658958880918,31,11,20,5.21530755695092,25.7846924430491
"1960","bang bang",6.25371352673265,103,13,90,6.15149715946602,96.848502840534
"1960","eight",6.25371352673265,103,13,90,6.15149715946602,96.848502840534
"1980","can cant",6.24695406001005,35,12,23,5.88825046752523,29.1117495324748
"1980","planned",6.24695406001005,35,12,23,5.88825046752523,29.1117495324748
"1980","want dont want",6.24695406001005,35,12,23,5.88825046752523,29.1117495324748
"1980","yeah ill",6.24695406001005,35,12,23,5.88825046752523,29.1117495324748
"2010","danced",6.24561907961112,75,20,55,11.5472042983842,63.4527957016158
"2010","switch",6.24561907961112,75,20,55,11.5472042983842,63.4527957016158
"2010","girl can",6.24258704146894,56,16,40,8.62191254279355,47.3780874572064
"2000","got car",6.23714245523519,26,13,13,6.99622786752402,19.003772132476
"2000","huh uh huh uh",6.23714245523519,26,13,13,6.99622786752402,19.003772132476
"2000","im gonna tell",6.23714245523519,26,13,13,6.99622786752402,19.003772132476
"2000","must confess",6.23714245523519,26,13,13,6.99622786752402,19.003772132476
"2000","say hello",6.23714245523519,26,13,13,6.99622786752402,19.003772132476
"2010","done",6.2330266321137,605,116,489,93.1474480069661,511.852551993034
"1990","coco",6.2320834874892,74,25,49,15.6987074987853,58.3012925012147
"1970","baby hold",6.22745073962369,28,9,19,3.83174097160674,24.1682590283933
"1970","can stop",6.22745073962369,28,9,19,3.83174097160674,24.1682590283933
"1970","girl ooh",6.22745073962369,28,9,19,3.83174097160674,24.1682590283933
"1970","long can",6.22745073962369,28,9,19,3.83174097160674,24.1682590283933
"1970","oh never",6.22745073962369,28,9,19,3.83174097160674,24.1682590283933
"1970","rest",6.22569884208076,241,47,194,32.9803419341866,208.019658065813
"1990","back",6.22082053622643,3938,900,3038,835.425812570496,3102.5741874295
"1960","oh yeah",6.21810898216788,542,47,495,32.3700141789377,509.629985821062
"2000","im back",6.21673659022681,105,40,65,28.2539971573085,76.7460028426915
"2000","know aint",6.21673659022681,105,40,65,28.2539971573085,76.7460028426915
"2010","oh youre",6.20761839651869,80,21,59,12.3170179182765,67.6829820817235
"2000","date",6.20335422719616,51,22,29,13.7233700478356,37.2766299521644
"2000","like man",6.20335422719616,51,22,29,13.7233700478356,37.2766299521644
"2000","north",6.20335422719616,51,22,29,13.7233700478356,37.2766299521644
"2010","bullshit",6.20128228424382,38,12,26,5.85058351118134,32.1494164888187
"2010","driver",6.20128228424382,38,12,26,5.85058351118134,32.1494164888187
"2010","need now",6.20128228424382,38,12,26,5.85058351118134,32.1494164888187
"1970","tear",6.20046568982063,193,39,154,26.4116431257179,166.588356874282
"1990","love somebody",6.19410901959697,42,16,26,8.91007722904033,33.0899227709597
"1970","diamond",6.18714818337194,146,31,115,19.9797922090923,126.020207790908
"2000","aint gettin",6.17620416568579,9,6,3,2.42177118491216,6.57822881508784
"2000","aint making",6.17620416568579,9,6,3,2.42177118491216,6.57822881508784
"2000","around aint",6.17620416568579,9,6,3,2.42177118491216,6.57822881508784
"2000","bad ass",6.17620416568579,9,6,3,2.42177118491216,6.57822881508784
"2000","big things",6.17620416568579,9,6,3,2.42177118491216,6.57822881508784
"2000","can mend broken heart",6.17620416568579,9,6,3,2.42177118491216,6.57822881508784
"2000","cant refuse",6.17620416568579,9,6,3,2.42177118491216,6.57822881508784
"2000","cause right now",6.17620416568579,9,6,3,2.42177118491216,6.57822881508784
"2000","chapter",6.17620416568579,9,6,3,2.42177118491216,6.57822881508784
"2000","come stop",6.17620416568579,9,6,3,2.42177118491216,6.57822881508784
"2000","country side",6.17620416568579,9,6,3,2.42177118491216,6.57822881508784
"2000","coupe",6.17620416568579,9,6,3,2.42177118491216,6.57822881508784
"2000","donkey",6.17620416568579,9,6,3,2.42177118491216,6.57822881508784
"2000","dont respect",6.17620416568579,9,6,3,2.42177118491216,6.57822881508784
"2000","dont wanna take",6.17620416568579,9,6,3,2.42177118491216,6.57822881508784
"2000","drink cup",6.17620416568579,9,6,3,2.42177118491216,6.57822881508784
"2000","easy find",6.17620416568579,9,6,3,2.42177118491216,6.57822881508784
"2000","every dream",6.17620416568579,9,6,3,2.42177118491216,6.57822881508784
"2000","every time look",6.17620416568579,9,6,3,2.42177118491216,6.57822881508784
"2000","everything around",6.17620416568579,9,6,3,2.42177118491216,6.57822881508784
"2000","floors",6.17620416568579,9,6,3,2.42177118491216,6.57822881508784
"2000","flop",6.17620416568579,9,6,3,2.42177118491216,6.57822881508784
"2000","follow heart",6.17620416568579,9,6,3,2.42177118491216,6.57822881508784
"2000","gave everything",6.17620416568579,9,6,3,2.42177118491216,6.57822881508784
"2000","head girl",6.17620416568579,9,6,3,2.42177118491216,6.57822881508784
"2000","hear sing",6.17620416568579,9,6,3,2.42177118491216,6.57822881508784
"2000","heres little",6.17620416568579,9,6,3,2.42177118491216,6.57822881508784
"2000","im im im",6.17620416568579,9,6,3,2.42177118491216,6.57822881508784
"2000","im six",6.17620416568579,9,6,3,2.42177118491216,6.57822881508784
"2000","just case",6.17620416568579,9,6,3,2.42177118491216,6.57822881508784
"2000","just shake",6.17620416568579,9,6,3,2.42177118491216,6.57822881508784
"2000","keeps alive",6.17620416568579,9,6,3,2.42177118491216,6.57822881508784
"2000","ladies gentlemen",6.17620416568579,9,6,3,2.42177118491216,6.57822881508784
"2000","learned play",6.17620416568579,9,6,3,2.42177118491216,6.57822881508784
"2000","let drive",6.17620416568579,9,6,3,2.42177118491216,6.57822881508784
"2000","little girl youre",6.17620416568579,9,6,3,2.42177118491216,6.57822881508784
"2000","living living",6.17620416568579,9,6,3,2.42177118491216,6.57822881508784
"2000","looking girl",6.17620416568579,9,6,3,2.42177118491216,6.57822881508784
"2000","love try",6.17620416568579,9,6,3,2.42177118491216,6.57822881508784
"2000","makin money",6.17620416568579,9,6,3,2.42177118491216,6.57822881508784
"2000","mean harm",6.17620416568579,9,6,3,2.42177118491216,6.57822881508784
"2000","need hurry",6.17620416568579,9,6,3,2.42177118491216,6.57822881508784
"2000","never trust",6.17620416568579,9,6,3,2.42177118491216,6.57822881508784
"2000","new man",6.17620416568579,9,6,3,2.42177118491216,6.57822881508784
"2000","now baby dont",6.17620416568579,9,6,3,2.42177118491216,6.57822881508784
"2000","nowhere can",6.17620416568579,9,6,3,2.42177118491216,6.57822881508784
"2000","oh must",6.17620416568579,9,6,3,2.42177118491216,6.57822881508784
"2000","one cry",6.17620416568579,9,6,3,2.42177118491216,6.57822881508784
"2000","ooh see",6.17620416568579,9,6,3,2.42177118491216,6.57822881508784
"2000","party girls",6.17620416568579,9,6,3,2.42177118491216,6.57822881508784
"2000","payed",6.17620416568579,9,6,3,2.42177118491216,6.57822881508784
"2000","pistols",6.17620416568579,9,6,3,2.42177118491216,6.57822881508784
"2000","play safe",6.17620416568579,9,6,3,2.42177118491216,6.57822881508784
"2000","profit",6.17620416568579,9,6,3,2.42177118491216,6.57822881508784
"2000","punch",6.17620416568579,9,6,3,2.42177118491216,6.57822881508784
"2000","right dont know",6.17620416568579,9,6,3,2.42177118491216,6.57822881508784
"2000","right now need",6.17620416568579,9,6,3,2.42177118491216,6.57822881508784
"2000","route",6.17620416568579,9,6,3,2.42177118491216,6.57822881508784
"2000","said im sorry",6.17620416568579,9,6,3,2.42177118491216,6.57822881508784
"2000","said see",6.17620416568579,9,6,3,2.42177118491216,6.57822881508784
"2000","see youd",6.17620416568579,9,6,3,2.42177118491216,6.57822881508784
"2000","sexy body",6.17620416568579,9,6,3,2.42177118491216,6.57822881508784
"2000","snap fingers",6.17620416568579,9,6,3,2.42177118491216,6.57822881508784
"2000","someone come",6.17620416568579,9,6,3,2.42177118491216,6.57822881508784
"2000","sorry things",6.17620416568579,9,6,3,2.42177118491216,6.57822881508784
"2000","spitting",6.17620416568579,9,6,3,2.42177118491216,6.57822881508784
"2000","still lonely",6.17620416568579,9,6,3,2.42177118491216,6.57822881508784
"2000","story girl",6.17620416568579,9,6,3,2.42177118491216,6.57822881508784
"2000","study",6.17620416568579,9,6,3,2.42177118491216,6.57822881508784
"2000","sun come",6.17620416568579,9,6,3,2.42177118491216,6.57822881508784
"2000","sun wont",6.17620416568579,9,6,3,2.42177118491216,6.57822881508784
"2000","think gotta",6.17620416568579,9,6,3,2.42177118491216,6.57822881508784
"2000","toes sand",6.17620416568579,9,6,3,2.42177118491216,6.57822881508784
"2000","top bottom",6.17620416568579,9,6,3,2.42177118491216,6.57822881508784
"2000","uh come",6.17620416568579,9,6,3,2.42177118491216,6.57822881508784
"2000","uh got",6.17620416568579,9,6,3,2.42177118491216,6.57822881508784
"2000","used sing",6.17620416568579,9,6,3,2.42177118491216,6.57822881508784
"2000","visa",6.17620416568579,9,6,3,2.42177118491216,6.57822881508784
"2000","walked life",6.17620416568579,9,6,3,2.42177118491216,6.57822881508784
"2000","whats good",6.17620416568579,9,6,3,2.42177118491216,6.57822881508784
"2000","whites",6.17620416568579,9,6,3,2.42177118491216,6.57822881508784
"2000","youre kinda",6.17620416568579,9,6,3,2.42177118491216,6.57822881508784
"1970","clouds",6.17328273997648,95,22,73,13.0005497250943,81.9994502749057
"2010","gone youre",6.17314563248833,47,14,33,7.23624802698745,39.7637519730126
"2010","wanna hold",6.17314563248833,47,14,33,7.23624802698745,39.7637519730126
"2010","gonna break",6.16757222427336,90,23,67,13.8566451580611,76.1433548419389
"1990","chillin",6.16305375335024,49,18,31,10.3950901005471,38.604909899453
"1960","pearl",6.16232910592524,41,7,34,2.44865420910783,38.5513457908922
"2010","now now",6.16190933181098,95,24,71,14.6264587779533,80.3735412220467
"2010","plans",6.16190933181098,95,24,71,14.6264587779533,80.3735412220467
"2000","alright alright",6.15856394616358,99,38,61,26.6394830340338,72.3605169659662
"2000","beautiful",6.1583938684991,515,164,351,138.579128914418,376.420871085582
"1970","feels good",6.15528230939065,68,17,51,9.30565664533066,58.6943433546693
"2000","girl world",6.14949326162226,54,23,31,14.530627109473,39.469372890527
"1980","oh baby",6.148925958858,387,84,303,65.1072265980647,321.892773401935
"1990","baby theres",6.14367271115209,32,13,19,6.78863026974501,25.211369730255
"1990","boy youre",6.14367271115209,32,13,19,6.78863026974501,25.211369730255
"1990","feeling im",6.14367271115209,32,13,19,6.78863026974501,25.211369730255
"1990","remix",6.14367271115209,32,13,19,6.78863026974501,25.211369730255
"1990","though im",6.14367271115209,32,13,19,6.78863026974501,25.211369730255
"2010","love get",6.13973540334693,61,17,44,9.39172616268583,51.6082738373142
"1990","kiss",6.1382883888086,809,201,608,171.625059006991,637.374940993009
"1960","mountain high",6.13365274017153,32,6,26,1.91114474857197,30.088855251428
"1960","na na na nana",6.13365274017153,32,6,26,1.91114474857197,30.088855251428
"1960","thank thank",6.13365274017153,32,6,26,1.91114474857197,30.088855251428
"1990","little time",6.12694496934581,78,26,52,16.5472862825035,61.4527137174965
"2000","glad came",6.1216448647986,37,17,20,9.9561704268611,27.0438295731389
"2000","now think",6.1216448647986,37,17,20,9.9561704268611,27.0438295731389
"1980","cant hear",6.12118562814333,83,23,60,13.963565394417,69.036434605583
"1990","dont mind",6.11193879738697,155,46,109,32.8824278690774,122.117572130923
"2000","cant sleep",6.10735506174225,57,24,33,15.3378841711103,41.6621158288897
"2000","cause just",6.10735506174225,57,24,33,15.3378841711103,41.6621158288897
"2000","im telling",6.10735506174225,57,24,33,15.3378841711103,41.6621158288897
"2000","like see",6.10735506174225,57,24,33,15.3378841711103,41.6621158288897
"1980","many things",6.10615524806754,52,16,36,8.74825783746605,43.251742162534
"1980","yeah youre",6.10615524806754,52,16,36,8.74825783746605,43.251742162534
"1980","magic",6.09718579523317,279,63,216,46.9377680125582,232.062231987442
"1990","sign",6.08976068059063,167,49,118,35.4281642202318,131.571835779768
"2000","alonei",6.08742938600175,16,9,7,4.3053709953994,11.6946290046006
"2000","always come",6.08742938600175,16,9,7,4.3053709953994,11.6946290046006
"2000","back watch",6.08742938600175,16,9,7,4.3053709953994,11.6946290046006
"2000","believe cause",6.08742938600175,16,9,7,4.3053709953994,11.6946290046006
"2000","bout im",6.08742938600175,16,9,7,4.3053709953994,11.6946290046006
"2000","cant wait see",6.08742938600175,16,9,7,4.3053709953994,11.6946290046006
"2000","come rescue",6.08742938600175,16,9,7,4.3053709953994,11.6946290046006
"2000","come right",6.08742938600175,16,9,7,4.3053709953994,11.6946290046006
"2000","cut like",6.08742938600175,16,9,7,4.3053709953994,11.6946290046006
"2000","gave away",6.08742938600175,16,9,7,4.3053709953994,11.6946290046006
"2000","im lost without",6.08742938600175,16,9,7,4.3053709953994,11.6946290046006
"2000","lay low",6.08742938600175,16,9,7,4.3053709953994,11.6946290046006
"2000","leave love",6.08742938600175,16,9,7,4.3053709953994,11.6946290046006
"2000","like two",6.08742938600175,16,9,7,4.3053709953994,11.6946290046006
"2000","matter youre",6.08742938600175,16,9,7,4.3053709953994,11.6946290046006
"2000","must come",6.08742938600175,16,9,7,4.3053709953994,11.6946290046006
"2000","notch",6.08742938600175,16,9,7,4.3053709953994,11.6946290046006
"2000","smile smile",6.08742938600175,16,9,7,4.3053709953994,11.6946290046006
"2000","sorta",6.08742938600175,16,9,7,4.3053709953994,11.6946290046006
"2000","sun shines",6.08742938600175,16,9,7,4.3053709953994,11.6946290046006
"2000","thisi",6.08742938600175,16,9,7,4.3053709953994,11.6946290046006
"2000","away wont",6.08459540866169,21,11,10,5.65079943146171,15.3492005685383
"2000","collar",6.08459540866169,21,11,10,5.65079943146171,15.3492005685383
"2000","didnt think",6.08459540866169,21,11,10,5.65079943146171,15.3492005685383
"2000","freakin",6.08459540866169,21,11,10,5.65079943146171,15.3492005685383
"2000","front door",6.08459540866169,21,11,10,5.65079943146171,15.3492005685383
"2000","gonna make move",6.08459540866169,21,11,10,5.65079943146171,15.3492005685383
"2000","gotta stay",6.08459540866169,21,11,10,5.65079943146171,15.3492005685383
"2000","man home",6.08459540866169,21,11,10,5.65079943146171,15.3492005685383
"2000","something say",6.08459540866169,21,11,10,5.65079943146171,15.3492005685383
"2000","stop wont",6.08459540866169,21,11,10,5.65079943146171,15.3492005685383
"2000","weakness",6.08459540866169,21,11,10,5.65079943146171,15.3492005685383
"1960","oclock",6.08181054553017,61,9,52,3.64311967696531,57.3568803230347
"1970","wheels",6.07951484107271,63,16,47,8.62141718611517,54.3785828138848
"1960","cherry",6.07256691122195,51,8,43,3.04588694303657,47.9541130569634
"1990","front",6.06424835612433,339,91,248,71.9170519201112,267.082948079889
"2010","pull",6.06329093128607,282,59,223,43.4174881619247,238.582511838075
"1970","coffee",6.0622017284538,33,10,23,4.51598043082223,28.4840195691778
"1970","get feeling",6.0622017284538,33,10,23,4.51598043082223,28.4840195691778
"1970","said ill",6.0622017284538,33,10,23,4.51598043082223,28.4840195691778
"2010","aye",6.05941473873618,152,35,117,23.4023340447254,128.597665955275
"1970","far",6.05907708030711,616,106,510,84.2983013753483,531.701698624652
"2010","girl wanna",6.0477244427821,34,11,23,5.23473261526751,28.7652673847325
"2010","hold im",6.0477244427821,34,11,23,5.23473261526751,28.7652673847325
"2010","wrist",6.0477244427821,34,11,23,5.23473261526751,28.7652673847325
"2010","new york",6.03289308520733,168,38,130,25.8657376283807,142.134262371619
"2000","bein",6.02592909312652,69,28,41,18.5669124176599,50.4330875823401
"2000","questions",6.02592909312652,69,28,41,18.5669124176599,50.4330875823401
"1960","dont care",6.02547529153085,355,33,322,21.2017620544702,333.79823794553
"1990","playa",6.02522986081732,60,21,39,12.7286817557719,47.2713182442281
"1990","see love",6.02522986081732,60,21,39,12.7286817557719,47.2713182442281
"2010","give heart",6.02362513024418,52,15,37,8.00606164687973,43.9939383531203
"2010","raised",6.02362513024418,52,15,37,8.00606164687973,43.9939383531203
"1990","given",6.0232675256316,124,38,86,26.3059422952619,97.6940577047381
"1980","another world",6.02272899861782,13,6,7,2.18706445936651,10.8129355406335
"1980","baby maybe",6.02272899861782,13,6,7,2.18706445936651,10.8129355406335
"1980","bit harder",6.02272899861782,13,6,7,2.18706445936651,10.8129355406335
"1980","bruise",6.02272899861782,13,6,7,2.18706445936651,10.8129355406335
"1980","cant imagine",6.02272899861782,13,6,7,2.18706445936651,10.8129355406335
"1980","courage",6.02272899861782,13,6,7,2.18706445936651,10.8129355406335
"1980","crazy know",6.02272899861782,13,6,7,2.18706445936651,10.8129355406335
"1980","day said",6.02272899861782,13,6,7,2.18706445936651,10.8129355406335
"1980","dontcha",6.02272899861782,13,6,7,2.18706445936651,10.8129355406335
"1980","eager",6.02272899861782,13,6,7,2.18706445936651,10.8129355406335
"1980","far behind",6.02272899861782,13,6,7,2.18706445936651,10.8129355406335
"1980","forest",6.02272899861782,13,6,7,2.18706445936651,10.8129355406335
"1980","hold heart",6.02272899861782,13,6,7,2.18706445936651,10.8129355406335
"1980","im making",6.02272899861782,13,6,7,2.18706445936651,10.8129355406335
"1980","know got right",6.02272899861782,13,6,7,2.18706445936651,10.8129355406335
"1980","let go im",6.02272899861782,13,6,7,2.18706445936651,10.8129355406335
"1980","lets go way",6.02272899861782,13,6,7,2.18706445936651,10.8129355406335
"1980","love oh yeah",6.02272899861782,13,6,7,2.18706445936651,10.8129355406335
"1980","masquerade",6.02272899861782,13,6,7,2.18706445936651,10.8129355406335
"1980","maybe im just",6.02272899861782,13,6,7,2.18706445936651,10.8129355406335
"1980","mewhy",6.02272899861782,13,6,7,2.18706445936651,10.8129355406335
"1980","nothings wrong",6.02272899861782,13,6,7,2.18706445936651,10.8129355406335
"1980","permission",6.02272899861782,13,6,7,2.18706445936651,10.8129355406335
"1980","seven seas",6.02272899861782,13,6,7,2.18706445936651,10.8129355406335
"1980","sights",6.02272899861782,13,6,7,2.18706445936651,10.8129355406335
"1980","since went away",6.02272899861782,13,6,7,2.18706445936651,10.8129355406335
"1980","stars shine",6.02272899861782,13,6,7,2.18706445936651,10.8129355406335
"1980","tight im",6.02272899861782,13,6,7,2.18706445936651,10.8129355406335
"1980","time ever",6.02272899861782,13,6,7,2.18706445936651,10.8129355406335
"1980","travel world",6.02272899861782,13,6,7,2.18706445936651,10.8129355406335
"1980","turn love",6.02272899861782,13,6,7,2.18706445936651,10.8129355406335
"1980","us boy",6.02272899861782,13,6,7,2.18706445936651,10.8129355406335
"1980","wait said",6.02272899861782,13,6,7,2.18706445936651,10.8129355406335
"1980","well love",6.02272899861782,13,6,7,2.18706445936651,10.8129355406335
"1980","wing",6.02272899861782,13,6,7,2.18706445936651,10.8129355406335
"1980","yeah little",6.02272899861782,13,6,7,2.18706445936651,10.8129355406335
"1980","yeah shake",6.02272899861782,13,6,7,2.18706445936651,10.8129355406335
"1980","can take time",6.01870851203951,20,8,12,3.36471455287156,16.6352854471284
"1980","exciting",6.01870851203951,20,8,12,3.36471455287156,16.6352854471284
"1980","know ive got",6.01870851203951,20,8,12,3.36471455287156,16.6352854471284
"1980","life know",6.01870851203951,20,8,12,3.36471455287156,16.6352854471284
"1980","pop pop pop",6.01870851203951,20,8,12,3.36471455287156,16.6352854471284
"1980","put arms",6.01870851203951,20,8,12,3.36471455287156,16.6352854471284
"1980","said oh",6.01870851203951,20,8,12,3.36471455287156,16.6352854471284
"1980","say really",6.01870851203951,20,8,12,3.36471455287156,16.6352854471284
"1980","still remember",6.01870851203951,20,8,12,3.36471455287156,16.6352854471284
"1980","time let",6.01870851203951,20,8,12,3.36471455287156,16.6352854471284
"1980","cover",6.01346928380479,116,30,86,19.515344406655,96.484655593345
"2010","aint hard",6.00617990554276,14,6,8,2.15547813569839,11.8445218643016
"2010","cause well",6.00617990554276,14,6,8,2.15547813569839,11.8445218643016
"2010","close enough",6.00617990554276,14,6,8,2.15547813569839,11.8445218643016
"2010","everything got",6.00617990554276,14,6,8,2.15547813569839,11.8445218643016
"2010","everything will alright",6.00617990554276,14,6,8,2.15547813569839,11.8445218643016
"2010","fire girl",6.00617990554276,14,6,8,2.15547813569839,11.8445218643016
"2010","get past",6.00617990554276,14,6,8,2.15547813569839,11.8445218643016
"2010","gonna push",6.00617990554276,14,6,8,2.15547813569839,11.8445218643016
"2010","gonna tear",6.00617990554276,14,6,8,2.15547813569839,11.8445218643016
"2010","head toes",6.00617990554276,14,6,8,2.15547813569839,11.8445218643016
"2010","im dancing",6.00617990554276,14,6,8,2.15547813569839,11.8445218643016
"2010","just met",6.00617990554276,14,6,8,2.15547813569839,11.8445218643016
"2010","make feel right",6.00617990554276,14,6,8,2.15547813569839,11.8445218643016
"2010","mate",6.00617990554276,14,6,8,2.15547813569839,11.8445218643016
"2010","money just",6.00617990554276,14,6,8,2.15547813569839,11.8445218643016
"2010","never done",6.00617990554276,14,6,8,2.15547813569839,11.8445218643016
"2010","night ooh",6.00617990554276,14,6,8,2.15547813569839,11.8445218643016
"2010","nothin nothin",6.00617990554276,14,6,8,2.15547813569839,11.8445218643016
"2010","oh oh want",6.00617990554276,14,6,8,2.15547813569839,11.8445218643016
"2010","overwhelmed",6.00617990554276,14,6,8,2.15547813569839,11.8445218643016
"2010","want right now",6.00617990554276,14,6,8,2.15547813569839,11.8445218643016
"2010","youd always",6.00617990554276,14,6,8,2.15547813569839,11.8445218643016
"2010","last time",6.00513952420861,71,19,52,10.9313534024704,60.0686465975296
"1970","man",6.00433355393179,2466,380,2086,337.46690128508,2128.53309871492
"1980","say love",6.00018918398102,184,44,140,30.9553738864183,153.044626113582
"2000","drift",5.99920766496106,40,18,22,10.7634274884985,29.2365725115015
"1980","although",5.99772454129102,61,18,43,10.2623793862583,50.7376206137417
"1990","seeing",5.99671596167588,71,24,47,15.0622734109967,55.9377265890033
"2000","get drunk",5.99203596907835,29,14,15,7.80348492916141,21.1965150708386
"2000","partys",5.99203596907835,29,14,15,7.80348492916141,21.1965150708386
"2000","sing sing",5.99203596907835,29,14,15,7.80348492916141,21.1965150708386
"2000","tonight just",5.99203596907835,29,14,15,7.80348492916141,21.1965150708386
"2000","laugh",5.99054125150004,169,60,109,45.4754811389061,123.524518861094
"1990","letters",5.990042618906,39,15,24,8.27364314125173,30.7263568587483
"1990","master",5.990042618906,39,15,24,8.27364314125173,30.7263568587483
"2010","cash",5.98608118537484,116,28,88,17.8596759815009,98.1403240184991
"1990","let music",5.98252440225866,29,12,17,6.15219618195642,22.8478038180436
"1990","live without love",5.98252440225866,29,12,17,6.15219618195642,22.8478038180436
"1990","never fall",5.98252440225866,29,12,17,6.15219618195642,22.8478038180436
"1990","rocket",5.98252440225866,29,12,17,6.15219618195642,22.8478038180436
"1990","shooting",5.98252440225866,29,12,17,6.15219618195642,22.8478038180436
"1990","want love want",5.98252440225866,29,12,17,6.15219618195642,22.8478038180436
"1970","didnt see",5.97874304399278,24,8,16,3.28434940423435,20.7156505957656
"1970","man oh",5.97874304399278,24,8,16,3.28434940423435,20.7156505957656
"1970","rely",5.97874304399278,24,8,16,3.28434940423435,20.7156505957656
"1970","together baby",5.97874304399278,24,8,16,3.28434940423435,20.7156505957656
"1970","twilight",5.97874304399278,24,8,16,3.28434940423435,20.7156505957656
"2010","waking",5.9759914822578,43,13,30,6.62039713107362,36.3796028689264
"1980","gets",5.97513161921221,352,77,275,59.2189761305394,292.781023869461
"1970","fell love",5.97341481013803,74,18,56,10.1267439963892,63.8732560036107
"1970","will will",5.97341481013803,74,18,56,10.1267439963892,63.8732560036107
"1960","searchin",5.97316544895784,72,10,62,4.30007568428692,67.6999243157131
"1960","set free",5.97316544895784,72,10,62,4.30007568428692,67.6999243157131
"1970","got know",5.96807691767953,53,14,39,7.25293826768419,45.7470617323158
"1980","want make",5.96558140064916,79,22,57,13.2906224838427,65.7093775161573
"1960","love just",5.96338684470033,290,28,262,17.3197492839334,272.680250716067
"1990","know right",5.96272545143118,53,19,34,11.2436688842652,41.7563311157348
"2000","wanna get",5.95599332173625,195,68,127,52.4717090064301,142.52829099357
"1990","oh baby baby",5.94351962662165,46,17,29,9.75865601275846,36.2413439872415
"1990","yeah like",5.94351962662165,46,17,29,9.75865601275846,36.2413439872415
"1960","thing",5.94348380869796,1697,126,1571,101.350394947707,1595.64960505229
"2010","know now",5.94121840374592,106,26,80,16.3200487417164,89.6799512582836
"1990","remember",5.94077511588316,894,220,674,189.657358161001,704.342641838999
"1960","mighty",5.93239432457395,94,12,82,5.61398769893015,88.3860123010698
"1960","cat",5.93048535908222,83,11,72,4.95703169160854,78.0429683083915
"1990","dont know",5.92659643263926,1641,389,1252,348.129446020361,1292.87055397964
"1990","else",5.91953048642458,625,158,467,132.590434955957,492.409565044043
"2010","cause make",5.91771941564326,30,10,20,4.61888171935369,25.3811182806463
"2010","drifting",5.91771941564326,30,10,20,4.61888171935369,25.3811182806463
"2010","eye eye",5.91771941564326,30,10,20,4.61888171935369,25.3811182806463
"2010","love night",5.91771941564326,30,10,20,4.61888171935369,25.3811182806463
"2010","need ya",5.91771941564326,30,10,20,4.61888171935369,25.3811182806463
"2010","pretty little",5.91771941564326,30,10,20,4.61888171935369,25.3811182806463
"1980","id love",5.91602861726932,44,14,30,7.40237201631743,36.5976279836826
"1960","got say",5.91600138430502,42,7,35,2.50837748250071,39.4916225174993
"1960","things say",5.91600138430502,42,7,35,2.50837748250071,39.4916225174993
"2010","im falling",5.91550332092624,91,23,68,14.0106078820395,76.9893921179605
"1970","ive seen",5.9106112918574,113,25,88,15.4638117782701,97.5361882217299
"2000","take clothes",5.90165487907584,43,19,24,11.5706845501359,31.4293154498641
"2000","just cant",5.89809401924263,493,157,336,132.659243795744,360.340756204256
"2000","loved",5.894648553256,398,129,269,107.09610351056,290.90389648944
"1990","adore",5.89129323975559,75,25,50,15.9108521947149,59.0891478052851
"2000","aint nothing",5.8903211231477,106,40,66,28.523082844521,77.476917155479
"1960","guide",5.88851644720874,62,9,53,3.70284295035818,58.2971570496418
"1990","hello",5.88737458939871,156,46,110,33.0945725650069,122.905427434993
"1990","verse",5.88203933189357,90,29,61,19.0930226336578,70.9069773663421
"1970","news",5.87909347015323,69,17,52,9.44250453717376,59.5574954628262
"1990","happen",5.8735689333542,172,50,122,36.4888876998794,135.511112300121
"1980","didnt mean",5.86949271696255,57,17,40,9.58943647568394,47.4105635243161
"1980","know shes",5.86949271696255,57,17,40,9.58943647568394,47.4105635243161
"1960","sky",5.86927685182303,562,48,514,33.5644796467952,528.435520353205
"1990","know",5.86653453006247,11166,2474,8692,2368.80767474915,8797.19232525085
"2010","story",5.86440997139292,185,41,144,28.4831039360144,156.516896063986
"1980","baby love way",5.85415527427829,24,9,15,4.03765746344587,19.9623425365541
"1980","can look",5.85415527427829,24,9,15,4.03765746344587,19.9623425365541
"1980","life live",5.85415527427829,24,9,15,4.03765746344587,19.9623425365541
"1980","oo oo",5.85415527427829,24,9,15,4.03765746344587,19.9623425365541
"1980","screams",5.85415527427829,24,9,15,4.03765746344587,19.9623425365541
"1980","ships",5.85415527427829,24,9,15,4.03765746344587,19.9623425365541
"1980","thats want",5.85415527427829,24,9,15,4.03765746344587,19.9623425365541
"1980","wop",5.85415527427829,24,9,15,4.03765746344587,19.9623425365541
"1970","seems like",5.85172917804178,102,23,79,13.958484967996,88.041515032004
"1960","im beggin",5.84858436375252,33,6,27,1.97086802196484,31.0291319780352
"1960","theyve got",5.84858436375252,33,6,27,1.97086802196484,31.0291319780352
"1960","wipe",5.84858436375252,33,6,27,1.97086802196484,31.0291319780352
"1980","youre gonna",5.84581239476593,421,90,331,70.8272413379463,350.172758662054
"1980","ityou",5.8427704887869,40,13,27,6.72942910574312,33.2705708942569
"1980","oh little",5.8427704887869,40,13,27,6.72942910574312,33.2705708942569
"1990","bye bye bye",5.83811456680508,26,11,15,5.51576209416782,20.4842379058322
"1990","falling apart",5.83811456680508,26,11,15,5.51576209416782,20.4842379058322
"1990","im knees",5.83811456680508,26,11,15,5.51576209416782,20.4842379058322
"1990","mark",5.83811456680508,26,11,15,5.51576209416782,20.4842379058322
"1990","must confess",5.83811456680508,26,11,15,5.51576209416782,20.4842379058322
"1990","never forget",5.83811456680508,26,11,15,5.51576209416782,20.4842379058322
"1990","satisfaction",5.83811456680508,26,11,15,5.51576209416782,20.4842379058322
"1990","tell friends",5.83811456680508,26,11,15,5.51576209416782,20.4842379058322
"1990","true oh",5.83811456680508,26,11,15,5.51576209416782,20.4842379058322
"1990","wrong just",5.83811456680508,26,11,15,5.51576209416782,20.4842379058322
"1990","yall dont",5.83811456680508,26,11,15,5.51576209416782,20.4842379058322
"1990","feels",5.83343557559993,446,116,330,94.6165343845711,351.383465615429
"1990","aloud",5.83204556600971,11,6,5,2.33359165522485,8.66640834477515
"1990","autumn",5.83204556600971,11,6,5,2.33359165522485,8.66640834477515
"1990","baby hear",5.83204556600971,11,6,5,2.33359165522485,8.66640834477515
"1990","baby sometimes",5.83204556600971,11,6,5,2.33359165522485,8.66640834477515
"1990","back little",5.83204556600971,11,6,5,2.33359165522485,8.66640834477515
"1990","believe know",5.83204556600971,11,6,5,2.33359165522485,8.66640834477515
"1990","big bad",5.83204556600971,11,6,5,2.33359165522485,8.66640834477515
"1990","cant nobody",5.83204556600971,11,6,5,2.33359165522485,8.66640834477515
"1990","change never",5.83204556600971,11,6,5,2.33359165522485,8.66640834477515
"1990","conversations",5.83204556600971,11,6,5,2.33359165522485,8.66640834477515
"1990","crazy crazy crazy",5.83204556600971,11,6,5,2.33359165522485,8.66640834477515
"1990","doim",5.83204556600971,11,6,5,2.33359165522485,8.66640834477515
"1990","dont need dont",5.83204556600971,11,6,5,2.33359165522485,8.66640834477515
"1990","dont speak",5.83204556600971,11,6,5,2.33359165522485,8.66640834477515
"1990","girl around",5.83204556600971,11,6,5,2.33359165522485,8.66640834477515
"1990","girl quit",5.83204556600971,11,6,5,2.33359165522485,8.66640834477515
"1990","hardly wait",5.83204556600971,11,6,5,2.33359165522485,8.66640834477515
"1990","homeless",5.83204556600971,11,6,5,2.33359165522485,8.66640834477515
"1990","hurt ill",5.83204556600971,11,6,5,2.33359165522485,8.66640834477515
"1990","id id",5.83204556600971,11,6,5,2.33359165522485,8.66640834477515
"1990","ill never see",5.83204556600971,11,6,5,2.33359165522485,8.66640834477515
"1990","know love say",5.83204556600971,11,6,5,2.33359165522485,8.66640834477515
"1990","kool",5.83204556600971,11,6,5,2.33359165522485,8.66640834477515
"1990","let clear",5.83204556600971,11,6,5,2.33359165522485,8.66640834477515
"1990","lived life",5.83204556600971,11,6,5,2.33359165522485,8.66640834477515
"1990","love somebody love",5.83204556600971,11,6,5,2.33359165522485,8.66640834477515
"1990","love tried",5.83204556600971,11,6,5,2.33359165522485,8.66640834477515
"1990","man play",5.83204556600971,11,6,5,2.33359165522485,8.66640834477515
"1990","nickel",5.83204556600971,11,6,5,2.33359165522485,8.66640834477515
"1990","night think",5.83204556600971,11,6,5,2.33359165522485,8.66640834477515
"1990","oh im just",5.83204556600971,11,6,5,2.33359165522485,8.66640834477515
"1990","one time dont",5.83204556600971,11,6,5,2.33359165522485,8.66640834477515
"1990","outside door",5.83204556600971,11,6,5,2.33359165522485,8.66640834477515
"1990","pain feel",5.83204556600971,11,6,5,2.33359165522485,8.66640834477515
"1990","pretend dont",5.83204556600971,11,6,5,2.33359165522485,8.66640834477515
"1990","rollin stone",5.83204556600971,11,6,5,2.33359165522485,8.66640834477515
"1990","rumble",5.83204556600971,11,6,5,2.33359165522485,8.66640834477515
"1990","silver spoon",5.83204556600971,11,6,5,2.33359165522485,8.66640834477515
"1990","soul yeah",5.83204556600971,11,6,5,2.33359165522485,8.66640834477515
"1990","steer",5.83204556600971,11,6,5,2.33359165522485,8.66640834477515
"1990","talk way",5.83204556600971,11,6,5,2.33359165522485,8.66640834477515
"1990","turn can",5.83204556600971,11,6,5,2.33359165522485,8.66640834477515
"1990","woo woo woo",5.83204556600971,11,6,5,2.33359165522485,8.66640834477515
"1990","yeah hold",5.83204556600971,11,6,5,2.33359165522485,8.66640834477515
"1990","youre ever wanted",5.83204556600971,11,6,5,2.33359165522485,8.66640834477515
"1990","youre moving",5.83204556600971,11,6,5,2.33359165522485,8.66640834477515
"1970","learned",5.82841730044883,148,31,117,20.2534879927785,127.746512007221
"1970","queen",5.82841730044883,148,31,117,20.2534879927785,127.746512007221
"2000","need life",5.824189207624,46,20,26,12.3779416117733,33.6220583882267
"2000","way way",5.824189207624,46,20,26,12.3779416117733,33.6220583882267
"1980","lives",5.82371587074607,185,44,141,31.1236096140619,153.876390385938
"1970","dance night",5.82272102761207,80,19,61,10.9478313474478,69.0521686525522
"2010","gonna need",5.82160495713423,26,9,17,4.00303082343986,21.9969691765601
"2010","keep eyes",5.82160495713423,26,9,17,4.00303082343986,21.9969691765601
"2010","now now now",5.82160495713423,26,9,17,4.00303082343986,21.9969691765601
"1970","im falling",5.81903528696094,91,21,70,12.4531581577219,78.5468418422781
"1970","see light",5.81903528696094,91,21,70,12.4531581577219,78.5468418422781
"2010","another life",5.81590231027659,18,7,11,2.77132903161221,15.2286709683878
"2010","eating",5.81590231027659,18,7,11,2.77132903161221,15.2286709683878
"2010","good god",5.81590231027659,18,7,11,2.77132903161221,15.2286709683878
"2010","know exactly",5.81590231027659,18,7,11,2.77132903161221,15.2286709683878
"2010","like old",5.81590231027659,18,7,11,2.77132903161221,15.2286709683878
"2010","money mind",5.81590231027659,18,7,11,2.77132903161221,15.2286709683878
"2010","planes",5.81590231027659,18,7,11,2.77132903161221,15.2286709683878
"2010","smoke weed",5.81590231027659,18,7,11,2.77132903161221,15.2286709683878
"2010","still hear",5.81590231027659,18,7,11,2.77132903161221,15.2286709683878
"2010","wanna wake",5.81590231027659,18,7,11,2.77132903161221,15.2286709683878
"1980","fresh",5.81442993326205,195,46,149,32.8059668904977,162.194033109502
"1980","oh girl",5.81430048116072,66,19,47,11.1035580244761,54.8964419755239
"1980","baby just",5.81249445026259,205,48,157,34.4883241669335,170.511675833067
"1980","take look",5.81161647896111,75,21,54,12.6176795732683,62.3823204267317
"1980","youand",5.81161647896111,75,21,54,12.6176795732683,62.3823204267317
"2000","can bring",5.80303179944339,32,15,17,8.61074199079879,23.3892580092012
"2000","choke",5.80303179944339,32,15,17,8.61074199079879,23.3892580092012
"2000","energy",5.80303179944339,32,15,17,8.61074199079879,23.3892580092012
"2000","ive just",5.80303179944339,32,15,17,8.61074199079879,23.3892580092012
"2000","last one",5.80303179944339,32,15,17,8.61074199079879,23.3892580092012
"2000","remix",5.80303179944339,32,15,17,8.61074199079879,23.3892580092012
"2000","showin",5.80303179944339,32,15,17,8.61074199079879,23.3892580092012
"1960","now go",5.79948207341595,73,10,63,4.3597989576798,68.6402010423202
"1990","laid",5.79923900771182,79,26,53,16.759430978433,62.240569021567
"1990","go go",5.79467507086491,266,73,193,56.4304891172554,209.569510882745
"1990","didnt mean",5.79346175030764,57,20,37,12.0922476679833,44.9077523320167
"1990","know shes",5.79346175030764,57,20,37,12.0922476679833,44.9077523320167
"1990","roll",5.79324447853357,804,199,605,170.564335527343,633.435664472657
"1970","get ya",5.7932068794265,64,16,48,8.75826507795827,55.2417349220417
"1970","wont tell",5.7932068794265,64,16,48,8.75826507795827,55.2417349220417
"1960","name",5.79275182323427,977,77,900,58.3496381048378,918.650361895162
"1980","know know",5.79242133240955,390,84,306,65.6119337809954,324.388066219005
"1990","wait till",5.79113399604484,36,14,22,7.63720905346314,28.3627909465369
"1980","battle",5.79021712898989,36,12,24,6.05648619516881,29.9435138048312
"1980","gonna keep",5.79021712898989,36,12,24,6.05648619516881,29.9435138048312
"1980","home take",5.79021712898989,36,12,24,6.05648619516881,29.9435138048312
"1980","ill hold",5.79021712898989,36,12,24,6.05648619516881,29.9435138048312
"1980","just one night",5.79021712898989,36,12,24,6.05648619516881,29.9435138048312
"1980","one us",5.79021712898989,36,12,24,6.05648619516881,29.9435138048312
"1980","yeah want",5.79021712898989,36,12,24,6.05648619516881,29.9435138048312
"2010","messed",5.78857653016424,39,12,27,6.0045462351598,32.9954537648402
"2010","please dont go",5.78857653016424,39,12,27,6.0045462351598,32.9954537648402
"1980","deep inside",5.78638297770099,117,30,87,19.6835801342986,97.3164198657014
"1980","will turn",5.78083879364451,28,10,18,4.71060037402018,23.2893996259798
"2010","alone cause",5.77689012358271,22,8,14,3.38717992752604,18.612820072474
"2010","alone just",5.77689012358271,22,8,14,3.38717992752604,18.612820072474
"2010","anything dont",5.77689012358271,22,8,14,3.38717992752604,18.612820072474
"2010","can mean",5.77689012358271,22,8,14,3.38717992752604,18.612820072474
"2010","cigarette",5.77689012358271,22,8,14,3.38717992752604,18.612820072474
"2010","every second",5.77689012358271,22,8,14,3.38717992752604,18.612820072474
"2010","just wanted",5.77689012358271,22,8,14,3.38717992752604,18.612820072474
"2010","till morning",5.77689012358271,22,8,14,3.38717992752604,18.612820072474
"2010","want time",5.77689012358271,22,8,14,3.38717992752604,18.612820072474
"2010","yeah oh oh",5.77689012358271,22,8,14,3.38717992752604,18.612820072474
"1970","boy oh",5.77280097384387,20,7,13,2.73695783686196,17.263042163138
"1970","felt good",5.77280097384387,20,7,13,2.73695783686196,17.263042163138
"1970","home youre",5.77280097384387,20,7,13,2.73695783686196,17.263042163138
"1970","youre near",5.77280097384387,20,7,13,2.73695783686196,17.263042163138
"1960","cherish",5.77112343106339,84,11,73,5.01675496500141,78.9832450349986
"2010","luck",5.7706829612439,117,28,89,18.0136387054794,98.9863612945206
"1980","door baby",5.76576233953018,32,11,21,5.38354328459449,26.6164567154055
"1980","love inside",5.76576233953018,32,11,21,5.38354328459449,26.6164567154055
"1980","maker",5.76576233953018,32,11,21,5.38354328459449,26.6164567154055
"1980","watch watch",5.76576233953018,32,11,21,5.38354328459449,26.6164567154055
"1980","worked",5.76576233953018,32,11,21,5.38354328459449,26.6164567154055
"1970","day can",5.76268360070117,29,9,20,3.96858886344984,25.0314111365502
"1970","everlasting",5.76268360070117,29,9,20,3.96858886344984,25.0314111365502
"1970","gave love",5.76268360070117,29,9,20,3.96858886344984,25.0314111365502
"1970","little piece",5.76268360070117,29,9,20,3.96858886344984,25.0314111365502
"1970","never fall",5.76268360070117,29,9,20,3.96858886344984,25.0314111365502
"1970","people world",5.76268360070117,29,9,20,3.96858886344984,25.0314111365502
"1970","surprised",5.76268360070117,29,9,20,3.96858886344984,25.0314111365502
"1970","teardrops",5.76268360070117,29,9,20,3.96858886344984,25.0314111365502
"1970","tell truth",5.76268360070117,29,9,20,3.96858886344984,25.0314111365502
"1970","theres love",5.76268360070117,29,9,20,3.96858886344984,25.0314111365502
"1970","time feel",5.76268360070117,29,9,20,3.96858886344984,25.0314111365502
"1990","feel love",5.76137345285582,68,23,45,14.4258393232082,53.5741606767919
"1960","sing",5.75868995197906,620,52,568,37.0284295035818,582.971570496418
"2000","can stay",5.75736226637095,24,12,12,6.45805649309909,17.5419435069009
"2000","drip",5.75736226637095,24,12,12,6.45805649309909,17.5419435069009
"2000","know truth",5.75736226637095,24,12,12,6.45805649309909,17.5419435069009
"2000","little late",5.75736226637095,24,12,12,6.45805649309909,17.5419435069009
"2000","lonely im",5.75736226637095,24,12,12,6.45805649309909,17.5419435069009
"2000","plate",5.75736226637095,24,12,12,6.45805649309909,17.5419435069009
"1970","kid",5.74771683852815,178,36,142,24.3589247480714,153.641075251929
"1980","believed",5.74753352044406,53,16,37,8.91649356510963,44.0835064348904
"1980","tell feel",5.74753352044406,53,16,37,8.91649356510963,44.0835064348904
"1960","runnin",5.7416998866181,241,24,217,14.3933088876826,226.606691112317
"1970","looks",5.74069961465462,196,39,157,26.8221868012472,169.177813198753
"1990","ive tried",5.73591518700311,50,18,32,10.6072347964766,39.3927652035234
"1990","matters",5.73591518700311,50,18,32,10.6072347964766,39.3927652035234
"1990","whats going",5.73591518700311,50,18,32,10.6072347964766,39.3927652035234
"2000","rollin",5.72859938119494,183,64,119,49.2426807598806,133.757319240119
"1980","tight",5.72768427193218,354,77,277,59.5554475858266,294.444552414173
"2010","asleep",5.72174074753071,72,19,53,11.0853161264489,60.9146838735512
"1970","innocent",5.71779554407109,59,15,44,8.07402561874278,50.9259743812572
"1990","im taking",5.71684699107257,23,10,13,4.87932800637923,18.1206719936208
"1990","ive cried",5.71684699107257,23,10,13,4.87932800637923,18.1206719936208
"1990","like river",5.71684699107257,23,10,13,4.87932800637923,18.1206719936208
"1990","sends",5.71684699107257,23,10,13,4.87932800637923,18.1206719936208
"1990","whispers",5.71684699107257,23,10,13,4.87932800637923,18.1206719936208
"1990","tight",5.71238575350767,354,94,260,75.0992223590542,278.900777640946
"1990","nobody",5.70065967751412,718,179,539,152.319891677404,565.680108322596
"1970","la la la",5.70024344559019,1245,200,1045,170.375625344657,1074.62437465534
"2000","whoa",5.68788574275934,687,213,474,184.861867114962,502.138132885038
"1980","know love",5.6860700429766,318,70,248,53.4989613906578,264.501038609342
"2010","dont call",5.68503534743125,53,15,38,8.16002437085818,44.8399756291418
"2010","limit",5.68503534743125,53,15,38,8.16002437085818,44.8399756291418
"2010","wave",5.67989220947742,97,24,73,14.9343842259103,82.0656157740897
"1960","now youve",5.67920074911204,43,7,36,2.56810075589358,40.4318992441064
"1980","lots",5.67356246960454,62,18,44,10.4306151139018,51.5693848860982
"1990","ocean",5.67197353520327,106,33,73,22.4873377685304,83.5126622314696
"2010","bop bop bop",5.66911138955869,87,22,65,13.3947569861257,73.6052430138743
"2010","like never",5.66911138955869,87,22,65,13.3947569861257,73.6052430138743
"1970","loving",5.66907920837323,504,88,416,68.9713374889213,435.028662511079
"1970","learn",5.66672488465877,239,46,193,32.7066461505004,206.2933538495
"1980","anytime",5.65956152280467,71,20,51,11.944736662694,59.055263337306
"1980","ba ba",5.65956152280467,71,20,51,11.944736662694,59.055263337306
"1980","love someone",5.65956152280467,71,20,51,11.944736662694,59.055263337306
"2000","change life",5.65581286503496,35,16,19,9.41799905243618,25.5820009475638
"2000","crawl",5.65581286503496,35,16,19,9.41799905243618,25.5820009475638
"2000","know need know",5.65581286503496,35,16,19,9.41799905243618,25.5820009475638
"2000","daughter",5.65374507915153,58,24,34,15.6069698583228,42.3930301416772
"2000","gonna good",5.65374507915153,58,24,34,15.6069698583228,42.3930301416772
"2000","hotter",5.65374507915153,58,24,34,15.6069698583228,42.3930301416772
"1980","known",5.65241580636976,211,49,162,35.4977385327949,175.502261467205
"1960","beggin",5.65057697039964,53,8,45,3.16533348982232,49.8346665101777
"1960","yeah come",5.65057697039964,53,8,45,3.16533348982232,49.8346665101777
"1970","cause really",5.64736373194967,34,10,24,4.65282832266533,29.3471716773347
"1970","teacher",5.64736373194967,34,10,24,4.65282832266533,29.3471716773347
"1970","arms",5.64604804669369,556,96,460,76.0874278647624,479.912572135238
"2000","away never",5.64368817613118,14,8,6,3.76719962097447,10.2328003790255
"2000","baby im beggin",5.64368817613118,14,8,6,3.76719962097447,10.2328003790255
"2000","boyi",5.64368817613118,14,8,6,3.76719962097447,10.2328003790255
"2000","cause every time",5.64368817613118,14,8,6,3.76719962097447,10.2328003790255
"2000","dont know heard",5.64368817613118,14,8,6,3.76719962097447,10.2328003790255
"2000","ese",5.64368817613118,14,8,6,3.76719962097447,10.2328003790255
"2000","find way back home",5.64368817613118,14,8,6,3.76719962097447,10.2328003790255
"2000","gets hard",5.64368817613118,14,8,6,3.76719962097447,10.2328003790255
"2000","girl life",5.64368817613118,14,8,6,3.76719962097447,10.2328003790255
"2000","got end",5.64368817613118,14,8,6,3.76719962097447,10.2328003790255
"2000","got need got need",5.64368817613118,14,8,6,3.76719962097447,10.2328003790255
"2000","houston",5.64368817613118,14,8,6,3.76719962097447,10.2328003790255
"2000","im home",5.64368817613118,14,8,6,3.76719962097447,10.2328003790255
"2000","keep eye",5.64368817613118,14,8,6,3.76719962097447,10.2328003790255
"2000","long want",5.64368817613118,14,8,6,3.76719962097447,10.2328003790255
"2000","magazines",5.64368817613118,14,8,6,3.76719962097447,10.2328003790255
"2000","need come",5.64368817613118,14,8,6,3.76719962097447,10.2328003790255
"2000","need got need",5.64368817613118,14,8,6,3.76719962097447,10.2328003790255
"2000","never seems",5.64368817613118,14,8,6,3.76719962097447,10.2328003790255
"2000","nitty",5.64368817613118,14,8,6,3.76719962097447,10.2328003790255
"2000","now boom",5.64368817613118,14,8,6,3.76719962097447,10.2328003790255
"2000","now hear",5.64368817613118,14,8,6,3.76719962097447,10.2328003790255
"2000","overtime",5.64368817613118,14,8,6,3.76719962097447,10.2328003790255
"2000","put back",5.64368817613118,14,8,6,3.76719962097447,10.2328003790255
"2000","see em",5.64368817613118,14,8,6,3.76719962097447,10.2328003790255
"2000","seem get",5.64368817613118,14,8,6,3.76719962097447,10.2328003790255
"2000","us get",5.64368817613118,14,8,6,3.76719962097447,10.2328003790255
"2000","wanna keep",5.64368817613118,14,8,6,3.76719962097447,10.2328003790255
"1970","ahh ahh",5.63988632725913,16,6,10,2.18956626948957,13.8104337305104
"1970","always seems",5.63988632725913,16,6,10,2.18956626948957,13.8104337305104
"1970","backwards",5.63988632725913,16,6,10,2.18956626948957,13.8104337305104
"1970","cant cant cant cant",5.63988632725913,16,6,10,2.18956626948957,13.8104337305104
"1970","concerned",5.63988632725913,16,6,10,2.18956626948957,13.8104337305104
"1970","everlasting love",5.63988632725913,16,6,10,2.18956626948957,13.8104337305104
"1970","gets high",5.63988632725913,16,6,10,2.18956626948957,13.8104337305104
"1970","give life",5.63988632725913,16,6,10,2.18956626948957,13.8104337305104
"1970","im gonna need",5.63988632725913,16,6,10,2.18956626948957,13.8104337305104
"1970","lonely night",5.63988632725913,16,6,10,2.18956626948957,13.8104337305104
"1970","man said",5.63988632725913,16,6,10,2.18956626948957,13.8104337305104
"1970","need em",5.63988632725913,16,6,10,2.18956626948957,13.8104337305104
"1970","people will",5.63988632725913,16,6,10,2.18956626948957,13.8104337305104
"1970","someday youll",5.63988632725913,16,6,10,2.18956626948957,13.8104337305104
"1970","springtime",5.63988632725913,16,6,10,2.18956626948957,13.8104337305104
"1970","want around",5.63988632725913,16,6,10,2.18956626948957,13.8104337305104
"2000","case",5.63714043502719,76,30,46,20.4505122281471,55.5494877718529
"2000","im trying",5.63714043502719,76,30,46,20.4505122281471,55.5494877718529
"1990","always keep",5.63686449617683,14,7,7,2.97002574301344,11.0299742569866
"1990","base",5.63686449617683,14,7,7,2.97002574301344,11.0299742569866
"1990","bit just",5.63686449617683,14,7,7,2.97002574301344,11.0299742569866
"1990","continue",5.63686449617683,14,7,7,2.97002574301344,11.0299742569866
"1990","fuck bitches",5.63686449617683,14,7,7,2.97002574301344,11.0299742569866
"1990","good cause",5.63686449617683,14,7,7,2.97002574301344,11.0299742569866
"1990","id ever",5.63686449617683,14,7,7,2.97002574301344,11.0299742569866
"1990","keep away",5.63686449617683,14,7,7,2.97002574301344,11.0299742569866
"1990","laws",5.63686449617683,14,7,7,2.97002574301344,11.0299742569866
"1990","lay head",5.63686449617683,14,7,7,2.97002574301344,11.0299742569866
"1990","make love cant",5.63686449617683,14,7,7,2.97002574301344,11.0299742569866
"1990","man whos",5.63686449617683,14,7,7,2.97002574301344,11.0299742569866
"1990","oh oh want",5.63686449617683,14,7,7,2.97002574301344,11.0299742569866
"1990","put blame",5.63686449617683,14,7,7,2.97002574301344,11.0299742569866
"1990","que te",5.63686449617683,14,7,7,2.97002574301344,11.0299742569866
"1990","said wouldnt",5.63686449617683,14,7,7,2.97002574301344,11.0299742569866
"1990","someone love",5.63686449617683,14,7,7,2.97002574301344,11.0299742569866
"1990","tear us apart",5.63686449617683,14,7,7,2.97002574301344,11.0299742569866
"1990","think just",5.63686449617683,14,7,7,2.97002574301344,11.0299742569866
"1990","true youre",5.63686449617683,14,7,7,2.97002574301344,11.0299742569866
"1990","wanna think",5.63686449617683,14,7,7,2.97002574301344,11.0299742569866
"1990","will hear",5.63686449617683,14,7,7,2.97002574301344,11.0299742569866
"1990","wrong baby",5.63686449617683,14,7,7,2.97002574301344,11.0299742569866
"1990","youre world",5.63686449617683,14,7,7,2.97002574301344,11.0299742569866
"2010","hanging",5.63607710343675,149,34,115,22.94044587279,126.05955412721
"2000","time life",5.63586515668973,61,25,36,16.4142269199602,44.5857730800398
"1980","oh sweet",5.63332868829557,49,15,34,8.24355065453532,40.7564493454647
"1980","regret",5.63332868829557,49,15,34,8.24355065453532,40.7564493454647
"1980","well know",5.63332868829557,49,15,34,8.24355065453532,40.7564493454647
"1990","darling dont",5.62890648202996,20,9,11,4.24289391859063,15.7571060814094
"1990","echo",5.62890648202996,20,9,11,4.24289391859063,15.7571060814094
"1990","let go cause",5.62890648202996,20,9,11,4.24289391859063,15.7571060814094
"1990","love blind",5.62890648202996,20,9,11,4.24289391859063,15.7571060814094
"1990","mean much",5.62890648202996,20,9,11,4.24289391859063,15.7571060814094
"1990","say really",5.62890648202996,20,9,11,4.24289391859063,15.7571060814094
"1990","spread wings",5.62890648202996,20,9,11,4.24289391859063,15.7571060814094
"1990","suicide",5.62890648202996,20,9,11,4.24289391859063,15.7571060814094
"1990","till cant",5.62890648202996,20,9,11,4.24289391859063,15.7571060814094
"1990","uh yeah",5.62890648202996,20,9,11,4.24289391859063,15.7571060814094
"1990","youre near",5.62890648202996,20,9,11,4.24289391859063,15.7571060814094
"2000","moved",5.6272372965329,73,29,44,19.6432551665097,53.3567448334902
"1980","fun",5.62315352874044,423,90,333,71.1637127932335,351.836287206767
"1960","ease",5.61534953400779,85,11,74,5.07647823839428,79.9235217616057
"2010","come oh",5.61410945409344,35,11,24,5.38869533924597,29.611304660754
"2010","everybody say",5.61410945409344,35,11,24,5.38869533924597,29.611304660754
"2010","hold us",5.61410945409344,35,11,24,5.38869533924597,29.611304660754
"1970","get high",5.61050718794862,49,13,36,6.7055467003118,42.2944532996882
"1970","im living",5.61050718794862,49,13,36,6.7055467003118,42.2944532996882
"2000","care know",5.60983406410448,19,10,9,5.11262805703678,13.8873719429632
"2000","̢cause",5.60983406410448,19,10,9,5.11262805703678,13.8873719429632
"2000","cause body",5.60983406410448,19,10,9,5.11262805703678,13.8873719429632
"2000","dont want know",5.60983406410448,19,10,9,5.11262805703678,13.8873719429632
"2000","get ass",5.60983406410448,19,10,9,5.11262805703678,13.8873719429632
"2000","girl always",5.60983406410448,19,10,9,5.11262805703678,13.8873719429632
"2000","girl lets",5.60983406410448,19,10,9,5.11262805703678,13.8873719429632
"2000","give just one night",5.60983406410448,19,10,9,5.11262805703678,13.8873719429632
"2000","got thinking",5.60983406410448,19,10,9,5.11262805703678,13.8873719429632
"2000","heart theres",5.60983406410448,19,10,9,5.11262805703678,13.8873719429632
"2000","ill waiting",5.60983406410448,19,10,9,5.11262805703678,13.8873719429632
"2000","live live",5.60983406410448,19,10,9,5.11262805703678,13.8873719429632
"2000","loveoh",5.60983406410448,19,10,9,5.11262805703678,13.8873719429632
"2000","much say",5.60983406410448,19,10,9,5.11262805703678,13.8873719429632
"2000","need cause",5.60983406410448,19,10,9,5.11262805703678,13.8873719429632
"2000","oh oh ohi",5.60983406410448,19,10,9,5.11262805703678,13.8873719429632
"2000","one dont",5.60983406410448,19,10,9,5.11262805703678,13.8873719429632
"2000","powers",5.60983406410448,19,10,9,5.11262805703678,13.8873719429632
"2000","real fine",5.60983406410448,19,10,9,5.11262805703678,13.8873719429632
"2000","run girl",5.60983406410448,19,10,9,5.11262805703678,13.8873719429632
"2000","song now",5.60983406410448,19,10,9,5.11262805703678,13.8873719429632
"2000","ups downs",5.60983406410448,19,10,9,5.11262805703678,13.8873719429632
"2000","will survive",5.60983406410448,19,10,9,5.11262805703678,13.8873719429632
"2000","wondering youre",5.60983406410448,19,10,9,5.11262805703678,13.8873719429632
"2000","ya get",5.60983406410448,19,10,9,5.11262805703678,13.8873719429632
"1980","baby made",5.60276233730235,17,7,10,2.86000736994083,14.1399926300592
"1980","can build",5.60276233730235,17,7,10,2.86000736994083,14.1399926300592
"1980","dont mean thing",5.60276233730235,17,7,10,2.86000736994083,14.1399926300592
"1980","dont mess around",5.60276233730235,17,7,10,2.86000736994083,14.1399926300592
"1980","doyou",5.60276233730235,17,7,10,2.86000736994083,14.1399926300592
"1980","girl makes",5.60276233730235,17,7,10,2.86000736994083,14.1399926300592
"1980","got oh",5.60276233730235,17,7,10,2.86000736994083,14.1399926300592
"1980","high im",5.60276233730235,17,7,10,2.86000736994083,14.1399926300592
"1980","hold got",5.60276233730235,17,7,10,2.86000736994083,14.1399926300592
"1980","learn fly",5.60276233730235,17,7,10,2.86000736994083,14.1399926300592
"1980","learned lesson",5.60276233730235,17,7,10,2.86000736994083,14.1399926300592
"1980","leave leave",5.60276233730235,17,7,10,2.86000736994083,14.1399926300592
"1980","lose love",5.60276233730235,17,7,10,2.86000736994083,14.1399926300592
"1980","love hurt",5.60276233730235,17,7,10,2.86000736994083,14.1399926300592
"1980","notion",5.60276233730235,17,7,10,2.86000736994083,14.1399926300592
"1980","run baby",5.60276233730235,17,7,10,2.86000736994083,14.1399926300592
"1980","thee",5.60276233730235,17,7,10,2.86000736994083,14.1399926300592
"1980","together together",5.60276233730235,17,7,10,2.86000736994083,14.1399926300592
"1980","wait forever",5.60276233730235,17,7,10,2.86000736994083,14.1399926300592
"1980","waits",5.60276233730235,17,7,10,2.86000736994083,14.1399926300592
"1980","wanna tell love",5.60276233730235,17,7,10,2.86000736994083,14.1399926300592
"1990","everybody needs",5.59876282790442,33,13,20,7.00077496567454,25.9992250343255
"1990","man man",5.59876282790442,33,13,20,7.00077496567454,25.9992250343255
"1990","melt",5.59876282790442,33,13,20,7.00077496567454,25.9992250343255
"1990","punk",5.59876282790442,33,13,20,7.00077496567454,25.9992250343255
"1990","wholl",5.59876282790442,33,13,20,7.00077496567454,25.9992250343255
"1960","took",5.59821248971818,553,47,506,33.0269701862593,519.973029813741
"1990","need",5.597381165439,3735,852,2883,792.360439296801,2942.6395607032
"1970","never come",5.59601914609076,39,11,28,5.33706778188082,33.6629322181192
"1990","always stay",5.59157565223237,17,8,9,3.60645983080204,13.393540169198
"1990","asleep cause",5.59157565223237,17,8,9,3.60645983080204,13.393540169198
"1990","bronx",5.59157565223237,17,8,9,3.60645983080204,13.393540169198
"1990","face just",5.59157565223237,17,8,9,3.60645983080204,13.393540169198
"1990","give sign",5.59157565223237,17,8,9,3.60645983080204,13.393540169198
"1990","id still",5.59157565223237,17,8,9,3.60645983080204,13.393540169198
"1990","looks good",5.59157565223237,17,8,9,3.60645983080204,13.393540169198
"1990","man see",5.59157565223237,17,8,9,3.60645983080204,13.393540169198
"1990","needed someone",5.59157565223237,17,8,9,3.60645983080204,13.393540169198
"1990","pack bags",5.59157565223237,17,8,9,3.60645983080204,13.393540169198
"1990","reckless",5.59157565223237,17,8,9,3.60645983080204,13.393540169198
"1990","religion",5.59157565223237,17,8,9,3.60645983080204,13.393540169198
"1990","telling lies",5.59157565223237,17,8,9,3.60645983080204,13.393540169198
"1990","without live without",5.59157565223237,17,8,9,3.60645983080204,13.393540169198
"1970","kind love",5.58793384567639,44,12,32,6.02130724109631,37.9786927589037
"1970","whole lot",5.58793384567639,44,12,32,6.02130724109631,37.9786927589037
"1990","every little",5.58628378224456,91,29,62,19.3051673295874,71.6948326704126
"1990","something",5.58057295651166,1202,289,913,254.997924507297,947.002075492703
"1970","teach",5.57860053159208,81,19,62,11.0846792392909,69.9153207607091
"1960","come dont",5.57699166628837,34,6,28,2.03059129535771,31.9694087046423
"1960","ever see",5.57699166628837,34,6,28,2.03059129535771,31.9694087046423
"1960","home baby",5.57699166628837,34,6,28,2.03059129535771,31.9694087046423
"1960","think twice",5.57699166628837,34,6,28,2.03059129535771,31.9694087046423
"2000","figure",5.57534164150323,107,40,67,28.7921685317335,78.2078314682665
"1990","go dont",5.57308796843443,118,36,82,25.0330741196847,92.9669258803153
"2000","track",5.56689224671743,145,52,93,39.017424645807,105.982575354193
"1990","dont think",5.56370504011518,284,77,207,60.249093643987,223.750906356013
"1990","food",5.56212154989707,54,19,35,11.4558135801947,42.5441864198053
"2000","leave",5.560442050877,1265,378,887,340.393394323765,924.606605676235
"1960","mercy",5.55421935820864,108,13,95,6.45011352643039,101.54988647357
"1970","feelings",5.55270311286387,246,47,199,33.6645813934021,212.335418606598
"1960","baby just",5.55144553645623,205,21,184,12.2432710455392,192.756728954461
"1970","came",5.54232182408354,701,118,583,95.9303721820117,605.069627817988
"2000","screen",5.54059179403392,38,17,21,10.2252561140736,27.7747438859264
"2000","think need",5.54059179403392,38,17,21,10.2252561140736,27.7747438859264
"2000","twisted",5.54059179403392,38,17,21,10.2252561140736,27.7747438859264
"1980","warm",5.53920039884553,237,54,183,39.871867451528,197.128132548472
"1980","bringing",5.53691357695528,58,17,41,9.75767220332752,48.2423277966725
"1980","girls girls",5.53691357695528,58,17,41,9.75767220332752,48.2423277966725
"1970","end",5.53423422100945,629,107,522,86.0773239693086,542.922676030691
"1980","bad im",5.52886851069757,45,14,31,7.57060774396101,37.429392256039
"1980","gonna rock",5.52886851069757,45,14,31,7.57060774396101,37.429392256039
"1980","got make",5.52886851069757,45,14,31,7.57060774396101,37.429392256039
"1990","baby let",5.52736295751459,126,38,88,26.730231687121,99.269768312879
"1990","explain",5.52736295751459,126,38,88,26.730231687121,99.269768312879
"2000","whatever",5.52621349371191,343,112,231,92.2963907138746,250.703609286125
"1960","can work",5.51817728994796,64,9,55,3.82228949714393,60.1777105028561
"1960","girl oh",5.51817728994796,64,9,55,3.82228949714393,60.1777105028561
"1960","hold hand",5.51817728994796,64,9,55,3.82228949714393,60.1777105028561
"2000","aint getting",5.5148116938897,27,13,14,7.26531355473648,19.7346864452635
"2000","diamond rings",5.5148116938897,27,13,14,7.26531355473648,19.7346864452635
"2000","either way",5.5148116938897,27,13,14,7.26531355473648,19.7346864452635
"2000","except",5.5148116938897,27,13,14,7.26531355473648,19.7346864452635
"2000","peeps",5.5148116938897,27,13,14,7.26531355473648,19.7346864452635
"1990","dont dont dont",5.5115837351348,40,15,25,8.48578783718126,31.5142121628187
"1990","endless",5.51021996390936,47,17,30,9.97080070868799,37.029199291312
"1990","makes want",5.51021996390936,47,17,30,9.97080070868799,37.029199291312
"1990","shelter",5.51021996390936,47,17,30,9.97080070868799,37.029199291312
"2010","losing",5.50977550918633,155,35,120,23.8642222166607,131.135777783339
"1980","tell youre",5.50975032627176,67,19,48,11.2717937521197,55.7282062478803
"1970","dee",5.50898750187554,115,25,90,15.7375075619563,99.2624924380437
"1990","soul",5.50193648874239,642,161,481,136.196894786759,505.803105213241
"1980","color",5.48516700998,90,24,66,15.141215487922,74.858784512078
"1970","day youll",5.48227894016913,25,8,17,3.42119729607745,21.5788027039226
"1970","feel better",5.48227894016913,25,8,17,3.42119729607745,21.5788027039226
"1970","shining star",5.48227894016913,25,8,17,3.42119729607745,21.5788027039226
"1970","sleepy",5.48227894016913,25,8,17,3.42119729607745,21.5788027039226
"1970","something good",5.48227894016913,25,8,17,3.42119729607745,21.5788027039226
"1970","way got",5.48227894016913,25,8,17,3.42119729607745,21.5788027039226
"1970","will remember",5.48227894016913,25,8,17,3.42119729607745,21.5788027039226
"1970","young girl",5.48227894016913,25,8,17,3.42119729607745,21.5788027039226
"2010","list",5.47943309507504,68,18,50,10.469465230535,57.530534769465
"2010","whip",5.47287514331796,182,40,142,28.021215764079,153.978784235921
"2000","means",5.47050551342131,155,55,100,41.7082815179316,113.291718482068
"2010","bang bang",5.47036451091419,103,25,78,15.858160569781,87.141839430219
"2010","whiskey",5.46226366128532,49,14,35,7.54417347494436,41.4558265250556
"1970","scene",5.45957644958172,121,26,95,16.5585949130148,104.441405086985
"2010","bitch im",5.45739079722845,31,10,21,4.77284444333215,26.2271555566679
"2010","come alive",5.45739079722845,31,10,21,4.77284444333215,26.2271555566679
"2010","credit",5.45739079722845,31,10,21,4.77284444333215,26.2271555566679
"2010","gonna know",5.45739079722845,31,10,21,4.77284444333215,26.2271555566679
"2010","im already",5.45739079722845,31,10,21,4.77284444333215,26.2271555566679
"2010","tattoo",5.45739079722845,31,10,21,4.77284444333215,26.2271555566679
"2010","work work work",5.45739079722845,31,10,21,4.77284444333215,26.2271555566679
"2010","dress",5.45440657714677,150,34,116,23.0944085967684,126.905591403232
"1960","arms around",5.45144699485359,44,7,37,2.62782402928645,41.3721759707135
"1960","kind love",5.45144699485359,44,7,37,2.62782402928645,41.3721759707135
"1960","made love",5.45144699485359,44,7,37,2.62782402928645,41.3721759707135
"1960","touching",5.45144699485359,44,7,37,2.62782402928645,41.3721759707135
"2000","girl need",5.45043859984163,41,18,23,11.032513175711,29.9674868242891
"2000","know think",5.45043859984163,41,18,23,11.032513175711,29.9674868242891
"2000","now look",5.45043859984163,41,18,23,11.032513175711,29.9674868242891
"2000","separate",5.45043859984163,41,18,23,11.032513175711,29.9674868242891
"2000","size",5.45043859984163,41,18,23,11.032513175711,29.9674868242891
"1960","cant tell",5.44978928972037,54,8,46,3.22505676321519,50.7749432367848
"1960","just good",5.44978928972037,54,8,46,3.22505676321519,50.7749432367848
"1960","new york city",5.44978928972037,54,8,46,3.22505676321519,50.7749432367848
"2010","just hold",5.44830138830513,73,19,54,11.2392788504273,61.7607211495727
"2010","oh cant",5.44830138830513,73,19,54,11.2392788504273,61.7607211495727
"1980","back time",5.43689156332651,41,13,28,6.8976648333867,34.1023351666133
"1980","beyond",5.43689156332651,41,13,28,6.8976648333867,34.1023351666133
"1980","cause theres",5.43689156332651,41,13,28,6.8976648333867,34.1023351666133
"1980","say can",5.43689156332651,41,13,28,6.8976648333867,34.1023351666133
"1980","shes one",5.43689156332651,41,13,28,6.8976648333867,34.1023351666133
"1980","yeahyou",5.43689156332651,41,13,28,6.8976648333867,34.1023351666133
"1990","anymore",5.43377359459661,227,63,164,48.1568459760037,178.843154023996
"1970","missin",5.43113144946233,60,15,45,8.21087351058588,51.7891264894141
"1980","crazy",5.42625367484506,861,171,690,144.850961501121,716.149038498879
"1990","questions",5.41998978057514,69,23,46,14.6379840191377,54.3620159808623
"1990","wanna hear",5.41998978057514,69,23,46,14.6379840191377,54.3620159808623
"1990","clap hands",5.41485088861804,30,12,18,6.36434087788595,23.6356591221141
"1990","let walk",5.41485088861804,30,12,18,6.36434087788595,23.6356591221141
"1990","together love",5.41485088861804,30,12,18,6.36434087788595,23.6356591221141
"1990","youre need",5.41485088861804,30,12,18,6.36434087788595,23.6356591221141
"1980","askin",5.40523434116035,54,16,38,9.08472929275321,44.9152707072468
"1980","play game",5.40523434116035,54,16,38,9.08472929275321,44.9152707072468
"1980","lucky",5.40484151450766,95,25,70,15.9823941261399,79.0176058738601
"1960","youve got",5.40379005429828,391,35,356,23.3517998966137,367.648200103386
"2010","dice",5.39867412245021,40,12,28,6.15850895913825,33.8414910408617
"2010","make feel good",5.39867412245021,40,12,28,6.15850895913825,33.8414910408617
"2010","suit",5.39867412245021,40,12,28,6.15850895913825,33.8414910408617
"1980","bad bad bad",5.39739317850363,21,8,13,3.53295028051514,17.4670497194849
"1980","halfway",5.39739317850363,21,8,13,3.53295028051514,17.4670497194849
"1980","id take",5.39739317850363,21,8,13,3.53295028051514,17.4670497194849
"1980","just game",5.39739317850363,21,8,13,3.53295028051514,17.4670497194849
"1980","just man",5.39739317850363,21,8,13,3.53295028051514,17.4670497194849
"1980","like every",5.39739317850363,21,8,13,3.53295028051514,17.4670497194849
"1980","want play",5.39739317850363,21,8,13,3.53295028051514,17.4670497194849
"1980","youbut",5.39739317850363,21,8,13,3.53295028051514,17.4670497194849
"1990","ice",5.38384409656157,215,60,155,45.6111096248493,169.388890375151
"2000","good night",5.38030252116779,44,19,25,11.8397702373483,32.1602297626517
"2000","got feelin",5.38030252116779,44,19,25,11.8397702373483,32.1602297626517
"2000","im talkin",5.38030252116779,44,19,25,11.8397702373483,32.1602297626517
"2000","ya dont",5.38030252116779,44,19,25,11.8397702373483,32.1602297626517
"1990","week",5.37583003094119,111,34,77,23.548061248178,87.451938751822
"2000","brings",5.36771511610902,89,34,55,23.9486261619091,65.0513738380909
"1970","hour",5.36739817697718,110,24,86,15.0532681027408,94.9467318972592
"1960","great",5.36663870516455,145,16,129,8.65987464196672,136.340125358033
"1980","listening",5.36259939398488,63,18,45,10.5988508415454,52.4011491584546
"1980","calm",5.36127495846616,37,12,25,6.22472192281238,30.7752780771876
"1980","hold arms",5.36127495846616,37,12,25,6.22472192281238,30.7752780771876
"1980","make mind",5.36127495846616,37,12,25,6.22472192281238,30.7752780771876
"1970","gonna see",5.35612784356675,55,14,41,7.52663405137039,47.4733659486296
"1960","whenever",5.35350999673181,182,19,163,10.8696357575031,171.130364242497
"1990","loose",5.34883881132732,115,35,80,24.3966400318961,90.6033599681039
"1960","bus",5.34076797438752,65,9,56,3.88201277053681,61.1179872294632
"2000","like baby",5.33924281502046,86,33,53,23.1413691002718,62.8586308997282
"2000","always time",5.33160237771513,30,14,16,8.07257061637387,21.9274293836261
"2000","everything alright",5.33160237771513,30,14,16,8.07257061637387,21.9274293836261
"2000","lookin good",5.33160237771513,30,14,16,8.07257061637387,21.9274293836261
"2000","mecause",5.33160237771513,30,14,16,8.07257061637387,21.9274293836261
"1990","love cause",5.33128413006431,51,18,33,10.8193794924061,40.1806205075939
"1970","eyed",5.3289789790581,30,9,21,4.10543675529294,25.8945632447071
"1970","good just",5.3289789790581,30,9,21,4.10543675529294,25.8945632447071
"1970","long just",5.3289789790581,30,9,21,4.10543675529294,25.8945632447071
"1970","scratch",5.3289789790581,30,9,21,4.10543675529294,25.8945632447071
"2000","baby wont",5.32641200153585,47,20,27,12.6470272989857,34.3529727010143
"2000","makes want",5.32641200153585,47,20,27,12.6470272989857,34.3529727010143
"2010","aint goin",5.32594747407893,27,9,18,4.15699354741832,22.8430064525817
"2010","beat heart",5.32594747407893,27,9,18,4.15699354741832,22.8430064525817
"2010","countin",5.32594747407893,27,9,18,4.15699354741832,22.8430064525817
"2010","gotta tell",5.32594747407893,27,9,18,4.15699354741832,22.8430064525817
"2010","night baby",5.32594747407893,27,9,18,4.15699354741832,22.8430064525817
"2010","one make",5.32594747407893,27,9,18,4.15699354741832,22.8430064525817
"2010","palm",5.32594747407893,27,9,18,4.15699354741832,22.8430064525817
"2010","want live",5.32594747407893,27,9,18,4.15699354741832,22.8430064525817
"2010","youre one want",5.32594747407893,27,9,18,4.15699354741832,22.8430064525817
"1960","im never gonna",5.31801071940195,35,6,29,2.09031456875059,32.9096854312494
"1960","lake",5.31801071940195,35,6,29,2.09031456875059,32.9096854312494
"1960","now hes",5.31801071940195,35,6,29,2.09031456875059,32.9096854312494
"1960","place can",5.31801071940195,35,6,29,2.09031456875059,32.9096854312494
"1960","tell world",5.31801071940195,35,6,29,2.09031456875059,32.9096854312494
"1980","ohh",5.31437154571103,188,44,144,31.6283167969926,156.371683203007
"1980","really want",5.31437154571103,188,44,144,31.6283167969926,156.371683203007
"1960","cream",5.31420864890817,87,11,76,5.19592478518003,81.80407521482
"2000","make go",5.31302029849175,83,32,51,22.3341120386344,60.6658879613656
"1980","feel fine",5.3076990349074,33,11,22,5.55177901223807,27.4482209877619
"1980","thats wanna",5.3076990349074,33,11,22,5.55177901223807,27.4482209877619
"1980","think dont",5.3076990349074,33,11,22,5.55177901223807,27.4482209877619
"1980","trying make",5.3076990349074,33,11,22,5.55177901223807,27.4482209877619
"1980","wholl",5.3076990349074,33,11,22,5.55177901223807,27.4482209877619
"1980","dont love dont",5.30669337577664,25,9,16,4.20589319108945,20.7941068089106
"1980","wont say",5.30669337577664,25,9,16,4.20589319108945,20.7941068089106
"1960","married",5.30402952192224,76,10,66,4.53896877785842,71.4610312221416
"1990","every single",5.30080923155223,92,29,63,19.5173120255169,72.4826879744831
"1990","dont walk",5.30031967470977,37,14,23,7.84935374939267,29.1506462506073
"1990","just walk",5.30031967470977,37,14,23,7.84935374939267,29.1506462506073
"1970","grew",5.29548652345476,50,13,37,6.8423945921549,43.1576054078451
"1970","ship",5.29548652345476,50,13,37,6.8423945921549,43.1576054078451
"1970","spring",5.29548652345476,50,13,37,6.8423945921549,43.1576054078451
"1990","cause can",5.29077797456413,62,21,41,13.152971147631,48.847028852369
"1990","lots",5.29077797456413,62,21,41,13.152971147631,48.847028852369
"1990","love good",5.29077797456413,62,21,41,13.152971147631,48.847028852369
"1990","mountains",5.29077797456413,62,21,41,13.152971147631,48.847028852369
"2000","now get",5.28929621911471,80,31,49,21.526854976997,58.473145023003
"2000","can go",5.28826843616259,198,68,130,53.2789660680675,144.721033931932
"2000","im really",5.28589183832055,50,21,29,13.4542843606231,36.5457156393769
"2000","somebody else",5.28589183832055,50,21,29,13.4542843606231,36.5457156393769
"1990","say wanna",5.28586508433252,44,16,28,9.33436662089939,34.6656333791006
"1990","want like",5.28586508433252,44,16,28,9.33436662089939,34.6656333791006
"1980","harmony",5.28484355790355,29,10,19,4.87883610166376,24.1211638983362
"1980","let music",5.28484355790355,29,10,19,4.87883610166376,24.1211638983362
"1980","senses",5.28484355790355,29,10,19,4.87883610166376,24.1211638983362
"1980","steel",5.28484355790355,29,10,19,4.87883610166376,24.1211638983362
"1980","sure know",5.28484355790355,29,10,19,4.87883610166376,24.1211638983362
"2010","dont feel",5.28289852909745,109,26,83,16.7819369136517,92.2180630863483
"1980","tonight oh",5.27967840028265,50,15,35,8.4117863821789,41.5882136178211
"2000","god",5.27793861038224,501,158,343,134.811929293444,366.188070706556
"2000","daily",5.2775820775067,22,11,11,5.91988511867417,16.0801148813258
"2000","go now go now",5.2775820775067,22,11,11,5.91988511867417,16.0801148813258
"2000","many people",5.2775820775067,22,11,11,5.91988511867417,16.0801148813258
"2000","next day",5.2775820775067,22,11,11,5.91988511867417,16.0801148813258
"2000","now go now",5.2775820775067,22,11,11,5.91988511867417,16.0801148813258
"2000","see wont",5.2775820775067,22,11,11,5.91988511867417,16.0801148813258
"2000","skirt",5.2775820775067,22,11,11,5.91988511867417,16.0801148813258
"2000","speaking",5.2775820775067,22,11,11,5.91988511867417,16.0801148813258
"2000","whats goin",5.2775820775067,22,11,11,5.91988511867417,16.0801148813258
"2010","anything wanna",5.27164054458908,15,6,9,2.30944085967684,12.6905591403232
"2010","break free",5.27164054458908,15,6,9,2.30944085967684,12.6905591403232
"2010","can hit",5.27164054458908,15,6,9,2.30944085967684,12.6905591403232
"2010","can sweet",5.27164054458908,15,6,9,2.30944085967684,12.6905591403232
"2010","ever let go",5.27164054458908,15,6,9,2.30944085967684,12.6905591403232
"2010","eyes said",5.27164054458908,15,6,9,2.30944085967684,12.6905591403232
"2010","im even",5.27164054458908,15,6,9,2.30944085967684,12.6905591403232
"2010","im let",5.27164054458908,15,6,9,2.30944085967684,12.6905591403232
"2010","jacket",5.27164054458908,15,6,9,2.30944085967684,12.6905591403232
"2010","least can",5.27164054458908,15,6,9,2.30944085967684,12.6905591403232
"2010","lets lets lets",5.27164054458908,15,6,9,2.30944085967684,12.6905591403232
"2010","love leave",5.27164054458908,15,6,9,2.30944085967684,12.6905591403232
"2010","love let go",5.27164054458908,15,6,9,2.30944085967684,12.6905591403232
"2010","love touch",5.27164054458908,15,6,9,2.30944085967684,12.6905591403232
"2010","meyeah",5.27164054458908,15,6,9,2.30944085967684,12.6905591403232
"2010","mine cause",5.27164054458908,15,6,9,2.30944085967684,12.6905591403232
"2010","needle",5.27164054458908,15,6,9,2.30944085967684,12.6905591403232
"2010","niggas dont",5.27164054458908,15,6,9,2.30944085967684,12.6905591403232
"2010","right now dont",5.27164054458908,15,6,9,2.30944085967684,12.6905591403232
"2010","stay awake",5.27164054458908,15,6,9,2.30944085967684,12.6905591403232
"2010","tell im sorry",5.27164054458908,15,6,9,2.30944085967684,12.6905591403232
"2010","way turn",5.27164054458908,15,6,9,2.30944085967684,12.6905591403232
"2010","worlds gonna",5.27164054458908,15,6,9,2.30944085967684,12.6905591403232
"1960","anyway",5.25926156593373,122,14,108,7.28623935393062,114.713760646069
"1970","planned",5.25705118494498,35,10,25,4.78967621450843,30.2103237854916
"2000","go like",5.25651064850389,53,22,31,14.2615414222605,38.7384585777395
"2000","hopin",5.25651064850389,53,22,31,14.2615414222605,38.7384585777395
"1960","york city",5.25544414090846,55,8,47,3.28478003660807,51.7152199633919
"1980","know dont know",5.25473569653604,77,21,56,12.9541510285555,64.0458489714445
"1970","apple",5.25372752540646,45,12,33,6.15815513293941,38.8418448670606
"1970","guarantee",5.25372752540646,45,12,33,6.15815513293941,38.8418448670606
"1970","nite",5.25372752540646,45,12,33,6.15815513293941,38.8418448670606
"1970","people dont",5.25372752540646,45,12,33,6.15815513293941,38.8418448670606
"2000","record",5.25053629504658,74,29,45,19.9123408537222,54.0876591462778
"1980","know cant",5.25011383498334,134,33,101,22.5435875042394,111.456412495761
"1980","oh yes",5.25011383498334,134,33,101,22.5435875042394,111.456412495761
"1990","know dont know",5.24928481543392,77,25,52,16.3351415865739,60.6648584134261
"2010","con",5.2435996674502,45,13,32,6.92832257903053,38.0716774209695
"1990","around baby",5.24215851881771,27,11,16,5.72790679009735,21.2720932099026
"1990","candles",5.24215851881771,27,11,16,5.72790679009735,21.2720932099026
"1990","day will",5.24215851881771,27,11,16,5.72790679009735,21.2720932099026
"1990","forth",5.24215851881771,27,11,16,5.72790679009735,21.2720932099026
"1990","mellow",5.24215851881771,27,11,16,5.72790679009735,21.2720932099026
"1990","things just",5.24215851881771,27,11,16,5.72790679009735,21.2720932099026
"1990","work body",5.24215851881771,27,11,16,5.72790679009735,21.2720932099026
"1970","love one",5.24082080941142,88,20,68,12.0426144821926,75.9573855178074
"2010","dont even know",5.23765009152387,64,17,47,9.8536143346212,54.1463856653788
"1970","oh little",5.237505481139,40,11,29,5.47391567372392,34.5260843262761
"2000","see know",5.23650948802364,56,23,33,15.0687984838979,40.9312015161021
"2010","danced night",5.2323086601576,23,8,15,3.5411426515045,19.4588573484955
"2010","enough im",5.2323086601576,23,8,15,3.5411426515045,19.4588573484955
"2010","even try",5.2323086601576,23,8,15,3.5411426515045,19.4588573484955
"2010","goin back",5.2323086601576,23,8,15,3.5411426515045,19.4588573484955
"2010","hates",5.2323086601576,23,8,15,3.5411426515045,19.4588573484955
"2010","heading",5.2323086601576,23,8,15,3.5411426515045,19.4588573484955
"2010","know youre going",5.2323086601576,23,8,15,3.5411426515045,19.4588573484955
"2010","sober",5.2323086601576,23,8,15,3.5411426515045,19.4588573484955
"2010","song just",5.2323086601576,23,8,15,3.5411426515045,19.4588573484955
"2010","wanna roll",5.2323086601576,23,8,15,3.5411426515045,19.4588573484955
"2010","world im",5.2323086601576,23,8,15,3.5411426515045,19.4588573484955
"2010","yeah yeah im",5.2323086601576,23,8,15,3.5411426515045,19.4588573484955
"1960","can change",5.23229541793398,45,7,38,2.68754730267933,42.3124526973207
"1960","worries",5.23229541793398,45,7,38,2.68754730267933,42.3124526973207
"1970","baby rock",5.23140016349369,21,7,14,2.87380572870506,18.1261942712949
"1970","beautiful youre",5.23140016349369,21,7,14,2.87380572870506,18.1261942712949
"1970","damned",5.23140016349369,21,7,14,2.87380572870506,18.1261942712949
"1970","eyes love",5.23140016349369,21,7,14,2.87380572870506,18.1261942712949
"1970","first love",5.23140016349369,21,7,14,2.87380572870506,18.1261942712949
"1970","keep lovin",5.23140016349369,21,7,14,2.87380572870506,18.1261942712949
"1970","love fall",5.23140016349369,21,7,14,2.87380572870506,18.1261942712949
"1970","love world",5.23140016349369,21,7,14,2.87380572870506,18.1261942712949
"1970","prayed",5.23140016349369,21,7,14,2.87380572870506,18.1261942712949
"1970","song make",5.23140016349369,21,7,14,2.87380572870506,18.1261942712949
"1970","sue",5.23140016349369,21,7,14,2.87380572870506,18.1261942712949
"1970","woman love",5.23140016349369,21,7,14,2.87380572870506,18.1261942712949
"2000","seven",5.22973679026346,105,39,66,28.2539971573085,76.7460028426915
"2010","steal",5.22499777068798,99,24,75,15.2423096738672,83.7576903261328
"2000","faster",5.22448264256516,59,24,35,15.8760555455353,43.1239444544647
"2000","im lookin",5.22448264256516,59,24,35,15.8760555455353,43.1239444544647
"1960","stars",5.22131126989776,313,29,284,18.6933845719695,294.30661542803
"2000","hung",5.22001015457226,65,26,39,17.49056966881,47.50943033119
"2000","walks",5.22001015457226,65,26,39,17.49056966881,47.50943033119
"2000","one two three",5.21929289761894,62,25,37,16.6833126071727,45.3166873928273
"1980","need someone",5.21863529511501,59,17,42,9.9259079309711,49.0740920690289
"1980","thinks",5.21863529511501,59,17,42,9.9259079309711,49.0740920690289
"1980","cant get enough",5.21701799799486,68,19,49,11.4400294797633,56.5599705202367
"1980","apartment",5.21454205309382,14,6,8,2.35530018701009,11.6446998129899
"1980","away night",5.21454205309382,14,6,8,2.35530018701009,11.6446998129899
"1980","destroy",5.21454205309382,14,6,8,2.35530018701009,11.6446998129899
"1980","eyes feel",5.21454205309382,14,6,8,2.35530018701009,11.6446998129899
"1980","eyesi",5.21454205309382,14,6,8,2.35530018701009,11.6446998129899
"1980","gonna slow",5.21454205309382,14,6,8,2.35530018701009,11.6446998129899
"1980","heartyou",5.21454205309382,14,6,8,2.35530018701009,11.6446998129899
"1980","hope youll",5.21454205309382,14,6,8,2.35530018701009,11.6446998129899
"1980","im dancing",5.21454205309382,14,6,8,2.35530018701009,11.6446998129899
"1980","im deep",5.21454205309382,14,6,8,2.35530018701009,11.6446998129899
"1980","life goes",5.21454205309382,14,6,8,2.35530018701009,11.6446998129899
"1980","need much",5.21454205309382,14,6,8,2.35530018701009,11.6446998129899
"1980","night ooh",5.21454205309382,14,6,8,2.35530018701009,11.6446998129899
"1980","satellite",5.21454205309382,14,6,8,2.35530018701009,11.6446998129899
"1980","stay oh",5.21454205309382,14,6,8,2.35530018701009,11.6446998129899
"1980","still care",5.21454205309382,14,6,8,2.35530018701009,11.6446998129899
"1980","things wanna",5.21454205309382,14,6,8,2.35530018701009,11.6446998129899
"1980","true youre",5.21454205309382,14,6,8,2.35530018701009,11.6446998129899
"1980","wanna tell love way",5.21454205309382,14,6,8,2.35530018701009,11.6446998129899
"1980","whenever im",5.21454205309382,14,6,8,2.35530018701009,11.6446998129899
"1980","yeah say",5.21454205309382,14,6,8,2.35530018701009,11.6446998129899
"2000","aint funny",5.21210781284374,12,7,5,3.22902824654955,8.77097175345045
"2000","away well",5.21210781284374,12,7,5,3.22902824654955,8.77097175345045
"2000","believe heart",5.21210781284374,12,7,5,3.22902824654955,8.77097175345045
"2000","confession",5.21210781284374,12,7,5,3.22902824654955,8.77097175345045
"2000","cutest",5.21210781284374,12,7,5,3.22902824654955,8.77097175345045
"2000","fired",5.21210781284374,12,7,5,3.22902824654955,8.77097175345045
"2000","fuck wit",5.21210781284374,12,7,5,3.22902824654955,8.77097175345045
"2000","go nowhere",5.21210781284374,12,7,5,3.22902824654955,8.77097175345045
"2000","gone aint",5.21210781284374,12,7,5,3.22902824654955,8.77097175345045
"2000","got sexy",5.21210781284374,12,7,5,3.22902824654955,8.77097175345045
"2000","hard got",5.21210781284374,12,7,5,3.22902824654955,8.77097175345045
"2000","herei",5.21210781284374,12,7,5,3.22902824654955,8.77097175345045
"2000","home come",5.21210781284374,12,7,5,3.22902824654955,8.77097175345045
"2000","im gonna spend",5.21210781284374,12,7,5,3.22902824654955,8.77097175345045
"2000","im keeping",5.21210781284374,12,7,5,3.22902824654955,8.77097175345045
"2000","im torn",5.21210781284374,12,7,5,3.22902824654955,8.77097175345045
"2000","juliet",5.21210781284374,12,7,5,3.22902824654955,8.77097175345045
"2000","life hands",5.21210781284374,12,7,5,3.22902824654955,8.77097175345045
"2000","listen say",5.21210781284374,12,7,5,3.22902824654955,8.77097175345045
"2000","love never knew",5.21210781284374,12,7,5,3.22902824654955,8.77097175345045
"2000","love way love way",5.21210781284374,12,7,5,3.22902824654955,8.77097175345045
"2000","lungs",5.21210781284374,12,7,5,3.22902824654955,8.77097175345045
"2000","nowhere else",5.21210781284374,12,7,5,3.22902824654955,8.77097175345045
"2000","one believe",5.21210781284374,12,7,5,3.22902824654955,8.77097175345045
"2000","one second",5.21210781284374,12,7,5,3.22902824654955,8.77097175345045
"2000","play games",5.21210781284374,12,7,5,3.22902824654955,8.77097175345045
"2000","playing games",5.21210781284374,12,7,5,3.22902824654955,8.77097175345045
"2000","promise wont",5.21210781284374,12,7,5,3.22902824654955,8.77097175345045
"2000","regular",5.21210781284374,12,7,5,3.22902824654955,8.77097175345045
"2000","sky high",5.21210781284374,12,7,5,3.22902824654955,8.77097175345045
"2000","something tell",5.21210781284374,12,7,5,3.22902824654955,8.77097175345045
"2000","ten thousand",5.21210781284374,12,7,5,3.22902824654955,8.77097175345045
"2000","thatll make",5.21210781284374,12,7,5,3.22902824654955,8.77097175345045
"2000","way long",5.21210781284374,12,7,5,3.22902824654955,8.77097175345045
"2000","world goes",5.21210781284374,12,7,5,3.22902824654955,8.77097175345045
"2000","world looks",5.21210781284374,12,7,5,3.22902824654955,8.77097175345045
"2000","yeahthe",5.21210781284374,12,7,5,3.22902824654955,8.77097175345045
"2010","life love",5.20670129393192,36,11,25,5.54265806322443,30.4573419367756
"1980","coming",5.20613114320061,614,125,489,103.296736773157,510.703263226843
"1960","baby im",5.20426579283312,340,31,309,20.3059129535771,319.694087046423
"2010","broke",5.19981899178854,233,49,184,35.8733146869803,197.12668531302
"2010","away will",5.19905169727245,19,7,12,2.92529175559067,16.0747082444093
"2010","body now",5.19905169727245,19,7,12,2.92529175559067,16.0747082444093
"2010","body right",5.19905169727245,19,7,12,2.92529175559067,16.0747082444093
"2010","crazy cause",5.19905169727245,19,7,12,2.92529175559067,16.0747082444093
"2010","girl lets",5.19905169727245,19,7,12,2.92529175559067,16.0747082444093
"2010","high heels",5.19905169727245,19,7,12,2.92529175559067,16.0747082444093
"2010","ill leave",5.19905169727245,19,7,12,2.92529175559067,16.0747082444093
"2010","life theres",5.19905169727245,19,7,12,2.92529175559067,16.0747082444093
"2010","one yeah",5.19905169727245,19,7,12,2.92529175559067,16.0747082444093
"2010","ya now",5.19905169727245,19,7,12,2.92529175559067,16.0747082444093
"2010","yes yes yes",5.19905169727245,19,7,12,2.92529175559067,16.0747082444093
"1970","boys",5.19718779368411,581,99,482,79.5086251608399,501.49137483916
"2000","famous",5.19167819873269,33,15,18,8.87982767801125,24.1201723219887
"2000","got like",5.19167819873269,33,15,18,8.87982767801125,24.1201723219887
"2000","security",5.19167819873269,33,15,18,8.87982767801125,24.1201723219887
"2000","think im gonna",5.19167819873269,33,15,18,8.87982767801125,24.1201723219887
"2000","way wanna",5.19167819873269,33,15,18,8.87982767801125,24.1201723219887
"1970","tryin",5.18856683145858,516,89,427,70.6135121910385,445.386487808961
"2010","thousand",5.18305011694942,173,38,135,26.6355512482729,146.364448751727
"1980","jump jump",5.17854105176927,115,29,86,19.3471086790115,95.6528913209885
"2010","lyin",5.17774975396452,84,21,63,12.9328688141903,71.0671311858097
"1980","darling",5.17353809440161,260,58,202,43.7412891873303,216.25871081267
"1970","wonderful",5.17198034691146,111,24,87,15.1901159945839,95.8098840054161
"1960","sees",5.16830439820367,66,9,57,3.94173604392968,62.0582639560703
"1960","shines",5.16830439820367,66,9,57,3.94173604392968,62.0582639560703
"1960","oh love",5.16536248323972,111,13,98,6.62928334660901,104.370716653391
"1970","word",5.16503572545987,343,62,281,46.9388269021826,296.061173097817
"1980","blinded",5.16178762373333,46,14,32,7.73884347160458,38.2611565283954
"1980","every little thing",5.16178762373333,46,14,32,7.73884347160458,38.2611565283954
"1980","lonely nights",5.16178762373333,46,14,32,7.73884347160458,38.2611565283954
"1980","much better",5.16178762373333,46,14,32,7.73884347160458,38.2611565283954
"1980","say just",5.16178762373333,46,14,32,7.73884347160458,38.2611565283954
"1990","one thing",5.1591564983624,204,57,147,43.2775179696245,160.722482030376
"1970","action",5.15558058128505,61,15,46,8.34772140242897,52.652278597571
"1980","flame",5.15512570141527,82,22,60,13.7953296667734,68.2046703332266
"1980","new",5.15200937603218,1223,236,987,205.752294908096,1017.2477050919
"1960","im ready",5.14866607571192,147,16,131,8.77932118875247,138.220678811248
"2000","confusing",5.13625547041031,17,9,8,4.57445668261186,12.4255433173881
"2000","just lay",5.13625547041031,17,9,8,4.57445668261186,12.4255433173881
"2000","killers",5.13625547041031,17,9,8,4.57445668261186,12.4255433173881
"2000","kills",5.13625547041031,17,9,8,4.57445668261186,12.4255433173881
"2000","na hey",5.13625547041031,17,9,8,4.57445668261186,12.4255433173881
"2000","na na hey",5.13625547041031,17,9,8,4.57445668261186,12.4255433173881
"2000","one girl",5.13625547041031,17,9,8,4.57445668261186,12.4255433173881
"2000","open mind",5.13625547041031,17,9,8,4.57445668261186,12.4255433173881
"2000","pow",5.13625547041031,17,9,8,4.57445668261186,12.4255433173881
"2000","proper",5.13625547041031,17,9,8,4.57445668261186,12.4255433173881
"2000","right things",5.13625547041031,17,9,8,4.57445668261186,12.4255433173881
"2000","said couldnt",5.13625547041031,17,9,8,4.57445668261186,12.4255433173881
"2000","thats lost",5.13625547041031,17,9,8,4.57445668261186,12.4255433173881
"2000","triple",5.13625547041031,17,9,8,4.57445668261186,12.4255433173881
"2000","youre want",5.13625547041031,17,9,8,4.57445668261186,12.4255433173881
"2000","lets go",5.13562865231001,202,69,133,54.3553088169174,147.644691183083
"1990","share",5.13485601250042,237,65,172,50.278292935299,186.721707064701
"1990","ease",5.12128498905085,85,27,58,18.0322991540102,66.9677008459898
"2000","im feelin",5.11809768107449,118,43,75,31.7521110910705,86.2478889089295
"2000","lot",5.11320673750082,410,131,279,110.32513175711,299.67486824289
"2000","become",5.11117324646637,96,36,60,25.8322259723964,70.1677740276036
"1970","set free",5.10615969930634,72,17,55,9.85304821270305,62.146951787297
"1980","love wont",5.10505872657157,101,26,75,16.9918084920014,84.0081915079986
"1990","doo doo doo doo",5.10104291636971,48,17,31,10.1829454046175,37.8170545953825
"1990","youre right",5.10104291636971,48,17,31,10.1829454046175,37.8170545953825
"2000","callin",5.09856078957867,134,48,86,36.0574820864699,97.9425179135301
"1970","dat",5.09643647992679,350,63,287,47.8967621450843,302.103237854916
"1990","final",5.09327931353989,34,13,21,7.21291966160408,26.7870803383959
"1990","kicking",5.09327931353989,34,13,21,7.21291966160408,26.7870803383959
"1990","wrong dont",5.09327931353989,34,13,21,7.21291966160408,26.7870803383959
"1990","bow",5.09310127235807,70,23,47,14.8501287150672,55.1498712849328
"1980","might",5.08774575239502,702,141,561,118.101480805792,583.898519194208
"1970","really love",5.08699698560542,100,22,78,13.6847891843098,86.3152108156902
"1990","around us",5.08480066286199,24,10,14,5.09147270230876,18.9085272976912
"1990","can wanna",5.08480066286199,24,10,14,5.09147270230876,18.9085272976912
"1990","good know",5.08480066286199,24,10,14,5.09147270230876,18.9085272976912
"1990","jay",5.08480066286199,24,10,14,5.09147270230876,18.9085272976912
"1990","look just",5.08480066286199,24,10,14,5.09147270230876,18.9085272976912
"1990","onand",5.08480066286199,24,10,14,5.09147270230876,18.9085272976912
"1990","one kiss",5.08480066286199,24,10,14,5.09147270230876,18.9085272976912
"1990","tank",5.08480066286199,24,10,14,5.09147270230876,18.9085272976912
"2000","cant forget",5.08434142483281,36,16,20,9.68708473964864,26.3129152603514
"2000","knowi",5.08434142483281,36,16,20,9.68708473964864,26.3129152603514
"1960","hold",5.07978933878336,1726,126,1600,103.0823698761,1622.9176301239
"1980","hero",5.07853366303757,55,16,39,9.25296502039679,45.7470349796032
"1980","love way love",5.07853366303757,55,16,39,9.25296502039679,45.7470349796032
"1980","right just",5.07853366303757,55,16,39,9.25296502039679,45.7470349796032
"1990","baby cant",5.07083085460191,124,37,87,26.3059422952619,97.6940577047381
"1970","give love",5.07037578670436,219,42,177,29.9696883136384,189.030311686362
"1980","oh just",5.07005071826809,87,23,64,14.6365083049913,72.3634916950087
"1980","starting",5.07005071826809,87,23,64,14.6365083049913,72.3634916950087
"1990","self",5.06982719130245,89,28,61,18.8808779377283,70.1191220622717
"1970","now ill",5.06905601949819,56,14,42,7.66348194321348,48.3365180567865
"1970","satisfy",5.06905601949819,56,14,42,7.66348194321348,48.3365180567865
"1960","love heart",5.06728975462505,56,8,48,3.34450331000094,52.6554966899991
"2010","know love",5.06535618414949,318,64,254,48.9601462251491,269.039853774851
"1990","time just",5.06314098872611,41,15,26,8.6979325331108,32.3020674668892
"1990","ah ah ah ah",5.05553408605653,59,20,39,12.5165370598424,46.4834629401576
"1990","hold close",5.05553408605653,59,20,39,12.5165370598424,46.4834629401576
"1990","know go",5.05553408605653,59,20,39,12.5165370598424,46.4834629401576
"1990","reality",5.05553408605653,59,20,39,12.5165370598424,46.4834629401576
"1990","wont long",5.05553408605653,59,20,39,12.5165370598424,46.4834629401576
"1980","hear voice",5.05367107628119,42,13,29,7.06590056103027,34.9340994389697
"1980","just way",5.05245754625927,106,27,79,17.8329871302193,88.1670128697807
"2010","im gonna love",5.05190343371558,55,15,40,8.4679498188151,46.5320501811849
"2010","falling",5.05161690364356,375,74,301,57.7360214919211,317.263978508079
"1990","sure",5.04758994593001,560,141,419,118.801029720538,441.198970279462
"2010","wouldnt",5.04060400343247,421,82,339,64.8183067949301,356.18169320507
"2000","asking",5.03890534629105,90,34,56,24.2177118491216,65.7822881508784
"2000","beef",5.03799666929417,25,12,13,6.72714218031156,18.2728578196884
"2000","bumpin",5.03799666929417,25,12,13,6.72714218031156,18.2728578196884
"2000","cant see im",5.03799666929417,25,12,13,6.72714218031156,18.2728578196884
"2000","crazy im",5.03799666929417,25,12,13,6.72714218031156,18.2728578196884
"2000","crossed",5.03799666929417,25,12,13,6.72714218031156,18.2728578196884
"2000","feel let",5.03799666929417,25,12,13,6.72714218031156,18.2728578196884
"2000","just one thing",5.03799666929417,25,12,13,6.72714218031156,18.2728578196884
"2000","met girl",5.03799666929417,25,12,13,6.72714218031156,18.2728578196884
"2000","think like",5.03799666929417,25,12,13,6.72714218031156,18.2728578196884
"2000","want life",5.03799666929417,25,12,13,6.72714218031156,18.2728578196884
"2000","whatcha say",5.03799666929417,25,12,13,6.72714218031156,18.2728578196884
"2000","yeah keep",5.03799666929417,25,12,13,6.72714218031156,18.2728578196884
"2010","field",5.03021026892675,41,12,29,6.31247168311671,34.6875283168833
"2010","plane",5.03021026892675,41,12,29,6.31247168311671,34.6875283168833
"1970","awful",5.02979457935066,17,6,11,2.32641416133266,14.6735858386673
"1970","bind",5.02979457935066,17,6,11,2.32641416133266,14.6735858386673
"1970","boy play",5.02979457935066,17,6,11,2.32641416133266,14.6735858386673
"1970","dont wanna let",5.02979457935066,17,6,11,2.32641416133266,14.6735858386673
"1970","gone cant",5.02979457935066,17,6,11,2.32641416133266,14.6735858386673
"1970","hold got",5.02979457935066,17,6,11,2.32641416133266,14.6735858386673
"1970","road im",5.02979457935066,17,6,11,2.32641416133266,14.6735858386673
"1970","till im",5.02979457935066,17,6,11,2.32641416133266,14.6735858386673
"1970","towns",5.02979457935066,17,6,11,2.32641416133266,14.6735858386673
"1970","us baby",5.02979457935066,17,6,11,2.32641416133266,14.6735858386673
"2010","can always",5.02780897721797,32,10,22,4.9268071673106,27.0731928326894
"2010","help im",5.02780897721797,32,10,22,4.9268071673106,27.0731928326894
"2010","lets lets",5.02780897721797,32,10,22,4.9268071673106,27.0731928326894
"2010","like go",5.02780897721797,32,10,22,4.9268071673106,27.0731928326894
"1990","wish",5.02512374686237,839,205,634,177.989399884877,661.010600115123
"1960","empty",5.02430981391336,136,15,121,8.12236518143086,127.877634818569
"2000","stop",5.02373508818394,1555,458,1097,418.428243615379,1136.57175638462
"1970","baby gonna",5.02350848945933,26,8,18,3.55804518792055,22.4419548120795
"1970","care say",5.02350848945933,26,8,18,3.55804518792055,22.4419548120795
"1970","got takes",5.02350848945933,26,8,18,3.55804518792055,22.4419548120795
"1970","let live",5.02350848945933,26,8,18,3.55804518792055,22.4419548120795
"1970","like yesterday",5.02350848945933,26,8,18,3.55804518792055,22.4419548120795
"1970","said aint",5.02350848945933,26,8,18,3.55804518792055,22.4419548120795
"1970","woods",5.02350848945933,26,8,18,3.55804518792055,22.4419548120795
"1970","love feel",5.02280477237285,89,20,69,12.1794623740357,76.8205376259643
"1960","baby cant",5.02222785443826,124,14,110,7.40568590071637,116.594314099284
"1960","youre gone",5.02222785443826,124,14,110,7.40568590071637,116.594314099284
"1960","keep waiting",5.02133339324261,46,7,39,2.7472705760722,43.2527294239278
"1960","said love",5.02133339324261,46,7,39,2.7472705760722,43.2527294239278
"2000","late",5.00291421346025,421,134,287,113.285074316447,307.714925683553
"2000","around cause",5.00217518905286,39,17,22,10.494341801286,28.505658198714
"2000","im caught",5.00217518905286,39,17,22,10.494341801286,28.505658198714
"2000","make believe",5.00217518905286,39,17,22,10.494341801286,28.505658198714
"2000","page",5.00217518905286,39,17,22,10.494341801286,28.505658198714
"2000","prince",5.00217518905286,39,17,22,10.494341801286,28.505658198714
"1960","disguise",5.0006261516178,67,9,58,4.00145931732255,62.9985406826774
"1980","take time",4.99717152951667,155,37,118,26.0765377847546,128.923462215245
"2000","fuckin",4.99463441362092,183,63,120,49.2426807598806,133.757319240119
"1970","come baby",4.98888564981928,177,35,142,24.2220768562283,152.777923143772
"1970","oh can",4.9877445316808,78,18,60,10.6741355637616,67.3258644362384
"1980","want love",4.98646743264956,185,43,142,31.1236096140619,153.876390385938
"2000","ya ya",4.98536177247989,157,55,102,42.2464528923566,114.753547107643
"1970","turning",4.98501458991993,165,33,132,22.5799021541112,142.420097845889
"2010","im just",4.98390912934413,462,89,373,71.1307784780468,390.869221521953
"1960","pick",4.97419781184403,186,19,167,11.1085288510746,174.891471148925
"1960","wine",4.9717617229404,161,17,144,9.6154470162527,151.384552983747
"1960","town",4.96527930923814,467,40,427,27.8907686744721,439.109231325528
"1960","loved",4.96521786456443,398,35,363,23.7698628103638,374.230137189636
"1970","time",4.96251941194637,5176,764,4412,708.324688179875,4467.67531182012
"1980","can stand",4.95829349824076,38,12,26,6.39295765045596,31.607042349544
"1980","freeze",4.95829349824076,38,12,26,6.39295765045596,31.607042349544
"1990","swing",4.95408836736806,101,31,70,21.4266142888827,79.5733857111173
"1990","bad bad bad",4.94920029367632,21,9,12,4.45503861452016,16.5449613854798
"1990","bare",4.94920029367632,21,9,12,4.45503861452016,16.5449613854798
"1990","dont dare",4.94920029367632,21,9,12,4.45503861452016,16.5449613854798
"1990","ever wanna",4.94920029367632,21,9,12,4.45503861452016,16.5449613854798
"1990","gotta let know",4.94920029367632,21,9,12,4.45503861452016,16.5449613854798
"1990","like sun",4.94920029367632,21,9,12,4.45503861452016,16.5449613854798
"1990","man loves",4.94920029367632,21,9,12,4.45503861452016,16.5449613854798
"1990","mine dont",4.94920029367632,21,9,12,4.45503861452016,16.5449613854798
"1990","see world",4.94920029367632,21,9,12,4.45503861452016,16.5449613854798
"1990","show youre",4.94920029367632,21,9,12,4.45503861452016,16.5449613854798
"1990","strung",4.94920029367632,21,9,12,4.45503861452016,16.5449613854798
"1990","tell heart",4.94920029367632,21,9,12,4.45503861452016,16.5449613854798
"1990","three four",4.94920029367632,21,9,12,4.45503861452016,16.5449613854798
"1980","come sing",4.9490393022353,18,7,11,3.0282430975844,14.9717569024156
"1980","cry know",4.9490393022353,18,7,11,3.0282430975844,14.9717569024156
"1980","free dont",4.9490393022353,18,7,11,3.0282430975844,14.9717569024156
"1980","hot like",4.9490393022353,18,7,11,3.0282430975844,14.9717569024156
"1980","im kinda",4.9490393022353,18,7,11,3.0282430975844,14.9717569024156
"1980","just let go",4.9490393022353,18,7,11,3.0282430975844,14.9717569024156
"1980","know makes",4.9490393022353,18,7,11,3.0282430975844,14.9717569024156
"1980","know still",4.9490393022353,18,7,11,3.0282430975844,14.9717569024156
"1980","love believe",4.9490393022353,18,7,11,3.0282430975844,14.9717569024156
"1980","receive",4.9490393022353,18,7,11,3.0282430975844,14.9717569024156
"1980","youve found",4.9490393022353,18,7,11,3.0282430975844,14.9717569024156
"1990","hill",4.94868632139469,63,21,42,13.3651158435605,49.6348841564395
"1990","disappear",4.948050213111,52,18,34,11.0315241883356,40.9684758116644
"1990","give heart",4.948050213111,52,18,34,11.0315241883356,40.9684758116644
"2000","uh uh uh",4.9441854702928,125,45,80,33.6357109015578,91.3642890984422
"1980","fading",4.94317607939728,51,15,36,8.58002210982247,42.4199778901775
"1970","takin",4.942556808524,118,25,93,16.1480512374856,101.851948762514
"2010","unless",4.9407012187031,85,21,64,13.0868315381688,71.9131684618312
"2000","wanna touch",4.93986814829637,42,18,24,11.3015988629234,30.6984011370766
"1970","just cant",4.93928278573733,493,85,408,67.4660106786473,425.533989321353
"2010","hoping",4.93896073719077,70,18,52,10.7773906784919,59.2226093215081
"1980","say want",4.93569200509709,69,19,50,11.6082652074069,57.3917347925931
"1970","circles",4.93568844149642,46,12,34,6.29500302478251,39.7049969752175
"1980","well well",4.93493315955644,97,25,72,16.3188655814271,80.6811344185729
"2010","cause baby",4.93004253434036,75,19,56,11.5472042983842,63.4527957016158
"2010","know youve",4.93004253434036,75,19,56,11.5472042983842,63.4527957016158
"1980","start",4.92992010181729,753,150,603,126.681502915614,626.318497084386
"1970","bam",4.92386946073714,31,9,22,4.24228464713604,26.757715352864
"1970","belly",4.92386946073714,31,9,22,4.24228464713604,26.757715352864
"1970","cant give",4.92386946073714,31,9,22,4.24228464713604,26.757715352864
"1970","higher higher",4.92386946073714,31,9,22,4.24228464713604,26.757715352864
"1970","lights go",4.92386946073714,31,9,22,4.24228464713604,26.757715352864
"1970","love lets",4.92386946073714,31,9,22,4.24228464713604,26.757715352864
"1970","now weve",4.92386946073714,31,9,22,4.24228464713604,26.757715352864
"1970","pig",4.92386946073714,31,9,22,4.24228464713604,26.757715352864
"1970","tale",4.92386946073714,31,9,22,4.24228464713604,26.757715352864
"1980","understand",4.91533985155388,585,119,466,98.4179006714931,486.582099328507
"2010","enough",4.90917403183512,798,146,652,122.862253734808,675.137746265192
"1960","satisfied",4.9068081299882,125,14,111,7.46540917410924,117.534590825891
"1970","aside",4.89796579766114,41,11,30,5.61076356556702,35.389236434433
"1970","oh wont",4.89796579766114,41,11,30,5.61076356556702,35.389236434433
"1970","stoppin",4.89796579766114,41,11,30,5.61076356556702,35.389236434433
"1990","cause wanna",4.89166669485373,31,12,19,6.57648557381548,24.4235144261845
"1990","eternity",4.89166669485373,31,12,19,6.57648557381548,24.4235144261845
"1990","lights go",4.89166669485373,31,12,19,6.57648557381548,24.4235144261845
"1990","never stop",4.89166669485373,31,12,19,6.57648557381548,24.4235144261845
"1990","sleep night",4.89166669485373,31,12,19,6.57648557381548,24.4235144261845
"1970","hurting",4.89072304523309,62,15,47,8.48456929427207,53.5154307057279
"1970","love go",4.88960935071769,36,10,26,4.92652410635153,31.0734758936485
"2000","brought",4.88952871697191,103,38,65,27.7158257828836,75.2841742171164
"1990","know true",4.88913465354338,82,26,56,17.3958650662216,64.6041349337784
"1960","dont know dont know",4.88508886557641,57,8,49,3.40422658339381,53.5957734166062
"1980","come play",4.8799608123714,34,11,23,5.72001473988165,28.2799852601184
"1980","every woman",4.8799608123714,34,11,23,5.72001473988165,28.2799852601184
"1980","heart mine",4.8799608123714,34,11,23,5.72001473988165,28.2799852601184
"1980","love first",4.8799608123714,34,11,23,5.72001473988165,28.2799852601184
"2010","girl youre",4.87641393076895,132,30,102,20.3230795651562,111.676920434844
"1990","can change",4.87151601973743,45,16,29,9.54651131682892,35.4534886831711
"1990","matter say",4.87151601973743,45,16,29,9.54651131682892,35.4534886831711
"2010","live forever",4.8673673102749,28,9,19,4.31095627139678,23.6890437286032
"2010","look look",4.8673673102749,28,9,19,4.31095627139678,23.6890437286032
"2010","make world",4.8673673102749,28,9,19,4.31095627139678,23.6890437286032
"2010","smoking",4.8673673102749,28,9,19,4.31095627139678,23.6890437286032
"2010","youll understand",4.8673673102749,28,9,19,4.31095627139678,23.6890437286032
"1990","fact",4.86598591676161,117,35,82,24.8209294237552,92.1790705762448
"1980","cross",4.86570329419257,136,33,103,22.8800589595266,113.119941040473
"1970","things",4.86518571392574,1560,244,1316,213.482711275233,1346.51728872477
"2000","already gone",4.86136878269502,28,13,15,7.53439924194894,20.4656007580511
"2000","around now",4.86136878269502,28,13,15,7.53439924194894,20.4656007580511
"2000","keep makin",4.86136878269502,28,13,15,7.53439924194894,20.4656007580511
"2000","life away",4.86136878269502,28,13,15,7.53439924194894,20.4656007580511
"2000","parents",4.86136878269502,28,13,15,7.53439924194894,20.4656007580511
"2000","quarter",4.86136878269502,28,13,15,7.53439924194894,20.4656007580511
"2000","rock night",4.86136878269502,28,13,15,7.53439924194894,20.4656007580511
"2000","smoking",4.86136878269502,28,13,15,7.53439924194894,20.4656007580511
"2000","thats get",4.86136878269502,28,13,15,7.53439924194894,20.4656007580511
"2000","womans",4.86136878269502,28,13,15,7.53439924194894,20.4656007580511
"1990","soft",4.85777095512806,67,22,45,14.2136946272786,52.7863053727214
"1970","lot",4.85265078092671,410,72,338,56.1076356556702,353.89236434433
"2000","go now",4.84638392837824,100,37,63,26.9085687212462,73.0914312787538
"1990","dream just",4.84598719423338,18,8,10,3.81860452673157,14.1813954732684
"1990","enough make",4.84598719423338,18,8,10,3.81860452673157,14.1813954732684
"1990","get another",4.84598719423338,18,8,10,3.81860452673157,14.1813954732684
"1990","hear music",4.84598719423338,18,8,10,3.81860452673157,14.1813954732684
"1990","ill sing",4.84598719423338,18,8,10,3.81860452673157,14.1813954732684
"1990","large",4.84598719423338,18,8,10,3.81860452673157,14.1813954732684
"1990","let go cant",4.84598719423338,18,8,10,3.81860452673157,14.1813954732684
"1990","let slip away",4.84598719423338,18,8,10,3.81860452673157,14.1813954732684
"1990","night make",4.84598719423338,18,8,10,3.81860452673157,14.1813954732684
"1990","night see",4.84598719423338,18,8,10,3.81860452673157,14.1813954732684
"1990","nothin good",4.84598719423338,18,8,10,3.81860452673157,14.1813954732684
"1990","original",4.84598719423338,18,8,10,3.81860452673157,14.1813954732684
"1990","roll let",4.84598719423338,18,8,10,3.81860452673157,14.1813954732684
"1990","tips",4.84598719423338,18,8,10,3.81860452673157,14.1813954732684
"1990","touch dont",4.84598719423338,18,8,10,3.81860452673157,14.1813954732684
"1990","dont wanna",4.84560330277092,771,189,582,163.563560561669,607.436439438331
"1980","walls",4.83608819080152,107,27,80,18.0012228578628,88.9987771421372
"1980","will come",4.83608819080152,107,27,80,18.0012228578628,88.9987771421372
"1960","baby say",4.83482225499084,37,6,31,2.20976111553634,34.7902388844637
"1960","just look",4.83482225499084,37,6,31,2.20976111553634,34.7902388844637
"1960","love baby baby",4.83482225499084,37,6,31,2.20976111553634,34.7902388844637
"1980","better now",4.83480195994907,22,8,14,3.70118600815871,18.2988139918413
"1980","didnt care",4.83480195994907,22,8,14,3.70118600815871,18.2988139918413
"1980","feel need",4.83480195994907,22,8,14,3.70118600815871,18.2988139918413
"1980","find words",4.83480195994907,22,8,14,3.70118600815871,18.2988139918413
"1980","im dreaming",4.83480195994907,22,8,14,3.70118600815871,18.2988139918413
"1980","love loves",4.83480195994907,22,8,14,3.70118600815871,18.2988139918413
"1980","love til",4.83480195994907,22,8,14,3.70118600815871,18.2988139918413
"1980","oh hes",4.83480195994907,22,8,14,3.70118600815871,18.2988139918413
"1990","theres one",4.83459900344587,129,38,91,27.3666657749096,101.63333422509
"1960","fade",4.83411241013462,150,16,134,8.95849100893109,141.041508991069
"1970","walking",4.83287236609068,227,43,184,31.0644714483832,195.935528551617
"1990","baby can make",4.83159813958014,12,6,6,2.54573635115438,9.45426364884562
"1990","baby way",4.83159813958014,12,6,6,2.54573635115438,9.45426364884562
"1990","breathe without",4.83159813958014,12,6,6,2.54573635115438,9.45426364884562
"1990","bumped",4.83159813958014,12,6,6,2.54573635115438,9.45426364884562
"1990","cant wait till",4.83159813958014,12,6,6,2.54573635115438,9.45426364884562
"1990","cause will",4.83159813958014,12,6,6,2.54573635115438,9.45426364884562
"1990","come undone",4.83159813958014,12,6,6,2.54573635115438,9.45426364884562
"1990","day found",4.83159813958014,12,6,6,2.54573635115438,9.45426364884562
"1990","daze",4.83159813958014,12,6,6,2.54573635115438,9.45426364884562
"1990","doesnt know",4.83159813958014,12,6,6,2.54573635115438,9.45426364884562
"1990","dont know hes",4.83159813958014,12,6,6,2.54573635115438,9.45426364884562
"1990","dough can",4.83159813958014,12,6,6,2.54573635115438,9.45426364884562
"1990","end day",4.83159813958014,12,6,6,2.54573635115438,9.45426364884562
"1990","february",4.83159813958014,12,6,6,2.54573635115438,9.45426364884562
"1990","girl think",4.83159813958014,12,6,6,2.54573635115438,9.45426364884562
"1990","girlyou",4.83159813958014,12,6,6,2.54573635115438,9.45426364884562
"1990","god made",4.83159813958014,12,6,6,2.54573635115438,9.45426364884562
"1990","got stop",4.83159813958014,12,6,6,2.54573635115438,9.45426364884562
"1990","hear love",4.83159813958014,12,6,6,2.54573635115438,9.45426364884562
"1990","heart see",4.83159813958014,12,6,6,2.54573635115438,9.45426364884562
"1990","ill hear",4.83159813958014,12,6,6,2.54573635115438,9.45426364884562
"1990","im falling apart",4.83159813958014,12,6,6,2.54573635115438,9.45426364884562
"1990","life want",4.83159813958014,12,6,6,2.54573635115438,9.45426364884562
"1990","little bit just",4.83159813958014,12,6,6,2.54573635115438,9.45426364884562
"1990","living lie",4.83159813958014,12,6,6,2.54573635115438,9.45426364884562
"1990","love love like",4.83159813958014,12,6,6,2.54573635115438,9.45426364884562
"1990","love will make",4.83159813958014,12,6,6,2.54573635115438,9.45426364884562
"1990","many tears",4.83159813958014,12,6,6,2.54573635115438,9.45426364884562
"1990","mysterious",4.83159813958014,12,6,6,2.54573635115438,9.45426364884562
"1990","never keep",4.83159813958014,12,6,6,2.54573635115438,9.45426364884562
"1990","night feel",4.83159813958014,12,6,6,2.54573635115438,9.45426364884562
"1990","peepin",4.83159813958014,12,6,6,2.54573635115438,9.45426364884562
"1990","place one",4.83159813958014,12,6,6,2.54573635115438,9.45426364884562
"1990","rock world",4.83159813958014,12,6,6,2.54573635115438,9.45426364884562
"1990","said much",4.83159813958014,12,6,6,2.54573635115438,9.45426364884562
"1990","say live",4.83159813958014,12,6,6,2.54573635115438,9.45426364884562
"1990","show life",4.83159813958014,12,6,6,2.54573635115438,9.45426364884562
"1990","stay can",4.83159813958014,12,6,6,2.54573635115438,9.45426364884562
"1990","take two",4.83159813958014,12,6,6,2.54573635115438,9.45426364884562
"1990","tears ive",4.83159813958014,12,6,6,2.54573635115438,9.45426364884562
"1990","thats price",4.83159813958014,12,6,6,2.54573635115438,9.45426364884562
"1990","time show",4.83159813958014,12,6,6,2.54573635115438,9.45426364884562
"1990","truei",4.83159813958014,12,6,6,2.54573635115438,9.45426364884562
"1990","wanna fall love",4.83159813958014,12,6,6,2.54573635115438,9.45426364884562
"1990","wave hands",4.83159813958014,12,6,6,2.54573635115438,9.45426364884562
"1990","will follow",4.83159813958014,12,6,6,2.54573635115438,9.45426364884562
"1990","wont love",4.83159813958014,12,6,6,2.54573635115438,9.45426364884562
"1990","yeah youve got",4.83159813958014,12,6,6,2.54573635115438,9.45426364884562
"1970","youre",4.82913963167859,6592,964,5628,902.101303029702,5689.8986969703
"1980","crush",4.82776998831566,74,20,54,12.4494438456248,61.5505561543752
"1980","cant love",4.8251809408249,30,10,20,5.04707182930734,24.9529281706927
"1980","every now",4.8251809408249,30,10,20,5.04707182930734,24.9529281706927
"1980","will last",4.8251809408249,30,10,20,5.04707182930734,24.9529281706927
"2000","uhhuh",4.82452181195382,63,25,38,16.9523982943851,46.0476017056149
"2000","askin",4.82398564773451,54,22,32,14.530627109473,39.469372890527
"2010","everything want",4.82375177851709,37,11,26,5.69662078720288,31.3033792127971
"2010","glad came",4.82375177851709,37,11,26,5.69662078720288,31.3033792127971
"2000","couldnt",4.82368133247432,508,159,349,136.695529103931,371.304470896069
"1990","tell whats",4.8203337689609,56,19,37,11.8801029720538,44.1198970279462
"2000","get just",4.81847091191285,60,24,36,16.1451412327477,43.8548587672523
"2000","sold",4.81847091191285,60,24,36,16.1451412327477,43.8548587672523
"1960","make happy",4.81817735456583,47,7,40,2.80699384946508,44.1930061505349
"2000","gotta let",4.81798902487683,57,23,34,15.3378841711103,41.6621158288897
"2000","shows",4.81798902487683,57,23,34,15.3378841711103,41.6621158288897
"2010","youre never gonna",4.81676700508077,51,14,37,7.85209892290127,43.1479010770987
"1980","time can",4.81373522719007,47,14,33,7.90707919924816,39.0929208007518
"1970","carry",4.811649928633,221,42,179,30.2433840973246,190.756615902675
"1980","get wrong",4.80429163790824,26,9,17,4.37412891873303,21.625871081267
"1980","just im",4.80429163790824,26,9,17,4.37412891873303,21.625871081267
"1980","just touch",4.80429163790824,26,9,17,4.37412891873303,21.625871081267
"1980","like yesterday",4.80429163790824,26,9,17,4.37412891873303,21.625871081267
"1980","satisfaction",4.80429163790824,26,9,17,4.37412891873303,21.625871081267
"1980","since youve gone",4.80429163790824,26,9,17,4.37412891873303,21.625871081267
"1980","whats love",4.80429163790824,26,9,17,4.37412891873303,21.625871081267
"2000","still",4.80093094949265,1843,538,1305,495.924921532568,1347.07507846743
"2000","aint true",4.80014394535121,10,6,4,2.69085687212462,7.30914312787538
"2000","alone theres",4.80014394535121,10,6,4,2.69085687212462,7.30914312787538
"2000","away got",4.80014394535121,10,6,4,2.69085687212462,7.30914312787538
"2000","better worse",4.80014394535121,10,6,4,2.69085687212462,7.30914312787538
"2000","came around",4.80014394535121,10,6,4,2.69085687212462,7.30914312787538
"2000","cant play",4.80014394535121,10,6,4,2.69085687212462,7.30914312787538
"2000","coldest",4.80014394535121,10,6,4,2.69085687212462,7.30914312787538
"2000","control just",4.80014394535121,10,6,4,2.69085687212462,7.30914312787538
"2000","crumbles",4.80014394535121,10,6,4,2.69085687212462,7.30914312787538
"2000","cry oh",4.80014394535121,10,6,4,2.69085687212462,7.30914312787538
"2000","day comes",4.80014394535121,10,6,4,2.69085687212462,7.30914312787538
"2000","dont get caught",4.80014394535121,10,6,4,2.69085687212462,7.30914312787538
"2000","dont try tell",4.80014394535121,10,6,4,2.69085687212462,7.30914312787538
"2000","else like",4.80014394535121,10,6,4,2.69085687212462,7.30914312787538
"2000","every memory",4.80014394535121,10,6,4,2.69085687212462,7.30914312787538
"2000","every wish",4.80014394535121,10,6,4,2.69085687212462,7.30914312787538
"2000","everytime see",4.80014394535121,10,6,4,2.69085687212462,7.30914312787538
"2000","fall dont",4.80014394535121,10,6,4,2.69085687212462,7.30914312787538
"2000","feel beat",4.80014394535121,10,6,4,2.69085687212462,7.30914312787538
"2000","feeling got",4.80014394535121,10,6,4,2.69085687212462,7.30914312787538
"2000","focus",4.80014394535121,10,6,4,2.69085687212462,7.30914312787538
"2000","follow cause",4.80014394535121,10,6,4,2.69085687212462,7.30914312787538
"2000","get back right",4.80014394535121,10,6,4,2.69085687212462,7.30914312787538
"2000","go baby dont",4.80014394535121,10,6,4,2.69085687212462,7.30914312787538
"2000","good friends",4.80014394535121,10,6,4,2.69085687212462,7.30914312787538
"2000","got niggas",4.80014394535121,10,6,4,2.69085687212462,7.30914312787538
"2000","heart youll",4.80014394535121,10,6,4,2.69085687212462,7.30914312787538
"2000","hes everything",4.80014394535121,10,6,4,2.69085687212462,7.30914312787538
"2000","home yeah yeah",4.80014394535121,10,6,4,2.69085687212462,7.30914312787538
"2000","hope dont",4.80014394535121,10,6,4,2.69085687212462,7.30914312787538
"2000","ill start",4.80014394535121,10,6,4,2.69085687212462,7.30914312787538
"2000","im better",4.80014394535121,10,6,4,2.69085687212462,7.30914312787538
"2000","im crazy im",4.80014394535121,10,6,4,2.69085687212462,7.30914312787538
"2000","im half",4.80014394535121,10,6,4,2.69085687212462,7.30914312787538
"2000","im lady",4.80014394535121,10,6,4,2.69085687212462,7.30914312787538
"2000","im trying get",4.80014394535121,10,6,4,2.69085687212462,7.30914312787538
"2000","interstate",4.80014394535121,10,6,4,2.69085687212462,7.30914312787538
"2000","jah",4.80014394535121,10,6,4,2.69085687212462,7.30914312787538
"2000","keep talking",4.80014394535121,10,6,4,2.69085687212462,7.30914312787538
"2000","kiss now",4.80014394535121,10,6,4,2.69085687212462,7.30914312787538
"2000","know feelin",4.80014394535121,10,6,4,2.69085687212462,7.30914312787538
"2000","know want baby",4.80014394535121,10,6,4,2.69085687212462,7.30914312787538
"2000","let now",4.80014394535121,10,6,4,2.69085687212462,7.30914312787538
"2000","licked",4.80014394535121,10,6,4,2.69085687212462,7.30914312787538
"2000","maintain",4.80014394535121,10,6,4,2.69085687212462,7.30914312787538
"2000","makes man",4.80014394535121,10,6,4,2.69085687212462,7.30914312787538
"2000","mind ease",4.80014394535121,10,6,4,2.69085687212462,7.30914312787538
"2000","mind shes",4.80014394535121,10,6,4,2.69085687212462,7.30914312787538
"2000","move cause",4.80014394535121,10,6,4,2.69085687212462,7.30914312787538
"2000","need go",4.80014394535121,10,6,4,2.69085687212462,7.30914312787538
"2000","never meant hurt",4.80014394535121,10,6,4,2.69085687212462,7.30914312787538
"2000","nigga thats",4.80014394535121,10,6,4,2.69085687212462,7.30914312787538
"2000","niggas like",4.80014394535121,10,6,4,2.69085687212462,7.30914312787538
"2000","now going",4.80014394535121,10,6,4,2.69085687212462,7.30914312787538
"2000","one place",4.80014394535121,10,6,4,2.69085687212462,7.30914312787538
"2000","rag",4.80014394535121,10,6,4,2.69085687212462,7.30914312787538
"2000","right gonna",4.80014394535121,10,6,4,2.69085687212462,7.30914312787538
"2000","right spot",4.80014394535121,10,6,4,2.69085687212462,7.30914312787538
"2000","said whats",4.80014394535121,10,6,4,2.69085687212462,7.30914312787538
"2000","sand can",4.80014394535121,10,6,4,2.69085687212462,7.30914312787538
"2000","selection",4.80014394535121,10,6,4,2.69085687212462,7.30914312787538
"2000","sheet",4.80014394535121,10,6,4,2.69085687212462,7.30914312787538
"2000","shes fire",4.80014394535121,10,6,4,2.69085687212462,7.30914312787538
"2000","spend baby",4.80014394535121,10,6,4,2.69085687212462,7.30914312787538
"2000","spinning round",4.80014394535121,10,6,4,2.69085687212462,7.30914312787538
"2000","star one",4.80014394535121,10,6,4,2.69085687212462,7.30914312787538
"2000","substitute",4.80014394535121,10,6,4,2.69085687212462,7.30914312787538
"2000","sweet honey",4.80014394535121,10,6,4,2.69085687212462,7.30914312787538
"2000","tell make",4.80014394535121,10,6,4,2.69085687212462,7.30914312787538
"2000","thats told",4.80014394535121,10,6,4,2.69085687212462,7.30914312787538
"2000","time every time",4.80014394535121,10,6,4,2.69085687212462,7.30914312787538
"2000","tired im",4.80014394535121,10,6,4,2.69085687212462,7.30914312787538
"2000","tonightyou",4.80014394535121,10,6,4,2.69085687212462,7.30914312787538
"2000","tote",4.80014394535121,10,6,4,2.69085687212462,7.30914312787538
"2000","treat way",4.80014394535121,10,6,4,2.69085687212462,7.30914312787538
"2000","unspoken",4.80014394535121,10,6,4,2.69085687212462,7.30914312787538
"2000","us two",4.80014394535121,10,6,4,2.69085687212462,7.30914312787538
"2000","wakin",4.80014394535121,10,6,4,2.69085687212462,7.30914312787538
"2000","wants love",4.80014394535121,10,6,4,2.69085687212462,7.30914312787538
"2000","wish take",4.80014394535121,10,6,4,2.69085687212462,7.30914312787538
"2000","without go",4.80014394535121,10,6,4,2.69085687212462,7.30914312787538
"2000","worth time",4.80014394535121,10,6,4,2.69085687212462,7.30914312787538
"2000","ya man",4.80014394535121,10,6,4,2.69085687212462,7.30914312787538
"2000","yeah cmon",4.80014394535121,10,6,4,2.69085687212462,7.30914312787538
"2000","youit",4.80014394535121,10,6,4,2.69085687212462,7.30914312787538
"2000","youre holdin",4.80014394535121,10,6,4,2.69085687212462,7.30914312787538
"2000","find just",4.79780188864246,20,10,10,5.38171374424925,14.6182862557508
"2000","found found",4.79780188864246,20,10,10,5.38171374424925,14.6182862557508
"2000","get hurt",4.79780188864246,20,10,10,5.38171374424925,14.6182862557508
"2000","gonna spend",4.79780188864246,20,10,10,5.38171374424925,14.6182862557508
"2000","keep real",4.79780188864246,20,10,10,5.38171374424925,14.6182862557508
"2000","name one",4.79780188864246,20,10,10,5.38171374424925,14.6182862557508
"2000","nigga im",4.79780188864246,20,10,10,5.38171374424925,14.6182862557508
"2000","outta control",4.79780188864246,20,10,10,5.38171374424925,14.6182862557508
"2000","really good",4.79780188864246,20,10,10,5.38171374424925,14.6182862557508
"2000","request",4.79780188864246,20,10,10,5.38171374424925,14.6182862557508
"2000","right night",4.79780188864246,20,10,10,5.38171374424925,14.6182862557508
"2000","teddy",4.79780188864246,20,10,10,5.38171374424925,14.6182862557508
"2000","theres still",4.79780188864246,20,10,10,5.38171374424925,14.6182862557508
"2000","top top",4.79780188864246,20,10,10,5.38171374424925,14.6182862557508
"2000","two one",4.79780188864246,20,10,10,5.38171374424925,14.6182862557508
"2000","youre standing",4.79780188864246,20,10,10,5.38171374424925,14.6182862557508
"2010","rule",4.79596906584473,101,24,77,15.5502351218241,85.4497648781759
"1970","cant live",4.79595656897729,113,24,89,15.4638117782701,97.5361882217299
"1990","cause youve",4.79416793296338,15,7,8,3.18217043894297,11.817829561057
"1990","collide",4.79416793296338,15,7,8,3.18217043894297,11.817829561057
"1990","comin back",4.79416793296338,15,7,8,3.18217043894297,11.817829561057
"1990","echoes",4.79416793296338,15,7,8,3.18217043894297,11.817829561057
"1990","gonna one",4.79416793296338,15,7,8,3.18217043894297,11.817829561057
"1990","got mad",4.79416793296338,15,7,8,3.18217043894297,11.817829561057
"1990","hes gone",4.79416793296338,15,7,8,3.18217043894297,11.817829561057
"1990","huh yeah",4.79416793296338,15,7,8,3.18217043894297,11.817829561057
"1990","just cant wait",4.79416793296338,15,7,8,3.18217043894297,11.817829561057
"1990","know im sayin",4.79416793296338,15,7,8,3.18217043894297,11.817829561057
"1990","like everything",4.79416793296338,15,7,8,3.18217043894297,11.817829561057
"1990","love may",4.79416793296338,15,7,8,3.18217043894297,11.817829561057
"1990","need see",4.79416793296338,15,7,8,3.18217043894297,11.817829561057
"1990","oh baby cant",4.79416793296338,15,7,8,3.18217043894297,11.817829561057
"1990","play dont",4.79416793296338,15,7,8,3.18217043894297,11.817829561057
"1990","start know",4.79416793296338,15,7,8,3.18217043894297,11.817829561057
"1990","sure ill",4.79416793296338,15,7,8,3.18217043894297,11.817829561057
"1990","together one",4.79416793296338,15,7,8,3.18217043894297,11.817829561057
"1990","wouldnt want",4.79416793296338,15,7,8,3.18217043894297,11.817829561057
"1990","yeah time",4.79416793296338,15,7,8,3.18217043894297,11.817829561057
"1990","yeah youve",4.79416793296338,15,7,8,3.18217043894297,11.817829561057
"1990","yes love",4.79416793296338,15,7,8,3.18217043894297,11.817829561057
"1990","youevery",4.79416793296338,15,7,8,3.18217043894297,11.817829561057
"1990","live without",4.79160701296323,202,56,146,42.8532285777654,159.146771422235
"1980","doi",4.77830513350248,65,18,47,10.9353222968326,54.0646777031674
"1980","ohoh",4.77830513350248,65,18,47,10.9353222968326,54.0646777031674
"2000","fast",4.77648240529839,341,110,231,91.7582193394496,249.24178066055
"1980","point",4.76459904440345,117,29,88,19.6835801342986,97.3164198657014
"2000","smell",4.76330968006803,94,35,59,25.2940545979715,68.7059454020285
"1990","dough",4.75962122395991,94,29,65,19.941601417376,74.058398582624
"1960","yeah oh",4.75831569765561,214,21,193,12.780780506075,201.219219493925
"2010","love heart",4.75610130529981,56,15,41,8.62191254279355,47.3780874572064
"1970","squeeze",4.74855811741149,68,16,52,9.30565664533066,58.6943433546693
"1970","many",4.74446217369007,541,92,449,74.034709487116,466.965290512884
"1970","anything dont",4.73770410059725,22,7,15,3.01065362054815,18.9893463794518
"1970","buddy",4.73770410059725,22,7,15,3.01065362054815,18.9893463794518
"1970","decided",4.73770410059725,22,7,15,3.01065362054815,18.9893463794518
"1970","love man",4.73770410059725,22,7,15,3.01065362054815,18.9893463794518
"1970","silent",4.73770410059725,22,7,15,3.01065362054815,18.9893463794518
"1970","sweetness",4.73770410059725,22,7,15,3.01065362054815,18.9893463794518
"1970","venus",4.73770410059725,22,7,15,3.01065362054815,18.9893463794518
"1980","ooh yeah",4.73683465246246,79,21,58,13.2906224838427,65.7093775161573
"2010","come way",4.7341755325146,24,8,16,3.69510537548295,20.3048946245171
"2010","ever loved",4.7341755325146,24,8,16,3.69510537548295,20.3048946245171
"2010","home just",4.7341755325146,24,8,16,3.69510537548295,20.3048946245171
"2010","huh know",4.7341755325146,24,8,16,3.69510537548295,20.3048946245171
"2010","im little",4.7341755325146,24,8,16,3.69510537548295,20.3048946245171
"2010","move move move",4.7341755325146,24,8,16,3.69510537548295,20.3048946245171
"2010","youno",4.7341755325146,24,8,16,3.69510537548295,20.3048946245171
"2010","youre arms",4.7341755325146,24,8,16,3.69510537548295,20.3048946245171
"2000","alcohol",4.72957127614764,31,14,17,8.34165630358633,22.6583436964137
"2000","covers",4.72957127614764,31,14,17,8.34165630358633,22.6583436964137
"2000","drinkin",4.72957127614764,31,14,17,8.34165630358633,22.6583436964137
"2000","looking good",4.72957127614764,31,14,17,8.34165630358633,22.6583436964137
"2000","risk",4.72957127614764,31,14,17,8.34165630358633,22.6583436964137
"2000","say aint",4.72957127614764,31,14,17,8.34165630358633,22.6583436964137
"2000","thing baby",4.72957127614764,31,14,17,8.34165630358633,22.6583436964137
"2000","yeah uh",4.72957127614764,31,14,17,8.34165630358633,22.6583436964137
"2000","dead",4.72797916643368,204,69,135,54.8934801913423,149.106519808658
"2000","sayin",4.72133343735925,181,62,119,48.7045093854557,132.295490614544
"1990","nights",4.71849503996846,387,100,287,82.0999973247287,304.900002675271
"1970","anybody",4.71678697650533,131,27,104,17.9270738314458,113.072926168554
"1970","simple",4.71678697650533,131,27,104,17.9270738314458,113.072926168554
"2010","changing",4.71655131342962,61,16,45,9.39172616268583,51.6082738373142
"2010","mall",4.71655131342962,61,16,45,9.39172616268583,51.6082738373142
"1990","go right",4.71472351031187,49,17,32,10.3950901005471,38.604909899453
"1990","boots",4.71303459180446,60,20,40,12.7286817557719,47.2713182442281
"1960","kissing",4.70861761737317,58,8,50,3.46394985678669,54.5360501432133
"1970","wrapped",4.70698058953402,52,13,39,7.11609037584109,44.8839096241589
"1960","sweet love",4.70057447738424,103,12,91,6.15149715946602,96.848502840534
"1960","shadows",4.69879209332353,80,10,70,4.77786187142992,75.2221381285701
"1960","youll find",4.69879209332353,80,10,70,4.77786187142992,75.2221381285701
"2010","deny",4.69735476960881,133,30,103,20.4770422891347,112.522957710865
"1990","hype",4.69719296000103,28,11,17,5.94005148602689,22.0599485139731
"1990","love gave",4.69719296000103,28,11,17,5.94005148602689,22.0599485139731
"1990","see things",4.69719296000103,28,11,17,5.94005148602689,22.0599485139731
"1990","slap",4.69719296000103,28,11,17,5.94005148602689,22.0599485139731
"1990","souls",4.69719296000103,28,11,17,5.94005148602689,22.0599485139731
"1990","will turn",4.69719296000103,28,11,17,5.94005148602689,22.0599485139731
"1990","world love",4.69719296000103,28,11,17,5.94005148602689,22.0599485139731
"2010","just cant get",4.69354090359123,66,17,49,10.1615397825781,55.8384602174219
"1980","love real",4.69180623255188,43,13,30,7.23413628867385,35.7658637113261
"1980","well can",4.69180623255188,43,13,30,7.23413628867385,35.7658637113261
"2010","take back",4.68463072977743,76,19,57,11.7011670223627,64.2988329776373
"2010","written",4.68373190600152,71,18,53,10.9313534024704,60.0686465975296
"2010","crystal",4.68194028110171,42,12,30,6.46643440709516,35.5335655929048
"2010","give something",4.68194028110171,42,12,30,6.46643440709516,35.5335655929048
"2010","tearing",4.68194028110171,42,12,30,6.46643440709516,35.5335655929048
"1990","past",4.68111126988225,215,59,156,45.6111096248493,169.388890375151
"1980","feel good",4.68060639319336,137,33,104,23.0482946871702,113.95170531283
"1960","holds",4.67902198699188,69,9,60,4.1209058641083,64.8790941358917
"1960","lived",4.67902198699188,69,9,60,4.1209058641083,64.8790941358917
"1990","everybody",4.6779850671362,1033,248,785,219.145470895206,813.854529104794
"1970","glory",4.67572697365677,85,19,66,11.6320708066633,73.3679291933367
"1970","whoa whoa whoa",4.67572697365677,85,19,66,11.6320708066633,73.3679291933367
"1970","without love",4.67572697365677,85,19,66,11.6320708066633,73.3679291933367
"1980","book",4.66538215727552,70,19,51,11.7765009350505,58.2234990649496
"2000","baby got need",4.66433391887376,15,8,7,4.03628530818693,10.9637146918131
"2000","banks",4.66433391887376,15,8,7,4.03628530818693,10.9637146918131
"2000","breathe just",4.66433391887376,15,8,7,4.03628530818693,10.9637146918131
"2000","can hit",4.66433391887376,15,8,7,4.03628530818693,10.9637146918131
"2000","envy",4.66433391887376,15,8,7,4.03628530818693,10.9637146918131
"2000","face know",4.66433391887376,15,8,7,4.03628530818693,10.9637146918131
"2000","friends got",4.66433391887376,15,8,7,4.03628530818693,10.9637146918131
"2000","get im gonna",4.66433391887376,15,8,7,4.03628530818693,10.9637146918131
"2000","got need got",4.66433391887376,15,8,7,4.03628530818693,10.9637146918131
"2000","im even",4.66433391887376,15,8,7,4.03628530818693,10.9637146918131
"2000","im let",4.66433391887376,15,8,7,4.03628530818693,10.9637146918131
"2000","im sitting",4.66433391887376,15,8,7,4.03628530818693,10.9637146918131
"2000","ive become",4.66433391887376,15,8,7,4.03628530818693,10.9637146918131
"2000","know nothing",4.66433391887376,15,8,7,4.03628530818693,10.9637146918131
"2000","link",4.66433391887376,15,8,7,4.03628530818693,10.9637146918131
"2000","long oh",4.66433391887376,15,8,7,4.03628530818693,10.9637146918131
"2000","love free",4.66433391887376,15,8,7,4.03628530818693,10.9637146918131
"2000","playboy",4.66433391887376,15,8,7,4.03628530818693,10.9637146918131
"2000","rid",4.66433391887376,15,8,7,4.03628530818693,10.9637146918131
"2000","say oh oh",4.66433391887376,15,8,7,4.03628530818693,10.9637146918131
"2000","set mind",4.66433391887376,15,8,7,4.03628530818693,10.9637146918131
"2000","still mine",4.66433391887376,15,8,7,4.03628530818693,10.9637146918131
"2000","still think",4.66433391887376,15,8,7,4.03628530818693,10.9637146918131
"2000","stripes",4.66433391887376,15,8,7,4.03628530818693,10.9637146918131
"2000","take cant",4.66433391887376,15,8,7,4.03628530818693,10.9637146918131
"2000","time every",4.66433391887376,15,8,7,4.03628530818693,10.9637146918131
"2000","try cause",4.66433391887376,15,8,7,4.03628530818693,10.9637146918131
"2000","turn around now",4.66433391887376,15,8,7,4.03628530818693,10.9637146918131
"2000","walk talk",4.66433391887376,15,8,7,4.03628530818693,10.9637146918131
"2000","want know oh",4.66433391887376,15,8,7,4.03628530818693,10.9637146918131
"2000","youtheres",4.66433391887376,15,8,7,4.03628530818693,10.9637146918131
"2000","pack",4.64841206910469,85,32,53,22.8722834130593,62.1277165869407
"2010","everything ive",4.64374938023631,20,7,13,3.07925447956913,16.9207455204309
"2010","fence",4.64374938023631,20,7,13,3.07925447956913,16.9207455204309
"2010","get night",4.64374938023631,20,7,13,3.07925447956913,16.9207455204309
"2010","listenin",4.64374938023631,20,7,13,3.07925447956913,16.9207455204309
"2010","mmmm",4.64374938023631,20,7,13,3.07925447956913,16.9207455204309
"2010","paralyzed",4.64374938023631,20,7,13,3.07925447956913,16.9207455204309
"2010","run hide",4.64374938023631,20,7,13,3.07925447956913,16.9207455204309
"2010","see everything",4.64374938023631,20,7,13,3.07925447956913,16.9207455204309
"2010","taller",4.64374938023631,20,7,13,3.07925447956913,16.9207455204309
"2010","top top",4.64374938023631,20,7,13,3.07925447956913,16.9207455204309
"2010","top world",4.64374938023631,20,7,13,3.07925447956913,16.9207455204309
"2010","way yeah",4.64374938023631,20,7,13,3.07925447956913,16.9207455204309
"1990","tearing",4.64285497031576,42,15,27,8.91007722904033,33.0899227709597
"2010","come come come",4.64245556417696,144,32,112,22.1706322528977,121.829367747102
"1960","waiting",4.64152214270528,686,55,631,40.9701655475115,645.029834452488
"1970","sun comes",4.63616244855001,63,15,48,8.62141718611517,54.3785828138848
"1980","love oh",4.63430208223362,228,51,177,38.3577459027358,189.642254097264
"2000","blast",4.63087759622813,34,15,19,9.14891336522372,24.8510866347763
"2000","home baby",4.63087759622813,34,15,19,9.14891336522372,24.8510866347763
"2000","need know need",4.63087759622813,34,15,19,9.14891336522372,24.8510866347763
"2000","nowi",4.63087759622813,34,15,19,9.14891336522372,24.8510866347763
"2000","sexual",4.63087759622813,34,15,19,9.14891336522372,24.8510866347763
"2000","time one",4.63087759622813,34,15,19,9.14891336522372,24.8510866347763
"2010","ass like",4.62665740229857,33,10,23,5.08076989128906,27.9192301087109
"2010","said said",4.62665740229857,33,10,23,5.08076989128906,27.9192301087109
"2010","baby believe",4.62635065152216,16,6,10,2.4634035836553,13.5365964163447
"2010","basement",4.62635065152216,16,6,10,2.4634035836553,13.5365964163447
"2010","buying",4.62635065152216,16,6,10,2.4634035836553,13.5365964163447
"2010","can really",4.62635065152216,16,6,10,2.4634035836553,13.5365964163447
"2010","cause might",4.62635065152216,16,6,10,2.4634035836553,13.5365964163447
"2010","di di",4.62635065152216,16,6,10,2.4634035836553,13.5365964163447
"2010","feel youre",4.62635065152216,16,6,10,2.4634035836553,13.5365964163447
"2010","get along",4.62635065152216,16,6,10,2.4634035836553,13.5365964163447
"2010","hard go",4.62635065152216,16,6,10,2.4634035836553,13.5365964163447
"2010","head spinning",4.62635065152216,16,6,10,2.4634035836553,13.5365964163447
"2010","heart break heart",4.62635065152216,16,6,10,2.4634035836553,13.5365964163447
"2010","hey hey baby",4.62635065152216,16,6,10,2.4634035836553,13.5365964163447
"2010","hope youre",4.62635065152216,16,6,10,2.4634035836553,13.5365964163447
"2010","im gonna need",4.62635065152216,16,6,10,2.4634035836553,13.5365964163447
"2010","ima make",4.62635065152216,16,6,10,2.4634035836553,13.5365964163447
"2010","keep em",4.62635065152216,16,6,10,2.4634035836553,13.5365964163447
"2010","lets keep",4.62635065152216,16,6,10,2.4634035836553,13.5365964163447
"2010","name cause",4.62635065152216,16,6,10,2.4634035836553,13.5365964163447
"2010","nothing wouldnt",4.62635065152216,16,6,10,2.4634035836553,13.5365964163447
"2010","oh babe",4.62635065152216,16,6,10,2.4634035836553,13.5365964163447
"2010","one touch",4.62635065152216,16,6,10,2.4634035836553,13.5365964163447
"2010","remember ill",4.62635065152216,16,6,10,2.4634035836553,13.5365964163447
"2010","say whatcha",4.62635065152216,16,6,10,2.4634035836553,13.5365964163447
"2010","tangled",4.62635065152216,16,6,10,2.4634035836553,13.5365964163447
"2010","think found",4.62635065152216,16,6,10,2.4634035836553,13.5365964163447
"2010","tub",4.62635065152216,16,6,10,2.4634035836553,13.5365964163447
"1990","compare",4.62423790708468,35,13,22,7.42506435753361,27.5749356424664
"1990","gotta say",4.62423790708468,35,13,22,7.42506435753361,27.5749356424664
"1990","im lonely",4.62423790708468,35,13,22,7.42506435753361,27.5749356424664
"1990","love call",4.62423790708468,35,13,22,7.42506435753361,27.5749356424664
"1990","roll roll",4.62423790708468,35,13,22,7.42506435753361,27.5749356424664
"1990","want dont want",4.62423790708468,35,13,22,7.42506435753361,27.5749356424664
"1990","feelin like",4.62247085105588,64,21,43,13.57726053949,50.42273946051
"2000","air",4.61579545468287,417,132,285,112.208731567597,304.791268432403
"1990","rich",4.61507247926054,134,39,95,28.4273892545572,105.572610745443
"1960","gonna fall",4.60925286663104,38,6,32,2.26948438892921,35.7305156110708
"1960","magic magic",4.60925286663104,38,6,32,2.26948438892921,35.7305156110708
"1960","nobody nobody",4.60925286663104,38,6,32,2.26948438892921,35.7305156110708
"1960","shape",4.60925286663104,38,6,32,2.26948438892921,35.7305156110708
"1960","wo wo",4.60925286663104,38,6,32,2.26948438892921,35.7305156110708
"1970","repeat",4.60615069736532,91,20,71,12.4531581577219,78.5468418422781
"1970","along way",4.59896432305208,27,8,19,3.69489307976364,23.3051069202364
"1970","find one",4.59896432305208,27,8,19,3.69489307976364,23.3051069202364
"1970","flew",4.59896432305208,27,8,19,3.69489307976364,23.3051069202364
"1970","love dont love",4.59896432305208,27,8,19,3.69489307976364,23.3051069202364
"1970","short",4.58787098562027,120,25,95,16.4217470211718,103.578252978828
"1970","mind",4.58748918592373,1930,297,1633,264.116431257179,1665.88356874282
"1990","cant make",4.58518439993714,53,18,35,11.2436688842652,41.7563311157348
"1990","long youre",4.58518439993714,53,18,35,11.2436688842652,41.7563311157348
"1980","kids",4.58424608942008,213,48,165,35.8342099880821,177.165790011918
"2010","fuck dont",4.58353451617156,47,13,34,7.23624802698745,39.7637519730126
"2010","ill find",4.58353451617156,47,13,34,7.23624802698745,39.7637519730126
"2000","jesus",4.57998247823654,79,30,49,21.2577692897845,57.7422307102155
"2000","late night",4.57998247823654,79,30,49,21.2577692897845,57.7422307102155
"1980","night love",4.57961643605066,39,12,27,6.56119337809954,32.4388066219005
"1960","quite",4.57726913630988,104,12,92,6.21122043285889,97.7887795671411
"1970","got say",4.57631980660784,42,11,31,5.74761145741011,36.2523885425899
"1970","still want",4.57631980660784,42,11,31,5.74761145741011,36.2523885425899
"2010","york",4.56203458484505,177,38,139,27.2514021441868,149.748597855813
"2000","around get",4.56169777642349,23,11,12,6.18897080588663,16.8110291941134
"2000","arrive",4.56169777642349,23,11,12,6.18897080588663,16.8110291941134
"2000","beatin",4.56169777642349,23,11,12,6.18897080588663,16.8110291941134
"2000","id like know",4.56169777642349,23,11,12,6.18897080588663,16.8110291941134
"2000","impress",4.56169777642349,23,11,12,6.18897080588663,16.8110291941134
"2000","look right",4.56169777642349,23,11,12,6.18897080588663,16.8110291941134
"2000","need got",4.56169777642349,23,11,12,6.18897080588663,16.8110291941134
"2000","sorry im",4.56169777642349,23,11,12,6.18897080588663,16.8110291941134
"2000","swore",4.56169777642349,23,11,12,6.18897080588663,16.8110291941134
"2000","think cant",4.56169777642349,23,11,12,6.18897080588663,16.8110291941134
"2000","want shit",4.56169777642349,23,11,12,6.18897080588663,16.8110291941134
"2000","way see",4.56169777642349,23,11,12,6.18897080588663,16.8110291941134
"2000","wont need",4.56169777642349,23,11,12,6.18897080588663,16.8110291941134
"2000","worldwide",4.56169777642349,23,11,12,6.18897080588663,16.8110291941134
"2000","finish",4.55734899076818,37,16,21,9.9561704268611,27.0438295731389
"2000","make good",4.55734899076818,37,16,21,9.9561704268611,27.0438295731389
"2000","planet",4.55734899076818,37,16,21,9.9561704268611,27.0438295731389
"2000","spend time",4.55734899076818,37,16,21,9.9561704268611,27.0438295731389
"2000","thing thing",4.55734899076818,37,16,21,9.9561704268611,27.0438295731389
"2000","wanna let",4.55734899076818,37,16,21,9.9561704268611,27.0438295731389
"2000","woop",4.55734899076818,37,16,21,9.9561704268611,27.0438295731389
"2010","beating",4.55289187386817,97,23,74,14.9343842259103,82.0656157740897
"2010","can call",4.55289187386817,97,23,74,14.9343842259103,82.0656157740897
"2000","way can",4.54878902824593,76,29,47,20.4505122281471,55.5494877718529
"1990","go wrong",4.54580010775758,68,22,46,14.4258393232082,53.5741606767919
"1990","wanna wanna",4.54580010775758,68,22,46,14.4258393232082,53.5741606767919
"1970","dream come true",4.54517304125535,32,9,23,4.37913253897913,27.6208674610209
"1970","say now",4.54517304125535,32,9,23,4.37913253897913,27.6208674610209
"1970","stairs",4.54517304125535,32,9,23,4.37913253897913,27.6208674610209
"1970","da la da da",4.54354686764836,37,10,27,5.06337199819462,31.9366280018054
"1970","praise",4.54354686764836,37,10,27,5.06337199819462,31.9366280018054
"1970","shadows",4.54203361966861,80,18,62,10.9478313474478,69.0521686525522
"1960","breeze",4.53766456901902,59,8,51,3.52367313017956,55.4763268698204
"1980","cmon",4.53708490671976,239,53,186,40.2083389068151,198.791661093185
"1980","blood",4.52551949971609,128,31,97,21.534173138378,106.465826861622
"1980","weak",4.52551949971609,128,31,97,21.534173138378,106.465826861622
"1960","book",4.52481181106477,70,9,61,4.18062913750118,65.8193708624988
"1970","whatever",4.52380545221539,343,61,282,46.9388269021826,296.061173097817
"1980","missing",4.51908285957833,188,43,145,31.6283167969926,156.371683203007
"2010","like girl",4.51893324746431,92,22,70,14.164570606018,77.835429393982
"2010","beat beat",4.51664113173707,52,14,38,8.00606164687973,43.9939383531203
"1980","always seem",4.51403138402963,15,6,9,2.52353591465367,12.4764640853463
"1980","dancing dark",4.51403138402963,15,6,9,2.52353591465367,12.4764640853463
"1980","got see",4.51403138402963,15,6,9,2.52353591465367,12.4764640853463
"1980","heaven earth",4.51403138402963,15,6,9,2.52353591465367,12.4764640853463
"1980","home can",4.51403138402963,15,6,9,2.52353591465367,12.4764640853463
"1980","knew id",4.51403138402963,15,6,9,2.52353591465367,12.4764640853463
"1980","love touch",4.51403138402963,15,6,9,2.52353591465367,12.4764640853463
"1980","mewe",4.51403138402963,15,6,9,2.52353591465367,12.4764640853463
"1980","night one",4.51403138402963,15,6,9,2.52353591465367,12.4764640853463
"1980","since went",4.51403138402963,15,6,9,2.52353591465367,12.4764640853463
"1980","tell love way",4.51403138402963,15,6,9,2.52353591465367,12.4764640853463
"1980","walk like",4.51403138402963,15,6,9,2.52353591465367,12.4764640853463
"1980","youwe",4.51403138402963,15,6,9,2.52353591465367,12.4764640853463
"1990","breakfast",4.51237574051504,25,10,15,5.30361739823829,19.6963826017617
"1990","head toe",4.51237574051504,25,10,15,5.30361739823829,19.6963826017617
"1990","horses",4.51237574051504,25,10,15,5.30361739823829,19.6963826017617
"1990","need like",4.51237574051504,25,10,15,5.30361739823829,19.6963826017617
"1990","pearls",4.51237574051504,25,10,15,5.30361739823829,19.6963826017617
"1990","said youd",4.51237574051504,25,10,15,5.30361739823829,19.6963826017617
"1990","tears im",4.51237574051504,25,10,15,5.30361739823829,19.6963826017617
"1990","unkind",4.51237574051504,25,10,15,5.30361739823829,19.6963826017617
"1970","tell ya",4.51083318764333,69,16,53,9.44250453717376,59.5574954628262
"1970","therell",4.51083318764333,69,16,53,9.44250453717376,59.5574954628262
"1970","thought id",4.51083318764333,69,16,53,9.44250453717376,59.5574954628262
"1970","sunday",4.50403479121743,103,22,81,14.0953328598391,88.9046671401609
"1980","devil",4.49367013766964,99,25,74,16.6553370367142,82.3446629632858
"1980","rock roll",4.49367013766964,99,25,74,16.6553370367142,82.3446629632858
"2010","write",4.49312966990882,172,37,135,26.4815885242945,145.518411475706
"1980","motion",4.48702054668045,148,35,113,24.8988876912495,123.10111230875
"2010","bye",4.48485320694908,183,39,144,28.1751784880575,154.824821511943
"2000","since",4.48470860857558,497,155,342,133.735586544594,363.264413455406
"1970","around just",4.48405728299458,18,6,12,2.46326205317576,15.5367379468242
"1970","baby makes",4.48405728299458,18,6,12,2.46326205317576,15.5367379468242
"1970","deep deep",4.48405728299458,18,6,12,2.46326205317576,15.5367379468242
"1970","get much",4.48405728299458,18,6,12,2.46326205317576,15.5367379468242
"1970","girl whats",4.48405728299458,18,6,12,2.46326205317576,15.5367379468242
"1970","go place",4.48405728299458,18,6,12,2.46326205317576,15.5367379468242
"1970","let mind",4.48405728299458,18,6,12,2.46326205317576,15.5367379468242
"1970","let tell ya",4.48405728299458,18,6,12,2.46326205317576,15.5367379468242
"1970","mama cause",4.48405728299458,18,6,12,2.46326205317576,15.5367379468242
"1970","mind wont",4.48405728299458,18,6,12,2.46326205317576,15.5367379468242
"1970","need cant",4.48405728299458,18,6,12,2.46326205317576,15.5367379468242
"1970","playground",4.48405728299458,18,6,12,2.46326205317576,15.5367379468242
"1970","sentimental",4.48405728299458,18,6,12,2.46326205317576,15.5367379468242
"1970","sing just",4.48405728299458,18,6,12,2.46326205317576,15.5367379468242
"1970","somebody new",4.48405728299458,18,6,12,2.46326205317576,15.5367379468242
"1970","spend night",4.48405728299458,18,6,12,2.46326205317576,15.5367379468242
"1970","three times",4.48405728299458,18,6,12,2.46326205317576,15.5367379468242
"1970","time turn around",4.48405728299458,18,6,12,2.46326205317576,15.5367379468242
"1970","try oh",4.48405728299458,18,6,12,2.46326205317576,15.5367379468242
"1990","need life",4.48169804310591,46,16,30,9.75865601275846,36.2413439872415
"1990","tell baby",4.48079199609751,72,23,49,15.2744181069263,56.7255818930737
"1980","can help",4.48037451557222,35,11,24,5.88825046752523,29.1117495324748
"1980","crowded",4.48037451557222,35,11,24,5.88825046752523,29.1117495324748
"1980","might just",4.48037451557222,35,11,24,5.88825046752523,29.1117495324748
"1980","one ever",4.48037451557222,35,11,24,5.88825046752523,29.1117495324748
"1990","dreams come",4.47738286221424,57,19,38,12.0922476679833,44.9077523320167
"1990","everybody wants",4.47738286221424,57,19,38,12.0922476679833,44.9077523320167
"1990","like see",4.47738286221424,57,19,38,12.0922476679833,44.9077523320167
"1990","make ya",4.47738286221424,57,19,38,12.0922476679833,44.9077523320167
"2010","track",4.47618411669723,145,32,113,22.3245949768762,122.675405023124
"2010","away im",4.47336831825831,57,15,42,8.77587526677201,48.224124733228
"1980","straight",4.47195502278969,255,56,199,42.9001105491124,212.099889450888
"1980","seems",4.47191209872179,477,98,379,80.2484420859867,396.751557914013
"2000","cry dont",4.47048149534428,67,26,41,18.028741043235,48.971258956765
"2000","aim",4.46503161170549,43,18,25,11.5706845501359,31.4293154498641
"2000","baby one",4.46503161170549,43,18,25,11.5706845501359,31.4293154498641
"2000","let hear",4.46496651904711,95,35,60,25.5631402851839,69.4368597148161
"2010","make say",4.4636836798119,38,11,27,5.85058351118134,32.1494164888187
"2010","travel",4.4636836798119,38,11,27,5.85058351118134,32.1494164888187
"2010","understand im",4.4636836798119,38,11,27,5.85058351118134,32.1494164888187
"2010","winning",4.4636836798119,38,11,27,5.85058351118134,32.1494164888187
"1990","rough",4.45861176644445,103,31,72,21.8509036807418,81.1490963192582
"1960","nana",4.45647228818718,105,12,93,6.27094370625176,98.7290562937482
"2010","belong belong",4.448267112361,62,16,46,9.54568888666429,52.4543111133357
"2010","either",4.448267112361,62,16,46,9.54568888666429,52.4543111133357
"2010","call baby",4.44799189578917,77,19,58,11.8551297463411,65.1448702536589
"1970","youre gonna",4.44679108231914,421,73,348,57.6129624659442,363.387037534056
"2010","nah",4.44443342867083,156,34,122,24.0181849406392,131.981815059361
"2010","bad girl",4.44265519241654,29,9,20,4.46491899537523,24.5350810046248
"2010","can put",4.44265519241654,29,9,20,4.46491899537523,24.5350810046248
"2010","hallelujah",4.44265519241654,29,9,20,4.46491899537523,24.5350810046248
"2010","like crazy",4.44265519241654,29,9,20,4.46491899537523,24.5350810046248
"2010","want yeah",4.44265519241654,29,9,20,4.46491899537523,24.5350810046248
"2000","much better",4.4392175308896,46,19,27,12.3779416117733,33.6220583882267
"2000","thing know",4.4392175308896,46,19,27,12.3779416117733,33.6220583882267
"2010","dare",4.43745089837395,67,17,50,10.3155025065566,56.6844974934434
"2000","baby make",4.43468700679757,61,24,37,16.4142269199602,44.5857730800398
"1960","love ooh",4.43387853529691,49,7,42,2.92644039625082,46.0735596037492
"1960","want girl",4.43387853529691,49,7,42,2.92644039625082,46.0735596037492
"1970","wanting",4.4322611131267,53,13,40,7.25293826768419,45.7470617323158
"2000","beat",4.43188548921072,765,232,533,205.850550717534,559.149449282466
"1980","every day",4.42675958858134,209,47,162,35.1612670775078,173.838732922492
"2000","one two",4.42441142866597,111,40,71,29.8685112805833,81.1314887194167
"2000","chillin",4.4237009035095,49,20,29,13.1851986734107,35.8148013265894
"2000","mind im",4.4237009035095,49,20,29,13.1851986734107,35.8148013265894
"2000","want girl",4.4237009035095,49,20,29,13.1851986734107,35.8148013265894
"1980","others",4.42214026241313,109,27,82,18.33769431315,90.66230568685
"1960","woah",4.41800856934774,82,10,72,4.89730841821566,77.1026915817843
"2000","eyes can",4.41693166925345,55,22,33,14.7997127966854,40.2002872033146
"2000","love way love",4.41693166925345,55,22,33,14.7997127966854,40.2002872033146
"2000","life ive",4.4167303686181,52,21,31,13.992455735048,38.007544264952
"1990","well thats",4.41525744398438,39,14,25,8.27364314125173,30.7263568587483
"1970","lovers",4.41483710726446,218,41,177,29.8328404217953,188.167159578205
"1970","walked",4.41483710726446,218,41,177,29.8328404217953,188.167159578205
"1970","can dance",4.41058874492455,75,17,58,10.2635918882323,64.7364081117677
"1990","baby night",4.40926698810784,32,12,20,6.78863026974501,25.211369730255
"1990","can bring",4.40926698810784,32,12,20,6.78863026974501,25.211369730255
"1990","cant cant cant",4.40926698810784,32,12,20,6.78863026974501,25.211369730255
"1990","miami",4.40926698810784,32,12,20,6.78863026974501,25.211369730255
"1990","want youre",4.40926698810784,32,12,20,6.78863026974501,25.211369730255
"1960","girl",4.39977118205938,4804,322,4482,286.910605379366,4517.08939462063
"1980","know youve got",4.39888101429959,31,10,21,5.21530755695092,25.7846924430491
"1980","nearly",4.39888101429959,31,10,21,5.21530755695092,25.7846924430491
"1960","night love",4.39355599939863,39,6,33,2.32920766232208,36.6707923376779
"1960","order",4.39355599939863,39,6,33,2.32920766232208,36.6707923376779
"2000","dial",4.39260796135833,26,12,14,6.99622786752402,19.003772132476
"2000","insecure",4.39260796135833,26,12,14,6.99622786752402,19.003772132476
"2000","joint",4.39260796135833,26,12,14,6.99622786752402,19.003772132476
"2000","keep eyes",4.39260796135833,26,12,14,6.99622786752402,19.003772132476
"2000","make come",4.39260796135833,26,12,14,6.99622786752402,19.003772132476
"2000","stop get",4.39260796135833,26,12,14,6.99622786752402,19.003772132476
"2000","things like",4.39260796135833,26,12,14,6.99622786752402,19.003772132476
"2000","yall dont",4.39260796135833,26,12,14,6.99622786752402,19.003772132476
"1970","give just",4.39152416817566,64,15,49,8.75826507795827,55.2417349220417
"1960","street",4.38778219452997,339,30,309,20.2461896801843,318.753810319816
"1990","silence",4.38720543047355,61,20,41,12.9408264517014,48.0591735482986
"1960","keeps",4.37585249301601,285,26,259,17.0211329169691,267.978867083031
"1990","really want",4.37582121201109,188,52,136,39.8832028347519,148.116797165248
"1960","ba ba",4.3748175886251,71,9,62,4.24035241089405,66.759647589106
"1960","let let",4.37202979189854,60,8,52,3.58339640357244,56.4166035964276
"2010","better",4.371403870592,1655,286,1369,254.808308184345,1400.19169181565
"1980","alli",4.36621738112064,19,7,12,3.19647882522798,15.803521174772
"1980","come rock",4.36621738112064,19,7,12,3.19647882522798,15.803521174772
"1980","day youre",4.36621738112064,19,7,12,3.19647882522798,15.803521174772
"1980","give just one night",4.36621738112064,19,7,12,3.19647882522798,15.803521174772
"1980","going dont",4.36621738112064,19,7,12,3.19647882522798,15.803521174772
"1980","home home",4.36621738112064,19,7,12,3.19647882522798,15.803521174772
"1980","just believe",4.36621738112064,19,7,12,3.19647882522798,15.803521174772
"1980","keep moving",4.36621738112064,19,7,12,3.19647882522798,15.803521174772
"1980","know might",4.36621738112064,19,7,12,3.19647882522798,15.803521174772
"1980","love knew",4.36621738112064,19,7,12,3.19647882522798,15.803521174772
"1980","neighborhood",4.36621738112064,19,7,12,3.19647882522798,15.803521174772
"1980","steal heart",4.36621738112064,19,7,12,3.19647882522798,15.803521174772
"1980","things know",4.36621738112064,19,7,12,3.19647882522798,15.803521174772
"1980","wants wants",4.36621738112064,19,7,12,3.19647882522798,15.803521174772
"1960","crowd",4.35931555279791,130,14,116,7.76402554107361,122.235974458926
"1980","go dont let",4.3501045853413,44,13,31,7.40237201631743,36.5976279836826
"1980","made love",4.3501045853413,44,13,31,7.40237201631743,36.5976279836826
"1980","stop dont stop",4.3501045853413,44,13,31,7.40237201631743,36.5976279836826
"1980","want bad",4.3501045853413,44,13,31,7.40237201631743,36.5976279836826
"1980","went away",4.3501045853413,44,13,31,7.40237201631743,36.5976279836826
"1990","alright alright alright",4.35009512046652,50,17,33,10.6072347964766,39.3927652035234
"1990","flower",4.35009512046652,50,17,33,10.6072347964766,39.3927652035234
"2010","magic",4.34640711778725,279,56,223,42.9555999899893,236.044400010011
"1970","box",4.34490515956987,48,12,36,6.5686988084687,41.4313011915313
"1970","extra",4.34490515956987,48,12,36,6.5686988084687,41.4313011915313
"1970","shaking",4.34490515956987,48,12,36,6.5686988084687,41.4313011915313
"1970","something like",4.34490515956987,48,12,36,6.5686988084687,41.4313011915313
"1970","well get",4.34490515956987,48,12,36,6.5686988084687,41.4313011915313
"1980","cant think",4.34266284674242,27,9,18,4.5423646463766,22.4576353536234
"1980","destination",4.34266284674242,27,9,18,4.5423646463766,22.4576353536234
"1980","together well",4.34266284674242,27,9,18,4.5423646463766,22.4576353536234
"1980","uh dont",4.34266284674242,27,9,18,4.5423646463766,22.4576353536234
"1980","want world",4.34266284674242,27,9,18,4.5423646463766,22.4576353536234
"1990","baby show",4.34108008990476,22,9,13,4.6671833104497,17.3328166895503
"1990","back mind",4.34108008990476,22,9,13,4.6671833104497,17.3328166895503
"1990","back well",4.34108008990476,22,9,13,4.6671833104497,17.3328166895503
"1990","feels like im",4.34108008990476,22,9,13,4.6671833104497,17.3328166895503
"1990","hey whats",4.34108008990476,22,9,13,4.6671833104497,17.3328166895503
"1990","let play",4.34108008990476,22,9,13,4.6671833104497,17.3328166895503
"1990","like really",4.34108008990476,22,9,13,4.6671833104497,17.3328166895503
"1990","meets",4.34108008990476,22,9,13,4.6671833104497,17.3328166895503
"1990","never ever ever",4.34108008990476,22,9,13,4.6671833104497,17.3328166895503
"1990","never known",4.34108008990476,22,9,13,4.6671833104497,17.3328166895503
"1990","one try",4.34108008990476,22,9,13,4.6671833104497,17.3328166895503
"1990","sons",4.34108008990476,22,9,13,4.6671833104497,17.3328166895503
"1990","time lets",4.34108008990476,22,9,13,4.6671833104497,17.3328166895503
"1990","way cant",4.34108008990476,22,9,13,4.6671833104497,17.3328166895503
"1990","weve come",4.34108008990476,22,9,13,4.6671833104497,17.3328166895503
"1990","need love",4.34007812442424,180,50,130,38.1860452673157,141.813954732684
"1960","aint nothing",4.33813332383344,106,12,94,6.33066697964464,99.6693330203554
"2000","cut",4.33621773763712,236,78,158,63.5042221821411,172.495777817859
"1980","stuff",4.32493879100741,164,38,126,27.5906593335468,136.409340666453
"1980","arrive",4.32424918841344,23,8,15,3.86942173580229,19.1305782641977
"1980","better take",4.32424918841344,23,8,15,3.86942173580229,19.1305782641977
"1980","dont come easy",4.32424918841344,23,8,15,3.86942173580229,19.1305782641977
"1980","glove",4.32424918841344,23,8,15,3.86942173580229,19.1305782641977
"1980","ive gone",4.32424918841344,23,8,15,3.86942173580229,19.1305782641977
"1980","lace",4.32424918841344,23,8,15,3.86942173580229,19.1305782641977
"1980","long since",4.32424918841344,23,8,15,3.86942173580229,19.1305782641977
"1980","night come",4.32424918841344,23,8,15,3.86942173580229,19.1305782641977
"1980","time never",4.32424918841344,23,8,15,3.86942173580229,19.1305782641977
"2010","alive",4.32072176658255,417,80,337,64.2024558990163,352.797544100984
"1980","destiny",4.3184571703196,53,15,38,8.91649356510963,44.0835064348904
"1980","laughter",4.3184571703196,53,15,38,8.91649356510963,44.0835064348904
"2000","atlanta",4.31802169977821,18,9,9,4.84354236982432,13.1564576301757
"2000","baby baby baby love",4.31802169977821,18,9,9,4.84354236982432,13.1564576301757
"2000","candy girl",4.31802169977821,18,9,9,4.84354236982432,13.1564576301757
"2000","club im",4.31802169977821,18,9,9,4.84354236982432,13.1564576301757
"2000","couldnt live",4.31802169977821,18,9,9,4.84354236982432,13.1564576301757
"2000","experience",4.31802169977821,18,9,9,4.84354236982432,13.1564576301757
"2000","go place",4.31802169977821,18,9,9,4.84354236982432,13.1564576301757
"2000","gonna start",4.31802169977821,18,9,9,4.84354236982432,13.1564576301757
"2000","got hey",4.31802169977821,18,9,9,4.84354236982432,13.1564576301757
"2000","make just",4.31802169977821,18,9,9,4.84354236982432,13.1564576301757
"2000","new york new",4.31802169977821,18,9,9,4.84354236982432,13.1564576301757
"2000","right fuck",4.31802169977821,18,9,9,4.84354236982432,13.1564576301757
"2000","right like",4.31802169977821,18,9,9,4.84354236982432,13.1564576301757
"2000","smoke weed",4.31802169977821,18,9,9,4.84354236982432,13.1564576301757
"2000","stop oh",4.31802169977821,18,9,9,4.84354236982432,13.1564576301757
"2000","three times",4.31802169977821,18,9,9,4.84354236982432,13.1564576301757
"2000","time turn around",4.31802169977821,18,9,9,4.84354236982432,13.1564576301757
"2000","toot",4.31802169977821,18,9,9,4.84354236982432,13.1564576301757
"2000","will just",4.31802169977821,18,9,9,4.84354236982432,13.1564576301757
"2000","wont remember",4.31802169977821,18,9,9,4.84354236982432,13.1564576301757
"2000","yeah lets",4.31802169977821,18,9,9,4.84354236982432,13.1564576301757
"2000","yeah one",4.31802169977821,18,9,9,4.84354236982432,13.1564576301757
"2000","york new",4.31802169977821,18,9,9,4.84354236982432,13.1564576301757
"1990","know name",4.31151993034428,65,21,44,13.7894052354196,51.2105947645804
"1990","breakin",4.30658643156751,88,27,61,18.6687332417988,69.3312667582012
"1980","thinking",4.30472561178109,452,93,359,76.0425488948972,375.957451105103
"2000","right back",4.29772866195932,83,31,52,22.3341120386344,60.6658879613656
"2000","rings",4.29772866195932,83,31,52,22.3341120386344,60.6658879613656
"2000","try",4.29697292195357,1260,372,888,339.047965887702,920.952034112297
"1970","bout baby",4.28649989087562,23,7,16,3.14750151239125,19.8524984876087
"1970","caused",4.28649989087562,23,7,16,3.14750151239125,19.8524984876087
"1970","glove",4.28649989087562,23,7,16,3.14750151239125,19.8524984876087
"1970","go sleep",4.28649989087562,23,7,16,3.14750151239125,19.8524984876087
"1970","gone long",4.28649989087562,23,7,16,3.14750151239125,19.8524984876087
"1970","like gotta",4.28649989087562,23,7,16,3.14750151239125,19.8524984876087
"1970","long since",4.28649989087562,23,7,16,3.14750151239125,19.8524984876087
"1970","long time ago",4.28649989087562,23,7,16,3.14750151239125,19.8524984876087
"1970","love time",4.28649989087562,23,7,16,3.14750151239125,19.8524984876087
"1970","love will find",4.28649989087562,23,7,16,3.14750151239125,19.8524984876087
"1970","never said",4.28649989087562,23,7,16,3.14750151239125,19.8524984876087
"1970","singing song",4.28649989087562,23,7,16,3.14750151239125,19.8524984876087
"1970","thing want",4.28649989087562,23,7,16,3.14750151239125,19.8524984876087
"1970","uncle",4.28649989087562,23,7,16,3.14750151239125,19.8524984876087
"1980","never know",4.28335891252991,100,25,75,16.8235727643578,83.1764272356422
"1970","melody",4.28185982421822,70,16,54,9.57935242901686,60.4206475709831
"1990","summer",4.28161442593843,331,86,245,70.219894352675,260.780105647325
"2010","boyfriend",4.27834437783033,48,13,35,7.3902107509659,40.6097892490341
"2010","way know",4.27834437783033,48,13,35,7.3902107509659,40.6097892490341
"2010","baby oh baby",4.27776644975512,25,8,17,3.84906809946141,21.1509319005386
"2010","checking",4.27776644975512,25,8,17,3.84906809946141,21.1509319005386
"2010","droppin",4.27776644975512,25,8,17,3.84906809946141,21.1509319005386
"2010","endlessly",4.27776644975512,25,8,17,3.84906809946141,21.1509319005386
"2010","head cant",4.27776644975512,25,8,17,3.84906809946141,21.1509319005386
"2010","rolled",4.27776644975512,25,8,17,3.84906809946141,21.1509319005386
"2010","version",4.27776644975512,25,8,17,3.84906809946141,21.1509319005386
"2010","well ive",4.27776644975512,25,8,17,3.84906809946141,21.1509319005386
"2010","yeah said",4.27776644975512,25,8,17,3.84906809946141,21.1509319005386
"1970","greatest",4.2773892344258,59,14,45,8.07402561874278,50.9259743812572
"2010","cause need",4.27506295537645,88,21,67,13.5487197101042,74.4512802898958
"1980","cant",4.272282608385,5338,955,4383,898.042314161419,4439.95768583858
"2000","playin song",4.26991438244156,29,13,16,7.80348492916141,21.1965150708386
"2000","una",4.26991438244156,29,13,16,7.80348492916141,21.1965150708386
"2000","woman take",4.26991438244156,29,13,16,7.80348492916141,21.1965150708386
"1960","goodbye",4.26815028868712,410,35,375,24.4865420910783,385.513457908922
"2000","gotta keep",4.25931103872197,80,30,50,21.526854976997,58.473145023003
"1960","girl got",4.25209133523665,50,7,43,2.9861636696437,47.0138363303563
"1960","gone im",4.25209133523665,50,7,43,2.9861636696437,47.0138363303563
"1960","long ago",4.25209133523665,50,7,43,2.9861636696437,47.0138363303563
"1960","now never",4.25209133523665,50,7,43,2.9861636696437,47.0138363303563
"1960","whats going",4.25209133523665,50,7,43,2.9861636696437,47.0138363303563
"2010","blaze",4.2518744268586,34,10,24,5.23473261526751,28.7652673847325
"2010","come dont",4.2518744268586,34,10,24,5.23473261526751,28.7652673847325
"2010","deep heart",4.2518744268586,34,10,24,5.23473261526751,28.7652673847325
"2010","glow",4.2518744268586,34,10,24,5.23473261526751,28.7652673847325
"1970","went",4.25180940627997,378,66,312,51.728503116691,326.271496883309
"1990","never make",4.2490364225726,43,15,28,9.12222192496986,33.8777780750301
"1990","pound",4.2490364225726,43,15,28,9.12222192496986,33.8777780750301
"1990","take clothes",4.2490364225726,43,15,28,9.12222192496986,33.8777780750301
"1990","die",4.24890433813292,516,129,387,109.466663099638,406.533336900362
"2010","gonna love",4.24764530863109,109,25,84,16.7819369136517,92.2180630863483
"2000","see im",4.24279884364676,131,46,85,35.2502250248326,95.7497749751674
"1980","dancing",4.23747292976327,362,76,286,60.9013334069752,301.098666593025
"2010","fan",4.23068900429852,53,14,39,8.16002437085818,44.8399756291418
"2010","heart dont",4.23068900429852,53,14,39,8.16002437085818,44.8399756291418
"2010","hoo hoo",4.23068900429852,53,14,39,8.16002437085818,44.8399756291418
"2010","long youre",4.23068900429852,53,14,39,8.16002437085818,44.8399756291418
"1980","can baby",4.22374272022612,40,12,28,6.72942910574312,33.2705708942569
"1980","cry just",4.22374272022612,40,12,28,6.72942910574312,33.2705708942569
"1980","rest life",4.22374272022612,40,12,28,6.72942910574312,33.2705708942569
"1980","tell just",4.22374272022612,40,12,28,6.72942910574312,33.2705708942569
"1980","way just",4.22374272022612,40,12,28,6.72942910574312,33.2705708942569
"2000","fucked",4.22256236325688,77,29,48,20.7195979153596,56.2804020846404
"2010","bye bye",4.21986277288127,78,19,59,12.0090924703196,65.9909075296804
"2010","yeah got",4.21986277288127,78,19,59,12.0090924703196,65.9909075296804
"2000","life",4.21922032193291,2901,830,2071,780.617578603353,2120.38242139665
"1970","gone away",4.21751476633995,38,10,28,5.20021989003772,32.7997801099623
"1990","youre one",4.20770226194286,285,75,210,60.4612383399165,224.538761660084
"1970","confusion",4.20564094795598,28,8,20,3.83174097160674,24.1682590283933
"1970","life can",4.20564094795598,28,8,20,3.83174097160674,24.1682590283933
"1970","make world",4.20564094795598,28,8,20,3.83174097160674,24.1682590283933
"1970","time turn",4.20564094795598,28,8,20,3.83174097160674,24.1682590283933
"1970","way baby",4.20564094795598,28,8,20,3.83174097160674,24.1682590283933
"1960","behind",4.20387726017206,342,30,312,20.4253595003629,321.574640499637
"2010","without baby",4.20316935956663,58,15,43,8.92983799075047,49.0701620092495
"1970","may",4.20196553088445,476,81,395,65.1395965173146,410.860403482685
"1990","passion",4.20012562821729,132,38,94,28.0030998626982,103.996900137302
"1960","train",4.19880455657658,221,21,200,13.1988434198251,207.801156580175
"1990","away pain",4.19849863747018,29,11,18,6.15219618195642,22.8478038180436
"1990","gotta give",4.19849863747018,29,11,18,6.15219618195642,22.8478038180436
"1990","partys",4.19849863747018,29,11,18,6.15219618195642,22.8478038180436
"1990","say things",4.19849863747018,29,11,18,6.15219618195642,22.8478038180436
"1990","tell wanna",4.19849863747018,29,11,18,6.15219618195642,22.8478038180436
"1990","stroke",4.19544383224479,124,36,88,26.3059422952619,97.6940577047381
"2000","ahah",4.19483671069536,13,7,6,3.49811393376201,9.50188606623799
"2000","aint got money",4.19483671069536,13,7,6,3.49811393376201,9.50188606623799
"2000","arms im",4.19483671069536,13,7,6,3.49811393376201,9.50188606623799
"2000","babe love",4.19483671069536,13,7,6,3.49811393376201,9.50188606623799
"2000","baby love baby baby",4.19483671069536,13,7,6,3.49811393376201,9.50188606623799
"2000","break em",4.19483671069536,13,7,6,3.49811393376201,9.50188606623799
"2000","cadillacs",4.19483671069536,13,7,6,3.49811393376201,9.50188606623799
"2000","connect",4.19483671069536,13,7,6,3.49811393376201,9.50188606623799
"2000","dont know get",4.19483671069536,13,7,6,3.49811393376201,9.50188606623799
"2000","feeling cause",4.19483671069536,13,7,6,3.49811393376201,9.50188606623799
"2000","first thing",4.19483671069536,13,7,6,3.49811393376201,9.50188606623799
"2000","forced",4.19483671069536,13,7,6,3.49811393376201,9.50188606623799
"2000","forgiveness",4.19483671069536,13,7,6,3.49811393376201,9.50188606623799
"2000","get aint",4.19483671069536,13,7,6,3.49811393376201,9.50188606623799
"2000","give moment",4.19483671069536,13,7,6,3.49811393376201,9.50188606623799
"2000","got dough",4.19483671069536,13,7,6,3.49811393376201,9.50188606623799
"2000","got many",4.19483671069536,13,7,6,3.49811393376201,9.50188606623799
"2000","gotta like",4.19483671069536,13,7,6,3.49811393376201,9.50188606623799
"2000","high can",4.19483671069536,13,7,6,3.49811393376201,9.50188606623799
"2000","ill pick",4.19483671069536,13,7,6,3.49811393376201,9.50188606623799
"2000","im breaking",4.19483671069536,13,7,6,3.49811393376201,9.50188606623799
"2000","im lovin",4.19483671069536,13,7,6,3.49811393376201,9.50188606623799
"2000","just ask",4.19483671069536,13,7,6,3.49811393376201,9.50188606623799
"2000","keep safe",4.19483671069536,13,7,6,3.49811393376201,9.50188606623799
"2000","know rock",4.19483671069536,13,7,6,3.49811393376201,9.50188606623799
"2000","know touch",4.19483671069536,13,7,6,3.49811393376201,9.50188606623799
"2000","lets go somewhere",4.19483671069536,13,7,6,3.49811393376201,9.50188606623799
"2000","like someone",4.19483671069536,13,7,6,3.49811393376201,9.50188606623799
"2000","logic",4.19483671069536,13,7,6,3.49811393376201,9.50188606623799
"2000","mind baby",4.19483671069536,13,7,6,3.49811393376201,9.50188606623799
"2000","movement",4.19483671069536,13,7,6,3.49811393376201,9.50188606623799
"2000","naive",4.19483671069536,13,7,6,3.49811393376201,9.50188606623799
"2000","new life",4.19483671069536,13,7,6,3.49811393376201,9.50188606623799
"2000","rain im",4.19483671069536,13,7,6,3.49811393376201,9.50188606623799
"2000","right ya",4.19483671069536,13,7,6,3.49811393376201,9.50188606623799
"2000","robbed",4.19483671069536,13,7,6,3.49811393376201,9.50188606623799
"2000","said really",4.19483671069536,13,7,6,3.49811393376201,9.50188606623799
"2000","snatch",4.19483671069536,13,7,6,3.49811393376201,9.50188606623799
"2000","sofa",4.19483671069536,13,7,6,3.49811393376201,9.50188606623799
"2000","soul soul",4.19483671069536,13,7,6,3.49811393376201,9.50188606623799
"2000","times get",4.19483671069536,13,7,6,3.49811393376201,9.50188606623799
"2000","vegas",4.19483671069536,13,7,6,3.49811393376201,9.50188606623799
"2000","wanna gotta",4.19483671069536,13,7,6,3.49811393376201,9.50188606623799
"2000","wanna taste",4.19483671069536,13,7,6,3.49811393376201,9.50188606623799
"2000","way give",4.19483671069536,13,7,6,3.49811393376201,9.50188606623799
"2000","willin",4.19483671069536,13,7,6,3.49811393376201,9.50188606623799
"2000","written face",4.19483671069536,13,7,6,3.49811393376201,9.50188606623799
"2010","run run",4.19151170559031,68,17,51,10.469465230535,57.530534769465
"1960","loud",4.1914450745143,208,20,188,12.4224408657178,195.577559134282
"1970","laughin",4.19095038425731,33,9,24,4.51598043082223,28.4840195691778
"1970","like will",4.19095038425731,33,9,24,4.51598043082223,28.4840195691778
"1970","one need",4.19095038425731,33,9,24,4.51598043082223,28.4840195691778
"1980","carry",4.18964556696139,221,49,172,37.1800958092307,183.819904190769
"1990","bended",4.18956507237644,19,8,11,4.0307492226611,14.9692507773389
"1990","best friends",4.18956507237644,19,8,11,4.0307492226611,14.9692507773389
"1990","free now",4.18956507237644,19,8,11,4.0307492226611,14.9692507773389
"1990","go tell",4.18956507237644,19,8,11,4.0307492226611,14.9692507773389
"1990","hands time",4.18956507237644,19,8,11,4.0307492226611,14.9692507773389
"1990","heart ill",4.18956507237644,19,8,11,4.0307492226611,14.9692507773389
"1990","like forever",4.18956507237644,19,8,11,4.0307492226611,14.9692507773389
"1990","losing mind",4.18956507237644,19,8,11,4.0307492226611,14.9692507773389
"1990","love away",4.18956507237644,19,8,11,4.0307492226611,14.9692507773389
"1990","shit like",4.18956507237644,19,8,11,4.0307492226611,14.9692507773389
"1990","spoon",4.18956507237644,19,8,11,4.0307492226611,14.9692507773389
"1990","tell girl",4.18956507237644,19,8,11,4.0307492226611,14.9692507773389
"1990","theres someone",4.18956507237644,19,8,11,4.0307492226611,14.9692507773389
"1990","walked door",4.18956507237644,19,8,11,4.0307492226611,14.9692507773389
"1990","without live",4.18956507237644,19,8,11,4.0307492226611,14.9692507773389
"1990","wondering youre",4.18956507237644,19,8,11,4.0307492226611,14.9692507773389
"1990","wont hurt",4.18956507237644,19,8,11,4.0307492226611,14.9692507773389
"1990","world thats",4.18956507237644,19,8,11,4.0307492226611,14.9692507773389
"1990","yeah feel",4.18956507237644,19,8,11,4.0307492226611,14.9692507773389
"1990","ill hold",4.18898628800133,36,13,23,7.63720905346314,28.3627909465369
"1990","records",4.18898628800133,36,13,23,7.63720905346314,28.3627909465369
"1990","tonight ill",4.18898628800133,36,13,23,7.63720905346314,28.3627909465369
"1960","get mind",4.18718679957691,40,6,34,2.38893093571496,37.611069064285
"1960","like can",4.18718679957691,40,6,34,2.38893093571496,37.611069064285
"1980","express",4.18547158171614,58,16,42,9.75767220332752,48.2423277966725
"2000","make work",4.18072785193871,32,14,18,8.61074199079879,23.3892580092012
"1990","never gonna",4.17913708355178,239,64,175,50.7025823271581,188.297417672842
"2000","aint never",4.17890521436109,96,35,61,25.8322259723964,70.1677740276036
"2010","short",4.1747808997665,120,27,93,18.4755268774148,101.524473122585
"1970","knows",4.17328752285033,496,84,412,67.8765543541766,428.123445645823
"1970","shes",4.16442262996044,1432,223,1209,195.966181119316,1236.03381888068
"1970","let take",4.15645377640065,65,15,50,8.89511296980137,56.1048870301986
"1980","cos",4.15634802371809,72,19,53,12.1129723903376,59.8870276096624
"1980","love much",4.15634802371809,72,19,53,12.1129723903376,59.8870276096624
"1980","tell tell",4.15634802371809,72,19,53,12.1129723903376,59.8870276096624
"2000","just let",4.15594582494014,164,56,108,44.1300527028438,119.869947297156
"1990","knife",4.15198009139806,58,19,39,12.3043923639128,45.6956076360872
"2010","like dont",4.15169274160248,99,23,76,15.2423096738672,83.7576903261328
"1960","silly",4.15077979905271,84,10,74,5.01675496500141,78.9832450349986
"1960","wont come",4.15077979905271,84,10,74,5.01675496500141,78.9832450349986
"2010","started",4.14761314892124,315,62,253,48.4982580532137,266.501741946786
"2010","back yeah",4.14240359095028,21,7,14,3.23321720354758,17.7667827964524
"2010","bees",4.14240359095028,21,7,14,3.23321720354758,17.7667827964524
"2010","county",4.14240359095028,21,7,14,3.23321720354758,17.7667827964524
"2010","dont dare",4.14240359095028,21,7,14,3.23321720354758,17.7667827964524
"2010","got perfect",4.14240359095028,21,7,14,3.23321720354758,17.7667827964524
"2010","just walked",4.14240359095028,21,7,14,3.23321720354758,17.7667827964524
"2010","lie cause",4.14240359095028,21,7,14,3.23321720354758,17.7667827964524
"2010","love oh oh oh",4.14240359095028,21,7,14,3.23321720354758,17.7667827964524
"2010","noche",4.14240359095028,21,7,14,3.23321720354758,17.7667827964524
"2010","perfectly",4.14240359095028,21,7,14,3.23321720354758,17.7667827964524
"2010","sinking",4.14240359095028,21,7,14,3.23321720354758,17.7667827964524
"2010","throne",4.14240359095028,21,7,14,3.23321720354758,17.7667827964524
"2010","dick",4.13693804456104,158,34,124,24.3261103885961,133.673889611404
"2010","send",4.13593954420522,191,40,151,29.4068802798852,161.593119720115
"2000","lets make",4.13192356940305,93,34,59,25.024968910759,67.975031089241
"2010","radio",4.128855697063,180,38,142,27.7132903161221,152.286709683878
"1970","yeah oh yeah",4.1253669338921,82,18,64,11.221527131134,70.778472868866
"2010","cab",4.12506894419327,39,11,28,6.0045462351598,32.9954537648402
"2010","ill try",4.12506894419327,39,11,28,6.0045462351598,32.9954537648402
"2010","rip",4.12506894419327,39,11,28,6.0045462351598,32.9954537648402
"2000","like oh",4.12450114637683,68,26,42,18.2978267304474,49.7021732695526
"2000","love better",4.11655679024697,35,15,20,9.41799905243618,25.5820009475638
"2000","try get",4.11655679024697,35,15,20,9.41799905243618,25.5820009475638
"2000","youcause",4.11655679024697,35,15,20,9.41799905243618,25.5820009475638
"1990","baby shes",4.11507739822954,47,16,31,9.97080070868799,37.029199291312
"1990","candle",4.11507739822954,47,16,31,9.97080070868799,37.029199291312
"1990","goodnight",4.11507739822954,47,16,31,9.97080070868799,37.029199291312
"1990","middle night",4.11507739822954,47,16,31,9.97080070868799,37.029199291312
"1980","worlds",4.11202455602871,96,24,72,16.1506298537835,79.8493701462165
"1980","due",4.10699504730019,36,11,25,6.05648619516881,29.9435138048312
"2000","know name",4.09679662185151,65,25,40,17.49056966881,47.50943033119
"2000","know say",4.09679662185151,65,25,40,17.49056966881,47.50943033119
"2000","wanna make",4.09664553079411,161,55,106,43.3227956412064,117.677204358794
"2000","one thing",4.0937354477764,204,68,136,54.8934801913423,149.106519808658
"2000","cause know",4.09266757239565,214,71,143,57.5843370634669,156.415662936533
"2000","back said",4.08606267864549,21,10,11,5.65079943146171,15.3492005685383
"2000","dont know whats",4.08606267864549,21,10,11,5.65079943146171,15.3492005685383
"2000","gotta let know",4.08606267864549,21,10,11,5.65079943146171,15.3492005685383
"2000","ill never let go",4.08606267864549,21,10,11,5.65079943146171,15.3492005685383
"2000","just hit",4.08606267864549,21,10,11,5.65079943146171,15.3492005685383
"2000","live dont",4.08606267864549,21,10,11,5.65079943146171,15.3492005685383
"2000","love got got",4.08606267864549,21,10,11,5.65079943146171,15.3492005685383
"2000","model",4.08606267864549,21,10,11,5.65079943146171,15.3492005685383
"2000","never seem",4.08606267864549,21,10,11,5.65079943146171,15.3492005685383
"2000","pay attention",4.08606267864549,21,10,11,5.65079943146171,15.3492005685383
"2000","something real",4.08606267864549,21,10,11,5.65079943146171,15.3492005685383
"2000","time aint",4.08606267864549,21,10,11,5.65079943146171,15.3492005685383
"1980","real love",4.07971481088982,101,25,76,16.9918084920014,84.0081915079986
"1990","know gotta",4.07737324059849,62,20,42,13.152971147631,48.847028852369
"1960","best thing",4.07681728940011,51,7,44,3.04588694303657,47.9541130569634
"1960","got nothing",4.07681728940011,51,7,44,3.04588694303657,47.9541130569634
"1960","september",4.07681728940011,51,7,44,3.04588694303657,47.9541130569634
"2000","let go dont",4.0721753844268,62,24,38,16.6833126071727,45.3166873928273
"2000","tip",4.0721753844268,62,24,38,16.6833126071727,45.3166873928273
"1980","alive",4.07163053268317,417,86,331,70.154298427372,346.845701572628
"2000","bullshit",4.0715700411615,38,16,22,10.2252561140736,27.7747438859264
"2000","person",4.0715700411615,38,16,22,10.2252561140736,27.7747438859264
"2000","teeth",4.0715700411615,38,16,22,10.2252561140736,27.7747438859264
"1990","can understand",4.06869424005389,16,7,9,3.39431513487251,12.6056848651275
"1990","can walk",4.06869424005389,16,7,9,3.39431513487251,12.6056848651275
"1990","come inside",4.06869424005389,16,7,9,3.39431513487251,12.6056848651275
"1990","display lyrics",4.06869424005389,16,7,9,3.39431513487251,12.6056848651275
"1990","display lyrics due",4.06869424005389,16,7,9,3.39431513487251,12.6056848651275
"1990","display lyrics due licensing",4.06869424005389,16,7,9,3.39431513487251,12.6056848651275
"1990","due licensing",4.06869424005389,16,7,9,3.39431513487251,12.6056848651275
"1990","due licensing restrictions",4.06869424005389,16,7,9,3.39431513487251,12.6056848651275
"1990","due licensing restrictions sorry",4.06869424005389,16,7,9,3.39431513487251,12.6056848651275
"1990","everything gonna",4.06869424005389,16,7,9,3.39431513487251,12.6056848651275
"1990","fires",4.06869424005389,16,7,9,3.39431513487251,12.6056848651275
"1990","free free",4.06869424005389,16,7,9,3.39431513487251,12.6056848651275
"1990","good can",4.06869424005389,16,7,9,3.39431513487251,12.6056848651275
"1990","inconvenience",4.06869424005389,16,7,9,3.39431513487251,12.6056848651275
"1990","junior",4.06869424005389,16,7,9,3.39431513487251,12.6056848651275
"1990","just goes",4.06869424005389,16,7,9,3.39431513487251,12.6056848651275
"1990","licensing",4.06869424005389,16,7,9,3.39431513487251,12.6056848651275
"1990","licensing restrictions",4.06869424005389,16,7,9,3.39431513487251,12.6056848651275
"1990","licensing restrictions sorry",4.06869424005389,16,7,9,3.39431513487251,12.6056848651275
"1990","licensing restrictions sorry inconvenience",4.06869424005389,16,7,9,3.39431513487251,12.6056848651275
"1990","like knife",4.06869424005389,16,7,9,3.39431513487251,12.6056848651275
"1990","lyrics due",4.06869424005389,16,7,9,3.39431513487251,12.6056848651275
"1990","lyrics due licensing",4.06869424005389,16,7,9,3.39431513487251,12.6056848651275
"1990","lyrics due licensing restrictions",4.06869424005389,16,7,9,3.39431513487251,12.6056848651275
"1990","night go",4.06869424005389,16,7,9,3.39431513487251,12.6056848651275
"1990","pause",4.06869424005389,16,7,9,3.39431513487251,12.6056848651275
"1990","position display",4.06869424005389,16,7,9,3.39431513487251,12.6056848651275
"1990","position display lyrics",4.06869424005389,16,7,9,3.39431513487251,12.6056848651275
"1990","position display lyrics due",4.06869424005389,16,7,9,3.39431513487251,12.6056848651275
"1990","restrictions",4.06869424005389,16,7,9,3.39431513487251,12.6056848651275
"1990","restrictions sorry",4.06869424005389,16,7,9,3.39431513487251,12.6056848651275
"1990","restrictions sorry inconvenience",4.06869424005389,16,7,9,3.39431513487251,12.6056848651275
"1990","sorry inconvenience",4.06869424005389,16,7,9,3.39431513487251,12.6056848651275
"1990","stake",4.06869424005389,16,7,9,3.39431513487251,12.6056848651275
"1990","sting",4.06869424005389,16,7,9,3.39431513487251,12.6056848651275
"1990","take high",4.06869424005389,16,7,9,3.39431513487251,12.6056848651275
"1990","time close eyes",4.06869424005389,16,7,9,3.39431513487251,12.6056848651275
"1990","try im",4.06869424005389,16,7,9,3.39431513487251,12.6056848651275
"1990","us back",4.06869424005389,16,7,9,3.39431513487251,12.6056848651275
"1990","winding",4.06869424005389,16,7,9,3.39431513487251,12.6056848651275
"1990","youre far away",4.06869424005389,16,7,9,3.39431513487251,12.6056848651275
"2010","skies",4.0676891144918,89,21,68,13.7026824340826,75.2973175659174
"1970","power",4.06482183019158,246,45,201,33.6645813934021,212.335418606598
"1990","mind",4.05783147828056,1930,446,1484,409.439263143996,1520.560736856
"2010","aint nothing can",4.05631392467787,17,6,11,2.61736630763376,14.3826336923662
"2010","alone need",4.05631392467787,17,6,11,2.61736630763376,14.3826336923662
"2010","concrete",4.05631392467787,17,6,11,2.61736630763376,14.3826336923662
"2010","dancing like",4.05631392467787,17,6,11,2.61736630763376,14.3826336923662
"2010","fans",4.05631392467787,17,6,11,2.61736630763376,14.3826336923662
"2010","get heart",4.05631392467787,17,6,11,2.61736630763376,14.3826336923662
"2010","ive ever known",4.05631392467787,17,6,11,2.61736630763376,14.3826336923662
"2010","killers",4.05631392467787,17,6,11,2.61736630763376,14.3826336923662
"2010","kills",4.05631392467787,17,6,11,2.61736630763376,14.3826336923662
"2010","lord im",4.05631392467787,17,6,11,2.61736630763376,14.3826336923662
"2010","love nobody",4.05631392467787,17,6,11,2.61736630763376,14.3826336923662
"2010","love turn",4.05631392467787,17,6,11,2.61736630763376,14.3826336923662
"2010","satin",4.05631392467787,17,6,11,2.61736630763376,14.3826336923662
"2010","seen nothing",4.05631392467787,17,6,11,2.61736630763376,14.3826336923662
"2010","tonight come",4.05631392467787,17,6,11,2.61736630763376,14.3826336923662
"2010","will alright",4.05631392467787,17,6,11,2.61736630763376,14.3826336923662
"1960","lots",4.05596803757141,62,8,54,3.70284295035818,58.2971570496418
"2010","let walk",4.04900559183765,30,9,21,4.61888171935369,25.3811182806463
"2010","rapper",4.04900559183765,30,9,21,4.61888171935369,25.3811182806463
"2010","ride like",4.04900559183765,30,9,21,4.61888171935369,25.3811182806463
"2010","shit im",4.04900559183765,30,9,21,4.61888171935369,25.3811182806463
"2010","sweet dream",4.04900559183765,30,9,21,4.61888171935369,25.3811182806463
"2010","waves",4.04900559183765,30,9,21,4.61888171935369,25.3811182806463
"2010","youre need",4.04900559183765,30,9,21,4.61888171935369,25.3811182806463
"1980","blue",4.04641660275249,471,96,375,79.2390277201252,391.760972279875
"1980","hand",4.0452489331843,859,167,692,144.514490045833,714.485509954167
"2000","take breath",4.04162620743535,41,17,24,11.032513175711,29.9674868242891
"2000","tell dont",4.04162620743535,41,17,24,11.032513175711,29.9674868242891
"1990","key",4.04084058400674,149,42,107,31.6095596935002,117.3904403065
"1990","supposed",4.04084058400674,149,42,107,31.6095596935002,117.3904403065
"2000","make right",4.04065674669563,87,32,55,23.4104547874842,63.5895452125158
"2000","guns",4.03412739014373,56,22,34,15.0687984838979,40.9312015161021
"1980","soldier",4.02879564641027,54,15,39,9.08472929275321,44.9152707072468
"1980","swallow",4.02879564641027,54,15,39,9.08472929275321,44.9152707072468
"1980","dont wanna go",4.02747180152323,45,13,32,7.57060774396101,37.429392256039
"1980","shades",4.02747180152323,45,13,32,7.57060774396101,37.429392256039
"1980","simply",4.02747180152323,45,13,32,7.57060774396101,37.429392256039
"2000","got baby",4.02370060079581,44,18,26,11.8397702373483,32.1602297626517
"2000","want need",4.02370060079581,44,18,26,11.8397702373483,32.1602297626517
"2000","fan",4.02194345620899,53,21,32,14.2615414222605,38.7384585777395
"2000","feed",4.02194345620899,53,21,32,14.2615414222605,38.7384585777395
"2000","right get",4.02194345620899,53,21,32,14.2615414222605,38.7384585777395
"2000","space",4.0205189761324,119,42,77,32.021196778283,86.978803221717
"1990","wouldnt change",4.01681990721155,40,14,26,8.48578783718126,31.5142121628187
"1990","always love",4.01525702433337,66,21,45,14.0015499313491,51.9984500686509
"2000","told",4.01449530227614,780,235,545,209.886836025721,570.113163974279
"2000","ya ya ya",4.00645424447833,103,37,66,27.7158257828836,75.2841742171164
"1990","fading",4.0060794030338,51,17,34,10.8193794924061,40.1806205075939
"1990","like want",4.0060794030338,51,17,34,10.8193794924061,40.1806205075939
"1990","spirit",4.0060794030338,51,17,34,10.8193794924061,40.1806205075939
"1990","east",4.00584148418364,101,30,71,21.4266142888827,79.5733857111173
"1980","driving",4.00345621992727,121,29,92,20.3565230448729,100.643476955127
"1980","get come",4.00332788617859,32,10,22,5.38354328459449,26.6164567154055
"1980","hardest",4.00332788617859,32,10,22,5.38354328459449,26.6164567154055
"1980","im fire",4.00332788617859,32,10,22,5.38354328459449,26.6164567154055
"1980","lets lets",4.00332788617859,32,10,22,5.38354328459449,26.6164567154055
"1980","oh theres",4.00332788617859,32,10,22,5.38354328459449,26.6164567154055
"1990","always make",3.99918455705254,13,6,7,2.75788104708391,10.2421189529161
"1990","arms hold",3.99918455705254,13,6,7,2.75788104708391,10.2421189529161
"1990","believe say",3.99918455705254,13,6,7,2.75788104708391,10.2421189529161
"1990","bitches dont",3.99918455705254,13,6,7,2.75788104708391,10.2421189529161
"1990","boy love",3.99918455705254,13,6,7,2.75788104708391,10.2421189529161
"1990","boy youll",3.99918455705254,13,6,7,2.75788104708391,10.2421189529161
"1990","bus stop",3.99918455705254,13,6,7,2.75788104708391,10.2421189529161
"1990","chronic",3.99918455705254,13,6,7,2.75788104708391,10.2421189529161
"1990","cracked",3.99918455705254,13,6,7,2.75788104708391,10.2421189529161
"1990","depends",3.99918455705254,13,6,7,2.75788104708391,10.2421189529161
"1990","dont say goodbye",3.99918455705254,13,6,7,2.75788104708391,10.2421189529161
"1990","dont want play",3.99918455705254,13,6,7,2.75788104708391,10.2421189529161
"1990","drawers",3.99918455705254,13,6,7,2.75788104708391,10.2421189529161
"1990","fine baby",3.99918455705254,13,6,7,2.75788104708391,10.2421189529161
"1990","foul",3.99918455705254,13,6,7,2.75788104708391,10.2421189529161
"1990","give another",3.99918455705254,13,6,7,2.75788104708391,10.2421189529161
"1990","gloom",3.99918455705254,13,6,7,2.75788104708391,10.2421189529161
"1990","hold heart",3.99918455705254,13,6,7,2.75788104708391,10.2421189529161
"1990","ill never know",3.99918455705254,13,6,7,2.75788104708391,10.2421189529161
"1990","itno",3.99918455705254,13,6,7,2.75788104708391,10.2421189529161
"1990","justice",3.99918455705254,13,6,7,2.75788104708391,10.2421189529161
"1990","know really love",3.99918455705254,13,6,7,2.75788104708391,10.2421189529161
"1990","lets forget",3.99918455705254,13,6,7,2.75788104708391,10.2421189529161
"1990","lets get away",3.99918455705254,13,6,7,2.75788104708391,10.2421189529161
"1990","like like got",3.99918455705254,13,6,7,2.75788104708391,10.2421189529161
"1990","love words",3.99918455705254,13,6,7,2.75788104708391,10.2421189529161
"1990","minute baby",3.99918455705254,13,6,7,2.75788104708391,10.2421189529161
"1990","need make",3.99918455705254,13,6,7,2.75788104708391,10.2421189529161
"1990","new dance",3.99918455705254,13,6,7,2.75788104708391,10.2421189529161
"1990","nighti",3.99918455705254,13,6,7,2.75788104708391,10.2421189529161
"1990","oh oh now",3.99918455705254,13,6,7,2.75788104708391,10.2421189529161
"1990","pains",3.99918455705254,13,6,7,2.75788104708391,10.2421189529161
"1990","please come back",3.99918455705254,13,6,7,2.75788104708391,10.2421189529161
"1990","rhythms",3.99918455705254,13,6,7,2.75788104708391,10.2421189529161
"1990","stars shine",3.99918455705254,13,6,7,2.75788104708391,10.2421189529161
"1990","time since",3.99918455705254,13,6,7,2.75788104708391,10.2421189529161
"1990","tried find",3.99918455705254,13,6,7,2.75788104708391,10.2421189529161
"1990","try give",3.99918455705254,13,6,7,2.75788104708391,10.2421189529161
"1990","wish come",3.99918455705254,13,6,7,2.75788104708391,10.2421189529161
"1990","wrong love",3.99918455705254,13,6,7,2.75788104708391,10.2421189529161
"1990","yeahhey",3.99918455705254,13,6,7,2.75788104708391,10.2421189529161
"1990","youre thinking",3.99918455705254,13,6,7,2.75788104708391,10.2421189529161
"1990","world",3.99735555436351,2103,484,1619,446.140295539805,1656.85970446019
"1980","wondering",3.99459497093312,126,30,96,21.1977016830908,104.802298316909
"1970","away time",3.99401175466638,19,6,13,2.60010994501886,16.3998900549811
"1970","back way",3.99401175466638,19,6,13,2.60010994501886,16.3998900549811
"1970","central",3.99401175466638,19,6,13,2.60010994501886,16.3998900549811
"1970","find way back",3.99401175466638,19,6,13,2.60010994501886,16.3998900549811
"1970","lovin im",3.99401175466638,19,6,13,2.60010994501886,16.3998900549811
"1970","piano",3.99401175466638,19,6,13,2.60010994501886,16.3998900549811
"1970","play just",3.99401175466638,19,6,13,2.60010994501886,16.3998900549811
"1970","refrain",3.99401175466638,19,6,13,2.60010994501886,16.3998900549811
"1970","seventeen",3.99401175466638,19,6,13,2.60010994501886,16.3998900549811
"1970","spoon",3.99401175466638,19,6,13,2.60010994501886,16.3998900549811
"1970","theres reason",3.99401175466638,19,6,13,2.60010994501886,16.3998900549811
"1970","thing cant",3.99401175466638,19,6,13,2.60010994501886,16.3998900549811
"1970","things aint",3.99401175466638,19,6,13,2.60010994501886,16.3998900549811
"1970","things right",3.99401175466638,19,6,13,2.60010994501886,16.3998900549811
"1970","warn",3.99401175466638,19,6,13,2.60010994501886,16.3998900549811
"1970","worry baby",3.99401175466638,19,6,13,2.60010994501886,16.3998900549811
"1970","know mean",3.99381334810833,100,21,79,13.6847891843098,86.3152108156902
"1990","baby gonna",3.99336174593733,26,10,16,5.51576209416782,20.4842379058322
"1990","crazy baby",3.99336174593733,26,10,16,5.51576209416782,20.4842379058322
"1990","ever go",3.99336174593733,26,10,16,5.51576209416782,20.4842379058322
"1990","figured",3.99336174593733,26,10,16,5.51576209416782,20.4842379058322
"1990","forever never",3.99336174593733,26,10,16,5.51576209416782,20.4842379058322
"1990","give need",3.99336174593733,26,10,16,5.51576209416782,20.4842379058322
"1990","gotta love",3.99336174593733,26,10,16,5.51576209416782,20.4842379058322
"1990","joint",3.99336174593733,26,10,16,5.51576209416782,20.4842379058322
"1990","love even",3.99336174593733,26,10,16,5.51576209416782,20.4842379058322
"1990","meits",3.99336174593733,26,10,16,5.51576209416782,20.4842379058322
"1990","need ill",3.99336174593733,26,10,16,5.51576209416782,20.4842379058322
"1990","see ive",3.99336174593733,26,10,16,5.51576209416782,20.4842379058322
"1990","stop get",3.99336174593733,26,10,16,5.51576209416782,20.4842379058322
"1990","youre worth",3.99336174593733,26,10,16,5.51576209416782,20.4842379058322
"1990","baby come",3.98971390139782,125,36,89,26.5180869911915,98.4819130088085
"1960","oh come",3.98964440336804,41,6,35,2.44865420910783,38.5513457908922
"1960","refuse",3.98964440336804,41,6,35,2.44865420910783,38.5513457908922
"1960","roll baby",3.98964440336804,41,6,35,2.44865420910783,38.5513457908922
"1960","say will",3.98964440336804,41,6,35,2.44865420910783,38.5513457908922
"1960","world will",3.98964440336804,41,6,35,2.44865420910783,38.5513457908922
"1980","bad bad",3.98926552685478,68,18,50,11.4400294797633,56.5599705202367
"1980","feel love",3.98926552685478,68,18,50,11.4400294797633,56.5599705202367
"1980","hurt",3.98777159939565,542,109,433,91.1837643828192,450.816235617181
"1960","shes",3.98633884202226,1432,104,1328,85.5237274985955,1346.4762725014
"1980","empty",3.98607158763745,136,32,104,22.8800589595266,113.119941040473
"1990","deep inside",3.98562987150815,117,34,83,24.8209294237552,92.1790705762448
"1970","turn upside",3.98282972960571,44,11,33,6.02130724109631,37.9786927589037
"1990","count",3.98047734096792,178,49,129,37.7617558754566,140.238244124543
"2000","long time",3.97814922671506,155,53,102,41.7082815179316,113.291718482068
"1990","way",3.97563587318974,4483,1006,3477,951.04467185209,3531.95532814791
"1990","cast",3.9643988132494,33,12,21,7.00077496567454,25.9992250343255
"1990","dont know just",3.9643988132494,33,12,21,7.00077496567454,25.9992250343255
"1990","everywhere go",3.9643988132494,33,12,21,7.00077496567454,25.9992250343255
"1990","day night",3.9635660160039,70,22,48,14.8501287150672,55.1498712849328
"2010","breaks",3.95828646059511,54,14,40,8.31398709483664,45.6860129051634
"2010","work hard",3.95828646059511,54,14,40,8.31398709483664,45.6860129051634
"1970","keeps",3.9568741331789,285,51,234,39.0016491752829,245.998350824717
"2000","pieces",3.95534837623423,100,36,64,26.9085687212462,73.0914312787538
"1960","different",3.95034679074686,198,19,179,11.825208131789,186.174791868211
"1960","hang",3.95034679074686,198,19,179,11.825208131789,186.174791868211
"1970","just like",3.94310063034577,618,102,516,84.5719971590345,533.428002840966
"1990","gonna take",3.94195229030519,170,47,123,36.0645983080204,133.93540169198
"1970","way dont",3.93061560705859,66,15,51,9.03196086164446,56.9680391383555
"1970","right back",3.92742170403585,83,18,65,11.3583750229771,71.6416249770229
"2000","alright cause",3.92568964209485,24,11,13,6.45805649309909,17.5419435069009
"2000","around know",3.92568964209485,24,11,13,6.45805649309909,17.5419435069009
"2000","bubble",3.92568964209485,24,11,13,6.45805649309909,17.5419435069009
"2000","disease",3.92568964209485,24,11,13,6.45805649309909,17.5419435069009
"2000","early morning",3.92568964209485,24,11,13,6.45805649309909,17.5419435069009
"2000","flag",3.92568964209485,24,11,13,6.45805649309909,17.5419435069009
"2000","heart open",3.92568964209485,24,11,13,6.45805649309909,17.5419435069009
"2000","noi",3.92568964209485,24,11,13,6.45805649309909,17.5419435069009
"2000","oh cause",3.92568964209485,24,11,13,6.45805649309909,17.5419435069009
"2000","pourin",3.92568964209485,24,11,13,6.45805649309909,17.5419435069009
"2000","tank",3.92568964209485,24,11,13,6.45805649309909,17.5419435069009
"2000","upset",3.92568964209485,24,11,13,6.45805649309909,17.5419435069009
"2000","wayi",3.92568964209485,24,11,13,6.45805649309909,17.5419435069009
"1990","know one",3.92066798427744,74,23,51,15.6987074987853,58.3012925012147
"1990","love hear",3.92066798427744,74,23,51,15.6987074987853,58.3012925012147
"2000","want love",3.91923589985433,185,62,123,49.7808521343055,135.219147865694
"1970","can turn",3.91910257406114,55,13,42,7.52663405137039,47.4733659486296
"1980","find youre",3.91811137482787,28,9,19,4.71060037402018,23.2893996259798
"1980","ill come",3.91811137482787,28,9,19,4.71060037402018,23.2893996259798
"1980","life away",3.91811137482787,28,9,19,4.71060037402018,23.2893996259798
"1980","love id",3.91811137482787,28,9,19,4.71060037402018,23.2893996259798
"1980","maybe youll",3.91811137482787,28,9,19,4.71060037402018,23.2893996259798
"1980","rock night",3.91811137482787,28,9,19,4.71060037402018,23.2893996259798
"1980","shelf",3.91811137482787,28,9,19,4.71060037402018,23.2893996259798
"1980","take night",3.91811137482787,28,9,19,4.71060037402018,23.2893996259798
"1980","virgin",3.91811137482787,28,9,19,4.71060037402018,23.2893996259798
"1980","know time",3.91693735638199,73,19,54,12.2812081179812,60.7187918820188
"1990","eyes see",3.91680141334918,55,18,37,11.6679582761242,43.3320417238758
"1990","give one",3.91680141334918,55,18,37,11.6679582761242,43.3320417238758
"1990","tell can",3.91680141334918,55,18,37,11.6679582761242,43.3320417238758
"2010","moving",3.91482644248002,215,44,171,33.1019856553681,181.898014344632
"1980","now theres",3.91481684766961,59,16,43,9.9259079309711,49.0740920690289
"1970","hooked",3.91028877348356,39,10,29,5.33706778188082,33.6629322181192
"1970","knocking",3.91028877348356,39,10,29,5.33706778188082,33.6629322181192
"1970","understood",3.91028877348356,39,10,29,5.33706778188082,33.6629322181192
"1960","love ya",3.90778350340416,52,7,45,3.10561021642945,48.8943897835706
"1960","rent",3.90778350340416,52,7,45,3.10561021642945,48.8943897835706
"1980","turn around",3.90638556349118,218,48,170,36.6753886263,181.3246113737
"1990","dreaming",3.90607031198179,162,45,117,34.3674407405841,127.632559259416
"1960","last forever",3.90519171852931,63,8,55,3.76256622375106,59.2374337762489
"1960","yeah now",3.90519171852931,63,8,55,3.76256622375106,59.2374337762489
"1980","cold outside",3.90277018285219,16,6,10,2.69177164229725,13.3082283577028
"1980","display lyrics",3.90277018285219,16,6,10,2.69177164229725,13.3082283577028
"1980","display lyrics due",3.90277018285219,16,6,10,2.69177164229725,13.3082283577028
"1980","display lyrics due licensing",3.90277018285219,16,6,10,2.69177164229725,13.3082283577028
"1980","due licensing",3.90277018285219,16,6,10,2.69177164229725,13.3082283577028
"1980","due licensing restrictions",3.90277018285219,16,6,10,2.69177164229725,13.3082283577028
"1980","due licensing restrictions sorry",3.90277018285219,16,6,10,2.69177164229725,13.3082283577028
"1980","get line",3.90277018285219,16,6,10,2.69177164229725,13.3082283577028
"1980","go ive",3.90277018285219,16,6,10,2.69177164229725,13.3082283577028
"1980","gonna shine",3.90277018285219,16,6,10,2.69177164229725,13.3082283577028
"1980","good can",3.90277018285219,16,6,10,2.69177164229725,13.3082283577028
"1980","im lost without",3.90277018285219,16,6,10,2.69177164229725,13.3082283577028
"1980","inconvenience",3.90277018285219,16,6,10,2.69177164229725,13.3082283577028
"1980","keep inside",3.90277018285219,16,6,10,2.69177164229725,13.3082283577028
"1980","knew youd",3.90277018285219,16,6,10,2.69177164229725,13.3082283577028
"1980","licensing",3.90277018285219,16,6,10,2.69177164229725,13.3082283577028
"1980","licensing restrictions",3.90277018285219,16,6,10,2.69177164229725,13.3082283577028
"1980","licensing restrictions sorry",3.90277018285219,16,6,10,2.69177164229725,13.3082283577028
"1980","licensing restrictions sorry inconvenience",3.90277018285219,16,6,10,2.69177164229725,13.3082283577028
"1980","lyrics due",3.90277018285219,16,6,10,2.69177164229725,13.3082283577028
"1980","lyrics due licensing",3.90277018285219,16,6,10,2.69177164229725,13.3082283577028
"1980","lyrics due licensing restrictions",3.90277018285219,16,6,10,2.69177164229725,13.3082283577028
"1980","methe",3.90277018285219,16,6,10,2.69177164229725,13.3082283577028
"1980","moment im",3.90277018285219,16,6,10,2.69177164229725,13.3082283577028
"1980","neither one",3.90277018285219,16,6,10,2.69177164229725,13.3082283577028
"1980","nowhere go",3.90277018285219,16,6,10,2.69177164229725,13.3082283577028
"1980","oh see",3.90277018285219,16,6,10,2.69177164229725,13.3082283577028
"1980","one now",3.90277018285219,16,6,10,2.69177164229725,13.3082283577028
"1980","one thing can",3.90277018285219,16,6,10,2.69177164229725,13.3082283577028
"1980","position display",3.90277018285219,16,6,10,2.69177164229725,13.3082283577028
"1980","position display lyrics",3.90277018285219,16,6,10,2.69177164229725,13.3082283577028
"1980","position display lyrics due",3.90277018285219,16,6,10,2.69177164229725,13.3082283577028
"1980","restrictions",3.90277018285219,16,6,10,2.69177164229725,13.3082283577028
"1980","restrictions sorry",3.90277018285219,16,6,10,2.69177164229725,13.3082283577028
"1980","restrictions sorry inconvenience",3.90277018285219,16,6,10,2.69177164229725,13.3082283577028
"1980","sacred",3.90277018285219,16,6,10,2.69177164229725,13.3082283577028
"1980","sorry inconvenience",3.90277018285219,16,6,10,2.69177164229725,13.3082283577028
"1980","stake",3.90277018285219,16,6,10,2.69177164229725,13.3082283577028
"1980","swallow pride",3.90277018285219,16,6,10,2.69177164229725,13.3082283577028
"1980","take take take",3.90277018285219,16,6,10,2.69177164229725,13.3082283577028
"1980","tell oh",3.90277018285219,16,6,10,2.69177164229725,13.3082283577028
"1980","want keep",3.90277018285219,16,6,10,2.69177164229725,13.3082283577028
"1980","youre gonna get",3.90277018285219,16,6,10,2.69177164229725,13.3082283577028
"2010","bathroom",3.90161690091809,35,10,25,5.38869533924597,29.611304660754
"2010","ever get",3.90161690091809,35,10,25,5.38869533924597,29.611304660754
"2010","history",3.90161690091809,35,10,25,5.38869533924597,29.611304660754
"2010","just thought",3.90161690091809,35,10,25,5.38869533924597,29.611304660754
"1980","time im",3.89175617615718,177,40,137,29.7777237929133,147.222276207087
"1980","get better",3.88930755859215,41,12,29,6.8976648333867,34.1023351666133
"1980","grace",3.88930755859215,41,12,29,6.8976648333867,34.1023351666133
"1980","slip away",3.88930755859215,41,12,29,6.8976648333867,34.1023351666133
"1980","yeah wanna",3.88930755859215,41,12,29,6.8976648333867,34.1023351666133
"1980","youve never",3.88930755859215,41,12,29,6.8976648333867,34.1023351666133
"1990","one day",3.88924328761922,158,44,114,33.518861956866,124.481138043134
"1990","fears",3.88525562982091,78,24,54,16.5472862825035,61.4527137174965
"1990","everything need",3.88014581733869,44,15,29,9.33436662089939,34.6656333791006
"1990","im missing",3.88014581733869,44,15,29,9.33436662089939,34.6656333791006
"1970","lee",3.87339324980011,24,7,17,3.28434940423435,20.7156505957656
"1970","lookin back",3.87339324980011,24,7,17,3.28434940423435,20.7156505957656
"1970","main",3.87339324980011,24,7,17,3.28434940423435,20.7156505957656
"1970","right cant",3.87339324980011,24,7,17,3.28434940423435,20.7156505957656
"1970","season",3.87339324980011,24,7,17,3.28434940423435,20.7156505957656
"2000","know whats",3.87188333135751,75,28,47,20.1814265409347,54.8185734590653
"2010","goes",3.87016873732948,712,129,583,109.621459472661,602.378540527339
"2010","wont stop",3.86725571554706,90,21,69,13.8566451580611,76.1433548419389
"2010","future",3.8662978452874,138,30,108,21.246855909027,116.753144090973
"1990","happy",3.86524842220904,520,129,391,110.315241883356,409.684758116644
"1980","sign",3.86499077248819,167,38,129,28.0953665164775,138.904633483522
"1980","ah come",3.86014475265993,24,8,16,4.03765746344587,19.9623425365541
"1980","away want",3.86014475265993,24,8,16,4.03765746344587,19.9623425365541
"1980","cause tonight",3.86014475265993,24,8,16,4.03765746344587,19.9623425365541
"1980","feel alive",3.86014475265993,24,8,16,4.03765746344587,19.9623425365541
"1980","good bad",3.86014475265993,24,8,16,4.03765746344587,19.9623425365541
"1980","heavenly",3.86014475265993,24,8,16,4.03765746344587,19.9623425365541
"1980","makes feel like",3.86014475265993,24,8,16,4.03765746344587,19.9623425365541
"1980","stream",3.86014475265993,24,8,16,4.03765746344587,19.9623425365541
"1980","twilight",3.86014475265993,24,8,16,4.03765746344587,19.9623425365541
"1980","want everything",3.86014475265993,24,8,16,4.03765746344587,19.9623425365541
"1980","youits",3.86014475265993,24,8,16,4.03765746344587,19.9623425365541
"1970","alone now",3.85946985050132,34,9,25,4.65282832266533,29.3471716773347
"1970","drives",3.85946985050132,34,9,25,4.65282832266533,29.3471716773347
"1970","mothers",3.85946985050132,34,9,25,4.65282832266533,29.3471716773347
"2010","dont waste",3.85905102010948,26,8,18,4.00303082343986,21.9969691765601
"2010","got head",3.85905102010948,26,8,18,4.00303082343986,21.9969691765601
"2010","one nights",3.85905102010948,26,8,18,4.00303082343986,21.9969691765601
"2010","scent",3.85905102010948,26,8,18,4.00303082343986,21.9969691765601
"2010","tag",3.85905102010948,26,8,18,4.00303082343986,21.9969691765601
"2010","universe",3.85905102010948,26,8,18,4.00303082343986,21.9969691765601
"1970","ill never",3.85762945435114,286,51,235,39.138497067126,246.861502932874
"1970","happy",3.85527994235745,520,87,433,71.1609037584109,448.839096241589
"2010","name",3.85359373660823,977,173,804,150.421581326952,826.578418673048
"1980","dancin",3.85349497807109,162,37,125,27.2541878782596,134.74581212174
"1960","learn",3.85139411501829,239,22,217,14.2738623408969,224.726137659103
"1980","alright now",3.84494375597398,20,7,13,3.36471455287156,16.6352854471284
"1980","busted",3.84494375597398,20,7,13,3.36471455287156,16.6352854471284
"1980","give money",3.84494375597398,20,7,13,3.36471455287156,16.6352854471284
"1980","go far",3.84494375597398,20,7,13,3.36471455287156,16.6352854471284
"1980","gonna spend",3.84494375597398,20,7,13,3.36471455287156,16.6352854471284
"1980","oh night oh",3.84494375597398,20,7,13,3.36471455287156,16.6352854471284
"1980","right night",3.84494375597398,20,7,13,3.36471455287156,16.6352854471284
"1980","right start",3.84494375597398,20,7,13,3.36471455287156,16.6352854471284
"1980","slow slow",3.84494375597398,20,7,13,3.36471455287156,16.6352854471284
"1980","trance",3.84494375597398,20,7,13,3.36471455287156,16.6352854471284
"1990","now theres",3.8433805254329,59,19,40,12.5165370598424,46.4834629401576
"1970","gonna leave",3.84091551742269,29,8,21,3.96858886344984,25.0314111365502
"1970","neon",3.84091551742269,29,8,21,3.96858886344984,25.0314111365502
"1970","nobody knows",3.84091551742269,29,8,21,3.96858886344984,25.0314111365502
"1970","score",3.84091551742269,29,8,21,3.96858886344984,25.0314111365502
"1970","snake",3.84091551742269,29,8,21,3.96858886344984,25.0314111365502
"2000","buying",3.83824151091397,16,8,8,4.3053709953994,11.6946290046006
"2000","cause hes",3.83824151091397,16,8,8,4.3053709953994,11.6946290046006
"2000","empty without",3.83824151091397,16,8,8,4.3053709953994,11.6946290046006
"2000","everything can",3.83824151091397,16,8,8,4.3053709953994,11.6946290046006
"2000","found somebody",3.83824151091397,16,8,8,4.3053709953994,11.6946290046006
"2000","get married",3.83824151091397,16,8,8,4.3053709953994,11.6946290046006
"2000","girl ya",3.83824151091397,16,8,8,4.3053709953994,11.6946290046006
"2000","good man",3.83824151091397,16,8,8,4.3053709953994,11.6946290046006
"2000","guess never",3.83824151091397,16,8,8,4.3053709953994,11.6946290046006
"2000","hard times",3.83824151091397,16,8,8,4.3053709953994,11.6946290046006
"2000","jaw",3.83824151091397,16,8,8,4.3053709953994,11.6946290046006
"2000","kiss baby",3.83824151091397,16,8,8,4.3053709953994,11.6946290046006
"2000","know didnt",3.83824151091397,16,8,8,4.3053709953994,11.6946290046006
"2000","lets know",3.83824151091397,16,8,8,4.3053709953994,11.6946290046006
"2000","like like yeah",3.83824151091397,16,8,8,4.3053709953994,11.6946290046006
"2000","live lie",3.83824151091397,16,8,8,4.3053709953994,11.6946290046006
"2000","place just",3.83824151091397,16,8,8,4.3053709953994,11.6946290046006
"2000","pray god",3.83824151091397,16,8,8,4.3053709953994,11.6946290046006
"2000","saw face",3.83824151091397,16,8,8,4.3053709953994,11.6946290046006
"2000","slave",3.83824151091397,16,8,8,4.3053709953994,11.6946290046006
"2000","stores",3.83824151091397,16,8,8,4.3053709953994,11.6946290046006
"2000","tell friend",3.83824151091397,16,8,8,4.3053709953994,11.6946290046006
"2000","tries",3.83824151091397,16,8,8,4.3053709953994,11.6946290046006
"2000","unverified",3.83824151091397,16,8,8,4.3053709953994,11.6946290046006
"2000","way love way love",3.83824151091397,16,8,8,4.3053709953994,11.6946290046006
"2000","yeah alright",3.83824151091397,16,8,8,4.3053709953994,11.6946290046006
"2000","youd like",3.83824151091397,16,8,8,4.3053709953994,11.6946290046006
"2000","youyoure",3.83824151091397,16,8,8,4.3053709953994,11.6946290046006
"1980","let know",3.83790284340193,297,63,234,49.9660111101426,247.033988889857
"1980","baby dont",3.83755141996837,366,76,290,61.5742763175495,304.42572368245
"1970","daddy",3.83283413544784,344,60,284,47.0756747940257,296.924325205974
"2000","im one",3.82818124657031,239,78,161,64.3114792437785,174.688520756222
"2010","fit",3.82565439467303,85,20,65,13.0868315381688,71.9131684618312
"2010","want say",3.82565439467303,85,20,65,13.0868315381688,71.9131684618312
"1980","never love",3.82270767889596,64,17,47,10.767086569189,53.232913430811
"1980","theres just",3.82270767889596,64,17,47,10.767086569189,53.232913430811
"1970","road",3.8207858728289,370,64,306,50.6337199819462,319.366280018054
"1960","baby want",3.81455375622007,75,9,66,4.47924550446555,70.5207544955345
"2000","countin",3.81325606862461,27,12,15,7.26531355473648,19.7346864452635
"2000","day will",3.81325606862461,27,12,15,7.26531355473648,19.7346864452635
"2000","gotta tell",3.81325606862461,27,12,15,7.26531355473648,19.7346864452635
"2000","im addicted",3.81325606862461,27,12,15,7.26531355473648,19.7346864452635
"2000","im gettin",3.81325606862461,27,12,15,7.26531355473648,19.7346864452635
"2000","just dont know",3.81325606862461,27,12,15,7.26531355473648,19.7346864452635
"2000","life now",3.81325606862461,27,12,15,7.26531355473648,19.7346864452635
"2000","ohh ohh",3.81325606862461,27,12,15,7.26531355473648,19.7346864452635
"2000","right love",3.81325606862461,27,12,15,7.26531355473648,19.7346864452635
"2000","say hey baby",3.81325606862461,27,12,15,7.26531355473648,19.7346864452635
"2000","squad",3.81325606862461,27,12,15,7.26531355473648,19.7346864452635
"2000","stop im",3.81325606862461,27,12,15,7.26531355473648,19.7346864452635
"2000","ups",3.81325606862461,27,12,15,7.26531355473648,19.7346864452635
"1970","tide",3.80974362757149,50,12,38,6.8423945921549,43.1576054078451
"1970","whoa whoa whoa whoa",3.80974362757149,50,12,38,6.8423945921549,43.1576054078451
"1990","know cant",3.80796382028404,134,38,96,28.4273892545572,105.572610745443
"2010","came",3.80763179962597,701,127,574,107.927869508898,593.072130491102
"2010","back just",3.80661030030567,40,11,29,6.15850895913825,33.8414910408617
"2010","ill let",3.80661030030567,40,11,29,6.15850895913825,33.8414910408617
"2010","im leaving",3.80661030030567,40,11,29,6.15850895913825,33.8414910408617
"2010","minutes",3.80661030030567,40,11,29,6.15850895913825,33.8414910408617
"2010","waist",3.80661030030567,40,11,29,6.15850895913825,33.8414910408617
"1970","billy",3.80310406086674,61,14,47,8.34772140242897,52.652278597571
"1960","say yeah",3.80046731596878,42,6,36,2.50837748250071,39.4916225174993
"1970","glad",3.7989094091348,217,40,177,29.6959925299523,187.304007470048
"1970","playing",3.7989094091348,217,40,177,29.6959925299523,187.304007470048
"2000","come around",3.7967315202929,69,26,43,18.5669124176599,50.4330875823401
"2000","excuse",3.7967315202929,69,26,43,18.5669124176599,50.4330875823401
"2000","know cause",3.7967315202929,69,26,43,18.5669124176599,50.4330875823401
"1990","baby gotta",3.79601770067968,23,9,14,4.87932800637923,18.1206719936208
"1990","flesh",3.79601770067968,23,9,14,4.87932800637923,18.1206719936208
"1990","heart away",3.79601770067968,23,9,14,4.87932800637923,18.1206719936208
"1990","impress",3.79601770067968,23,9,14,4.87932800637923,18.1206719936208
"1990","keep warm",3.79601770067968,23,9,14,4.87932800637923,18.1206719936208
"1990","like gotta",3.79601770067968,23,9,14,4.87932800637923,18.1206719936208
"1990","mebaby",3.79601770067968,23,9,14,4.87932800637923,18.1206719936208
"1990","old school",3.79601770067968,23,9,14,4.87932800637923,18.1206719936208
"1990","proof",3.79601770067968,23,9,14,4.87932800637923,18.1206719936208
"1990","really really really",3.79601770067968,23,9,14,4.87932800637923,18.1206719936208
"1990","like like",3.78978126030858,318,82,236,67.4620133055911,250.537986694409
"2000","smile",3.78928170559038,583,178,405,156.876955644866,426.123044355134
"2010","attention",3.7881386723272,80,19,61,12.3170179182765,67.6829820817235
"2010","way im",3.7881386723272,80,19,61,12.3170179182765,67.6829820817235
"1970","kind",3.78732819298153,554,92,462,75.8137320810763,478.186267918924
"1970","oooh",3.78543710749408,78,17,61,10.6741355637616,67.3258644362384
"1960","sound",3.78534378436215,405,34,371,24.1879257241139,380.812074275886
"1990","im gonna take",3.78515590565178,37,13,24,7.84935374939267,29.1506462506073
"1990","make real",3.78515590565178,37,13,24,7.84935374939267,29.1506462506073
"1990","bust",3.78401614169515,122,35,87,25.8816529034029,96.1183470965971
"1990","know baby",3.78290513522278,63,20,43,13.3651158435605,49.6348841564395
"1990","talk talk",3.78290513522278,63,20,43,13.3651158435605,49.6348841564395
"1990","see can",3.78199223509455,102,30,72,21.6387589848122,80.3612410151878
"1970","cant see",3.77889313142985,306,54,252,41.875454903988,264.124545096012
"1970","ago",3.77652620448478,125,25,100,17.1059864803872,107.894013519613
"1990","dont know im",3.77591317523527,110,32,78,23.3359165522485,86.6640834477515
"1990","want tell",3.77042767344358,48,16,32,10.1829454046175,37.8170545953825
"1970","couldnt",3.76995726114721,508,85,423,69.5187290562938,438.481270943706
"1960","alright alright",3.7662479616328,99,11,88,5.91260406589452,93.0873959341055
"2000","oh girl",3.76218699197842,66,25,41,17.7596553560225,48.2403446439775
"1960","love tonight",3.75903367465883,64,8,56,3.82228949714393,60.1777105028561
"1960","speed",3.75903367465883,64,8,56,3.82228949714393,60.1777105028561
"1980","lasts",3.75807422377485,37,11,26,6.22472192281238,30.7752780771876
"1980","love gonna",3.75338264038288,55,15,40,9.25296502039679,45.7470349796032
"1980","threw",3.75338264038288,55,15,40,9.25296502039679,45.7470349796032
"2000","wonder",3.74907583914605,493,152,341,132.659243795744,360.340756204256
"1990","daddy",3.74803655421339,344,88,256,72.9777753997589,271.022224600241
"2010","baby take",3.74737144776668,45,12,33,6.92832257903053,38.0716774209695
"2010","mind mind",3.74737144776668,45,12,33,6.92832257903053,38.0716774209695
"1960","aint good",3.74473391108515,53,7,46,3.16533348982232,49.8346665101777
"1960","sugar",3.74389769026973,254,23,231,15.16971144179,238.83028855821
"1990","harlem",3.74199346154178,30,11,19,6.36434087788595,23.6356591221141
"1990","hold like",3.74199346154178,30,11,19,6.36434087788595,23.6356591221141
"1990","reminisce",3.74199346154178,30,11,19,6.36434087788595,23.6356591221141
"1990","wanna make love",3.74199346154178,30,11,19,6.36434087788595,23.6356591221141
"1990","youwhen",3.74199346154178,30,11,19,6.36434087788595,23.6356591221141
"2010","bang",3.74175558422898,239,48,191,36.7970910308511,202.202908969149
"2000","know im",3.74005988156026,580,177,403,156.069698583228,423.930301416772
"1980","dont dont",3.73733131213408,93,23,70,15.6459226708527,77.3540773291473
"1980","runs",3.73733131213408,93,23,70,15.6459226708527,77.3540773291473
"2000","make want",3.73456229870999,30,13,17,8.07257061637387,21.9274293836261
"2000","mike",3.73456229870999,30,13,17,8.07257061637387,21.9274293836261
"2000","rewind",3.73456229870999,30,13,17,8.07257061637387,21.9274293836261
"2000","round go",3.73456229870999,30,13,17,8.07257061637387,21.9274293836261
"1990","think time",3.73313803162268,67,21,46,14.2136946272786,52.7863053727214
"2000","aint coming",3.72909212959376,11,6,5,2.95994255933709,8.04005744066292
"2000","aint shit",3.72909212959376,11,6,5,2.95994255933709,8.04005744066292
"2000","alright know",3.72909212959376,11,6,5,2.95994255933709,8.04005744066292
"2000","ass niggas",3.72909212959376,11,6,5,2.95994255933709,8.04005744066292
"2000","away leave",3.72909212959376,11,6,5,2.95994255933709,8.04005744066292
"2000","baby belong",3.72909212959376,11,6,5,2.95994255933709,8.04005744066292
"2000","baby dream",3.72909212959376,11,6,5,2.95994255933709,8.04005744066292
"2000","back girl",3.72909212959376,11,6,5,2.95994255933709,8.04005744066292
"2000","blouse",3.72909212959376,11,6,5,2.95994255933709,8.04005744066292
"2000","bricks",3.72909212959376,11,6,5,2.95994255933709,8.04005744066292
"2000","bursting",3.72909212959376,11,6,5,2.95994255933709,8.04005744066292
"2000","can mend broken",3.72909212959376,11,6,5,2.95994255933709,8.04005744066292
"2000","cant pay",3.72909212959376,11,6,5,2.95994255933709,8.04005744066292
"2000","car keep",3.72909212959376,11,6,5,2.95994255933709,8.04005744066292
"2000","chance get",3.72909212959376,11,6,5,2.95994255933709,8.04005744066292
"2000","chime",3.72909212959376,11,6,5,2.95994255933709,8.04005744066292
"2000","come got",3.72909212959376,11,6,5,2.95994255933709,8.04005744066292
"2000","cool like",3.72909212959376,11,6,5,2.95994255933709,8.04005744066292
"2000","dots",3.72909212959376,11,6,5,2.95994255933709,8.04005744066292
"2000","everything thats",3.72909212959376,11,6,5,2.95994255933709,8.04005744066292
"2000","flaunt",3.72909212959376,11,6,5,2.95994255933709,8.04005744066292
"2000","girl dont need",3.72909212959376,11,6,5,2.95994255933709,8.04005744066292
"2000","got lost",3.72909212959376,11,6,5,2.95994255933709,8.04005744066292
"2000","got takes make",3.72909212959376,11,6,5,2.95994255933709,8.04005744066292
"2000","got wont",3.72909212959376,11,6,5,2.95994255933709,8.04005744066292
"2000","gym",3.72909212959376,11,6,5,2.95994255933709,8.04005744066292
"2000","hate im",3.72909212959376,11,6,5,2.95994255933709,8.04005744066292
"2000","hey ya",3.72909212959376,11,6,5,2.95994255933709,8.04005744066292
"2000","hope one",3.72909212959376,11,6,5,2.95994255933709,8.04005744066292
"2000","icy",3.72909212959376,11,6,5,2.95994255933709,8.04005744066292
"2000","im sittin",3.72909212959376,11,6,5,2.95994255933709,8.04005744066292
"2000","im wit",3.72909212959376,11,6,5,2.95994255933709,8.04005744066292
"2000","ive feeling",3.72909212959376,11,6,5,2.95994255933709,8.04005744066292
"2000","know doesnt",3.72909212959376,11,6,5,2.95994255933709,8.04005744066292
"2000","knows hes",3.72909212959376,11,6,5,2.95994255933709,8.04005744066292
"2000","knows shes",3.72909212959376,11,6,5,2.95994255933709,8.04005744066292
"2000","last dime",3.72909212959376,11,6,5,2.95994255933709,8.04005744066292
"2000","late last night",3.72909212959376,11,6,5,2.95994255933709,8.04005744066292
"2000","latest",3.72909212959376,11,6,5,2.95994255933709,8.04005744066292
"2000","live without live",3.72909212959376,11,6,5,2.95994255933709,8.04005744066292
"2000","live without live without",3.72909212959376,11,6,5,2.95994255933709,8.04005744066292
"2000","man ive",3.72909212959376,11,6,5,2.95994255933709,8.04005744066292
"2000","man knows",3.72909212959376,11,6,5,2.95994255933709,8.04005744066292
"2000","matter hard",3.72909212959376,11,6,5,2.95994255933709,8.04005744066292
"2000","moan",3.72909212959376,11,6,5,2.95994255933709,8.04005744066292
"2000","never looking",3.72909212959376,11,6,5,2.95994255933709,8.04005744066292
"2000","nigga cant",3.72909212959376,11,6,5,2.95994255933709,8.04005744066292
"2000","night lonely",3.72909212959376,11,6,5,2.95994255933709,8.04005744066292
"2000","number two",3.72909212959376,11,6,5,2.95994255933709,8.04005744066292
"2000","oh head",3.72909212959376,11,6,5,2.95994255933709,8.04005744066292
"2000","one knew",3.72909212959376,11,6,5,2.95994255933709,8.04005744066292
"2000","one three",3.72909212959376,11,6,5,2.95994255933709,8.04005744066292
"2000","opens",3.72909212959376,11,6,5,2.95994255933709,8.04005744066292
"2000","phone call",3.72909212959376,11,6,5,2.95994255933709,8.04005744066292
"2000","punches",3.72909212959376,11,6,5,2.95994255933709,8.04005744066292
"2000","show oh",3.72909212959376,11,6,5,2.95994255933709,8.04005744066292
"2000","somewhere far",3.72909212959376,11,6,5,2.95994255933709,8.04005744066292
"2000","sour",3.72909212959376,11,6,5,2.95994255933709,8.04005744066292
"2000","talk god",3.72909212959376,11,6,5,2.95994255933709,8.04005744066292
"2000","tattooed",3.72909212959376,11,6,5,2.95994255933709,8.04005744066292
"2000","think im love",3.72909212959376,11,6,5,2.95994255933709,8.04005744066292
"2000","throw back",3.72909212959376,11,6,5,2.95994255933709,8.04005744066292
"2000","throw em",3.72909212959376,11,6,5,2.95994255933709,8.04005744066292
"2000","time spend",3.72909212959376,11,6,5,2.95994255933709,8.04005744066292
"2000","trying figure",3.72909212959376,11,6,5,2.95994255933709,8.04005744066292
"2000","us along",3.72909212959376,11,6,5,2.95994255933709,8.04005744066292
"2000","way better",3.72909212959376,11,6,5,2.95994255933709,8.04005744066292
"2000","wont hear",3.72909212959376,11,6,5,2.95994255933709,8.04005744066292
"2000","ya want",3.72909212959376,11,6,5,2.95994255933709,8.04005744066292
"2000","yankee",3.72909212959376,11,6,5,2.95994255933709,8.04005744066292
"2000","yeahyeah",3.72909212959376,11,6,5,2.95994255933709,8.04005744066292
"2000","youre new",3.72909212959376,11,6,5,2.95994255933709,8.04005744066292
"2000","fact",3.72493497490276,117,41,76,31.4830254038581,85.5169745961419
"1970","know ill",3.71468826702753,168,32,136,22.9904458296404,145.00955417036
"1970","feel feel",3.71369144739117,67,15,52,9.16880875348756,57.8311912465124
"2010","im really",3.71366954900854,50,13,37,7.69813619892281,42.3018638010772
"2010","right baby",3.71366954900854,50,13,37,7.69813619892281,42.3018638010772
"1960","meaning",3.71350054454271,162,16,146,9.67517028964558,152.324829710354
"1980","tears",3.71287193075381,502,101,401,84.4543352770761,417.545664722924
"1980","make move",3.71178897352692,98,24,74,16.4871013090706,81.5128986909294
"1970","everyday",3.70945906121722,243,44,199,33.2540377178728,209.745962282127
"2000","whoa whoa whoa",3.70932243040179,85,31,54,22.8722834130593,62.1277165869407
"1970","depend",3.70923874884184,45,11,34,6.15815513293941,38.8418448670606
"1970","worries",3.70923874884184,45,11,34,6.15815513293941,38.8418448670606
"2000","telling",3.70859319381008,260,84,176,69.9622786752402,190.03772132476
"1990","baby aint",3.69233119125387,71,22,49,15.0622734109967,55.9377265890033
"2010","back aint",3.68876254911802,22,7,15,3.38717992752604,18.612820072474
"2010","dont know love",3.68876254911802,22,7,15,3.38717992752604,18.612820072474
"2010","dont listen",3.68876254911802,22,7,15,3.38717992752604,18.612820072474
"2010","ever let",3.68876254911802,22,7,15,3.38717992752604,18.612820072474
"2010","mad cause",3.68876254911802,22,7,15,3.38717992752604,18.612820072474
"2010","man thats",3.68876254911802,22,7,15,3.38717992752604,18.612820072474
"2010","turn right",3.68876254911802,22,7,15,3.38717992752604,18.612820072474
"1970","days",3.68793976944485,682,111,571,93.3302622369928,588.669737763007
"2010","keep going",3.68395109458085,31,9,22,4.77284444333215,26.2271555566679
"2010","never knew love",3.68395109458085,31,9,22,4.77284444333215,26.2271555566679
"2010","night oh night",3.68395109458085,31,9,22,4.77284444333215,26.2271555566679
"2010","shoulda",3.68395109458085,31,9,22,4.77284444333215,26.2271555566679
"2010","trade",3.68395109458085,31,9,22,4.77284444333215,26.2271555566679
"2010","want cant",3.68395109458085,31,9,22,4.77284444333215,26.2271555566679
"2000","boy got",3.68054258894024,33,14,19,8.87982767801125,24.1201723219887
"2000","cry cry",3.68054258894024,33,14,19,8.87982767801125,24.1201723219887
"2000","gift",3.68054258894024,33,14,19,8.87982767801125,24.1201723219887
"2000","shoe",3.68054258894024,33,14,19,8.87982767801125,24.1201723219887
"1970","can still",3.6796542977863,56,13,43,7.66348194321348,48.3365180567865
"1980","dont understand",3.67668445776756,108,26,82,18.1694585855064,89.8305414144936
"1980","light",3.67438724549968,1015,194,821,170.759263558232,844.240736441768
"2000","good girl",3.66249840594718,82,30,52,22.0650263514219,59.9349736485781
"1990","baby want",3.65909860315785,75,23,52,15.9108521947149,59.0891478052851
"1980","knowing",3.65498508448809,133,31,102,22.3753517765959,110.624648223404
"1960","dry",3.65431428220218,88,10,78,5.25564805857291,82.7443519414271
"1960","letter",3.65431428220218,88,10,78,5.25564805857291,82.7443519414271
"2010","dawn",3.65275112796404,107,24,83,16.4740114656948,90.5259885343052
"2010","walls",3.65275112796404,107,24,83,16.4740114656948,90.5259885343052
"2000","ever since",3.65192863194137,54,21,33,14.530627109473,39.469372890527
"1970","goin",3.65102040205583,556,92,464,76.0874278647624,479.912572135238
"1970","last night",3.64984935490198,144,28,116,19.7060964254061,124.293903574594
"2000","half",3.6496367470584,230,75,155,61.8897080588663,168.110291941134
"1990","gonna alright",3.64531921421254,41,14,27,8.6979325331108,32.3020674668892
"1990","try make",3.64531921421254,41,14,27,8.6979325331108,32.3020674668892
"1990","world will",3.64531921421254,41,14,27,8.6979325331108,32.3020674668892
"2000","chicken",3.64512705843403,36,15,21,9.68708473964864,26.3129152603514
"2000","know wrong",3.64512705843403,36,15,21,9.68708473964864,26.3129152603514
"1970","sin",3.64466889760043,73,16,57,9.98989610454615,63.0101038954538
"1970","mercy",3.63647668959244,108,22,86,14.7795723190546,93.2204276809454
"1980","get feeling",3.63620500314867,33,10,23,5.55177901223807,27.4482209877619
"1980","look eye",3.63620500314867,33,10,23,5.55177901223807,27.4482209877619
"1980","man man",3.63620500314867,33,10,23,5.55177901223807,27.4482209877619
"1980","one makes",3.63620500314867,33,10,23,5.55177901223807,27.4482209877619
"1980","wanna run",3.63620500314867,33,10,23,5.55177901223807,27.4482209877619
"2000","album",3.63376030042108,51,20,31,13.7233700478356,37.2766299521644
"2000","bags",3.63376030042108,51,20,31,13.7233700478356,37.2766299521644
"1960","think youre",3.62935678501434,163,16,147,9.73489356303845,153.265106436962
"1980","holding",3.62469120845929,299,63,236,50.3024825654298,248.69751743457
"2000","beat goes",3.62409385777331,39,16,23,10.494341801286,28.505658198714
"2000","purple",3.62409385777331,39,16,23,10.494341801286,28.505658198714
"1990","weve",3.62354771243919,427,107,320,90.58578516191,336.41421483809
"1970","drift",3.62075429964156,40,10,30,5.47391567372392,34.5260843262761
"1970","im leaving",3.62075429964156,40,10,30,5.47391567372392,34.5260843262761
"1970","sho",3.62075429964156,40,10,30,5.47391567372392,34.5260843262761
"1970","undercover",3.62075429964156,40,10,30,5.47391567372392,34.5260843262761
"2000","put put",3.62073251679836,48,19,29,12.9161129861982,35.0838870138018
"2000","shaking",3.62073251679836,48,19,29,12.9161129861982,35.0838870138018
"2000","understands",3.62073251679836,48,19,29,12.9161129861982,35.0838870138018
"1960","good thing",3.61922938302753,43,6,37,2.56810075589358,40.4318992441064
"1960","settle",3.61922938302753,43,6,37,2.56810075589358,40.4318992441064
"1960","watched",3.61922938302753,43,6,37,2.56810075589358,40.4318992441064
"1990","know dont",3.61740770315828,243,64,179,51.5511611108762,191.448838889124
"2000","fighting",3.6166763156797,79,29,50,21.2577692897845,57.7422307102155
"2000","ghetto",3.6166763156797,79,29,50,21.2577692897845,57.7422307102155
"2000","course",3.61385318393466,45,18,27,12.1088559245608,32.8911440754392
"2000","people dont",3.61385318393466,45,18,27,12.1088559245608,32.8911440754392
"2000","will take",3.61385318393466,45,18,27,12.1088559245608,32.8911440754392
"2000","baby dont go",3.61130133408828,19,9,10,5.11262805703678,13.8873719429632
"2000","bended",3.61130133408828,19,9,10,5.11262805703678,13.8873719429632
"2000","crazy cause",3.61130133408828,19,9,10,5.11262805703678,13.8873719429632
"2000","dont change",3.61130133408828,19,9,10,5.11262805703678,13.8873719429632
"2000","fight fight",3.61130133408828,19,9,10,5.11262805703678,13.8873719429632
"2000","girl good",3.61130133408828,19,9,10,5.11262805703678,13.8873719429632
"2000","lets play",3.61130133408828,19,9,10,5.11262805703678,13.8873719429632
"2000","like forever",3.61130133408828,19,9,10,5.11262805703678,13.8873719429632
"2000","like wanna",3.61130133408828,19,9,10,5.11262805703678,13.8873719429632
"2000","make man",3.61130133408828,19,9,10,5.11262805703678,13.8873719429632
"2000","open arms",3.61130133408828,19,9,10,5.11262805703678,13.8873719429632
"2000","pain dont",3.61130133408828,19,9,10,5.11262805703678,13.8873719429632
"2000","radar",3.61130133408828,19,9,10,5.11262805703678,13.8873719429632
"2000","sleeve",3.61130133408828,19,9,10,5.11262805703678,13.8873719429632
"2000","tail",3.61130133408828,19,9,10,5.11262805703678,13.8873719429632
"2000","tearin",3.61130133408828,19,9,10,5.11262805703678,13.8873719429632
"2000","trucks",3.61130133408828,19,9,10,5.11262805703678,13.8873719429632
"2000","wont change",3.61130133408828,19,9,10,5.11262805703678,13.8873719429632
"2000","ya like",3.61130133408828,19,9,10,5.11262805703678,13.8873719429632
"1990","carried",3.60990059241203,20,8,12,4.24289391859063,15.7571060814094
"1990","door dont",3.60990059241203,20,8,12,4.24289391859063,15.7571060814094
"1990","drew",3.60990059241203,20,8,12,4.24289391859063,15.7571060814094
"1990","drive night",3.60990059241203,20,8,12,4.24289391859063,15.7571060814094
"1990","everything ive",3.60990059241203,20,8,12,4.24289391859063,15.7571060814094
"1990","fall like",3.60990059241203,20,8,12,4.24289391859063,15.7571060814094
"1990","find time",3.60990059241203,20,8,12,4.24289391859063,15.7571060814094
"1990","get excited",3.60990059241203,20,8,12,4.24289391859063,15.7571060814094
"1990","hold oh",3.60990059241203,20,8,12,4.24289391859063,15.7571060814094
"1990","hope gone",3.60990059241203,20,8,12,4.24289391859063,15.7571060814094
"1990","itnow",3.60990059241203,20,8,12,4.24289391859063,15.7571060814094
"1990","put arms",3.60990059241203,20,8,12,4.24289391859063,15.7571060814094
"1990","stay ill",3.60990059241203,20,8,12,4.24289391859063,15.7571060814094
"1990","stretch",3.60990059241203,20,8,12,4.24289391859063,15.7571060814094
"1990","teddy",3.60990059241203,20,8,12,4.24289391859063,15.7571060814094
"1990","youre gonna make",3.60990059241203,20,8,12,4.24289391859063,15.7571060814094
"1990","love heart",3.6095666906396,56,18,38,11.8801029720538,44.1198970279462
"2000","youre gone",3.60889535467421,124,43,81,33.3666252143453,90.6333747856547
"1990","see im",3.60853849047098,131,37,94,27.7909551667686,103.209044833231
"2000","start",3.6066839302579,753,226,527,202.621522470984,550.378477529016
"1970","leaving",3.59663032092922,200,37,163,27.3695783686196,172.63042163138
"1990","play",3.59549324444781,1125,265,860,238.662782920723,886.337217079277
"1980","show way",3.59347136734043,51,14,37,8.58002210982247,42.4199778901775
"1980","shower",3.59347136734043,51,14,37,8.58002210982247,42.4199778901775
"1970","jesus",3.59163439437503,79,17,62,10.8109834556047,68.1890165443953
"1960","youre love",3.58742791648669,54,7,47,3.22505676321519,50.7749432367848
"2000","want know",3.58727968234861,305,97,208,82.071134599801,222.928865400199
"1990","cant live without",3.58250381612706,91,27,64,19.3051673295874,71.6948326704126
"1990","gangsta",3.58250381612706,91,27,64,19.3051673295874,71.6948326704126
"1970","gonna stop",3.58080292747803,62,14,48,8.48456929427207,53.5154307057279
"1980","bone",3.57923215851343,65,17,48,10.9353222968326,54.0646777031674
"1980","come see",3.57506626265659,42,12,30,7.06590056103027,34.9340994389697
"1980","dont let go dont",3.57506626265659,42,12,30,7.06590056103027,34.9340994389697
"1980","every word",3.57506626265659,42,12,30,7.06590056103027,34.9340994389697
"1980","go dont let go",3.57506626265659,42,12,30,7.06590056103027,34.9340994389697
"1980","say yeah",3.57506626265659,42,12,30,7.06590056103027,34.9340994389697
"1980","stay away",3.57506626265659,42,12,30,7.06590056103027,34.9340994389697
"2010","just live",3.57423008775496,36,10,26,5.54265806322443,30.4573419367756
"2010","like make",3.57423008775496,36,10,26,5.54265806322443,30.4573419367756
"2010","theres place",3.57423008775496,36,10,26,5.54265806322443,30.4573419367756
"1990","booty",3.57418398320262,256,67,189,54.3090421579601,201.69095784204
"1990","watching",3.57418398320262,256,67,189,54.3090421579601,201.69095784204
"1990","run away",3.57398113190183,95,28,67,20.1537461133055,74.8462538866945
"1990","dee",3.57348505179008,115,33,82,24.3966400318961,90.6033599681039
"2010","na na na na",3.56941970952104,831,148,683,127.943023626097,703.056976373903
"1990","alright alright",3.56870706716243,99,29,70,21.0023248970236,77.9976751029764
"1990","ive never",3.56631349965664,103,30,73,21.8509036807418,81.1490963192582
"1970","come along",3.56141858805862,51,12,39,6.97924248399799,44.020757516002
"1970","show way",3.56141858805862,51,12,39,6.97924248399799,44.020757516002
"1960","know dont know",3.55668200580064,77,9,68,4.59869205125129,72.4013079487487
"1960","weather",3.55668200580064,77,9,68,4.59869205125129,72.4013079487487
"2010","ones",3.55479011721107,218,44,174,33.5638738273035,184.436126172697
"1990","blast",3.55418942004287,34,12,22,7.21291966160408,26.7870803383959
"1990","heart mine",3.55418942004287,34,12,22,7.21291966160408,26.7870803383959
"1990","say bye",3.55418942004287,34,12,22,7.21291966160408,26.7870803383959
"1990","totally",3.55418942004287,34,12,22,7.21291966160408,26.7870803383959
"1970","anymore dont",3.55265265270541,20,6,14,2.73695783686196,17.263042163138
"1970","arms tonight",3.55265265270541,20,6,14,2.73695783686196,17.263042163138
"1970","enough just",3.55265265270541,20,6,14,2.73695783686196,17.263042163138
"1970","get night",3.55265265270541,20,6,14,2.73695783686196,17.263042163138
"1970","im high",3.55265265270541,20,6,14,2.73695783686196,17.263042163138
"1970","melting",3.55265265270541,20,6,14,2.73695783686196,17.263042163138
"1970","need somebody lean",3.55265265270541,20,6,14,2.73695783686196,17.263042163138
"1970","oh get",3.55265265270541,20,6,14,2.73695783686196,17.263042163138
"1970","run hide",3.55265265270541,20,6,14,2.73695783686196,17.263042163138
"1970","say right",3.55265265270541,20,6,14,2.73695783686196,17.263042163138
"1970","slow slow",3.55265265270541,20,6,14,2.73695783686196,17.263042163138
"1970","somebody lean",3.55265265270541,20,6,14,2.73695783686196,17.263042163138
"1970","time place",3.55265265270541,20,6,14,2.73695783686196,17.263042163138
"1970","try find",3.55265265270541,20,6,14,2.73695783686196,17.263042163138
"1970","well feel",3.55265265270541,20,6,14,2.73695783686196,17.263042163138
"1990","heavens",3.55088624081668,60,19,41,12.7286817557719,47.2713182442281
"1990","missin",3.55088624081668,60,19,41,12.7286817557719,47.2713182442281
"1990","oh now",3.55088624081668,60,19,41,12.7286817557719,47.2713182442281
"2010","bombs",3.55063164938595,18,6,12,2.77132903161221,15.2286709683878
"2010","cause feel",3.55063164938595,18,6,12,2.77132903161221,15.2286709683878
"2010","code",3.55063164938595,18,6,12,2.77132903161221,15.2286709683878
"2010","crashed",3.55063164938595,18,6,12,2.77132903161221,15.2286709683878
"2010","decision",3.55063164938595,18,6,12,2.77132903161221,15.2286709683878
"2010","forget im",3.55063164938595,18,6,12,2.77132903161221,15.2286709683878
"2010","free cause",3.55063164938595,18,6,12,2.77132903161221,15.2286709683878
"2010","george",3.55063164938595,18,6,12,2.77132903161221,15.2286709683878
"2010","hard like",3.55063164938595,18,6,12,2.77132903161221,15.2286709683878
"2010","man yeah",3.55063164938595,18,6,12,2.77132903161221,15.2286709683878
"2010","need take",3.55063164938595,18,6,12,2.77132903161221,15.2286709683878
"2010","skip",3.55063164938595,18,6,12,2.77132903161221,15.2286709683878
"2010","uhuh",3.55063164938595,18,6,12,2.77132903161221,15.2286709683878
"2010","wont remember",3.55063164938595,18,6,12,2.77132903161221,15.2286709683878
"1970","can help",3.54917865049501,35,9,26,4.78967621450843,30.2103237854916
"1970","dream come",3.54917865049501,35,9,26,4.78967621450843,30.2103237854916
"1970","walk door",3.54917865049501,35,9,26,4.78967621450843,30.2103237854916
"2010","just get",3.54342861892637,113,25,88,17.3977878095656,95.6022121904344
"2010","oh im",3.54342861892637,113,25,88,17.3977878095656,95.6022121904344
"1970","lead",3.54044820733427,188,35,153,25.7274036665024,162.272596333498
"1960","skies",3.53766565832822,89,10,79,5.31537133196578,83.6846286680342
"2000","know time",3.52852515370853,73,27,46,19.6432551665097,53.3567448334902
"1980","got everything",3.527427948859,29,9,20,4.87883610166376,24.1211638983362
"1980","jump jump jump",3.527427948859,29,9,20,4.87883610166376,24.1211638983362
"1980","neon",3.527427948859,29,9,20,4.87883610166376,24.1211638983362
"1990","along way",3.5224872055816,27,10,17,5.72790679009735,21.2720932099026
"1990","cuts",3.5224872055816,27,10,17,5.72790679009735,21.2720932099026
"1990","im make",3.5224872055816,27,10,17,5.72790679009735,21.2720932099026
"1990","offer",3.5224872055816,27,10,17,5.72790679009735,21.2720932099026
"1990","together well",3.5224872055816,27,10,17,5.72790679009735,21.2720932099026
"1980","steal",3.52168011213996,99,24,75,16.6553370367142,82.3446629632858
"1980","theyve",3.50728238648667,104,25,79,17.4965156749321,86.5034843250679
"2010","go lets",3.50712563789196,41,11,30,6.31247168311671,34.6875283168833
"2010","players",3.50712563789196,41,11,30,6.31247168311671,34.6875283168833
"1970","drag",3.50537934253324,68,15,53,9.30565664533066,58.6943433546693
"1970","know ive",3.50537934253324,68,15,53,9.30565664533066,58.6943433546693
"1970","wasted",3.50537934253324,68,15,53,9.30565664533066,58.6943433546693
"1970","bump bump",3.50248501693763,30,8,22,4.10543675529294,25.8945632447071
"1970","dont lose",3.50248501693763,30,8,22,4.10543675529294,25.8945632447071
"1970","heard say",3.50248501693763,30,8,22,4.10543675529294,25.8945632447071
"1970","love night",3.50248501693763,30,8,22,4.10543675529294,25.8945632447071
"1970","way oh",3.50248501693763,30,8,22,4.10543675529294,25.8945632447071
"1980","really",3.49839669695402,1880,347,1533,316.283167969927,1563.71683203007
"1960","thats way",3.49764292974931,204,19,185,12.1835477721463,191.816452227854
"1970","fold",3.4946441460887,25,7,18,3.42119729607745,21.5788027039226
"1970","good things",3.4946441460887,25,7,18,3.42119729607745,21.5788027039226
"1970","makes hard",3.4946441460887,25,7,18,3.42119729607745,21.5788027039226
"1970","oh one",3.4946441460887,25,7,18,3.42119729607745,21.5788027039226
"1970","time ago",3.4946441460887,25,7,18,3.42119729607745,21.5788027039226
"1970","well always",3.4946441460887,25,7,18,3.42119729607745,21.5788027039226
"1980","stop dont",3.49160920385659,56,15,41,9.42120074804036,46.5787992519596
"1990","brand",3.48969483721196,148,41,107,31.3974149975707,116.602585002429
"2000","thatll",3.48649119350897,70,26,44,18.8359981048724,51.1640018951276
"2010","brain",3.48184167313275,108,24,84,16.6279741896733,91.3720258103267
"2010","can hear",3.48184167313275,108,24,84,16.6279741896733,91.3720258103267
"1960","beneath",3.47996648639556,66,8,58,3.94173604392968,62.0582639560703
"1960","smilin",3.47996648639556,66,8,58,3.94173604392968,62.0582639560703
"1960","theyd",3.47996648639556,66,8,58,3.94173604392968,62.0582639560703
"2010","dont keep",3.4745618747664,27,8,19,4.15699354741832,22.8430064525817
"2010","dudes",3.4745618747664,27,8,19,4.15699354741832,22.8430064525817
"2010","either way",3.4745618747664,27,8,19,4.15699354741832,22.8430064525817
"2010","frozen",3.4745618747664,27,8,19,4.15699354741832,22.8430064525817
"2010","hoped",3.4745618747664,27,8,19,4.15699354741832,22.8430064525817
"2010","level",3.4745618747664,27,8,19,4.15699354741832,22.8430064525817
"2010","now girl",3.4745618747664,27,8,19,4.15699354741832,22.8430064525817
"2010","say cause",3.4745618747664,27,8,19,4.15699354741832,22.8430064525817
"2010","squad",3.4745618747664,27,8,19,4.15699354741832,22.8430064525817
"2010","stand oh",3.4745618747664,27,8,19,4.15699354741832,22.8430064525817
"2010","ups",3.4745618747664,27,8,19,4.15699354741832,22.8430064525817
"2010","video",3.4745618747664,27,8,19,4.15699354741832,22.8430064525817
"2010","words love",3.4745618747664,27,8,19,4.15699354741832,22.8430064525817
"1990","now know",3.47435032781703,177,48,129,37.5496111795271,139.450388820473
"2010","im saying",3.4693873849208,46,12,34,7.08228530300899,38.917714696991
"2010","know tonight",3.4693873849208,46,12,34,7.08228530300899,38.917714696991
"2010","want want want",3.4693873849208,46,12,34,7.08228530300899,38.917714696991
"2010","youve done",3.4693873849208,46,12,34,7.08228530300899,38.917714696991
"1990","feel im",3.46464887033301,68,21,47,14.4258393232082,53.5741606767919
"1990","seemed",3.46464887033301,68,21,47,14.4258393232082,53.5741606767919
"2000","disrespect",3.46111879915513,22,10,12,5.91988511867417,16.0801148813258
"2000","get loose",3.46111879915513,22,10,12,5.91988511867417,16.0801148813258
"2000","just cant believe",3.46111879915513,22,10,12,5.91988511867417,16.0801148813258
"2000","let fall",3.46111879915513,22,10,12,5.91988511867417,16.0801148813258
"2000","let play",3.46111879915513,22,10,12,5.91988511867417,16.0801148813258
"2000","like sugar",3.46111879915513,22,10,12,5.91988511867417,16.0801148813258
"2000","look mirror",3.46111879915513,22,10,12,5.91988511867417,16.0801148813258
"2000","looking back",3.46111879915513,22,10,12,5.91988511867417,16.0801148813258
"2000","mani",3.46111879915513,22,10,12,5.91988511867417,16.0801148813258
"2000","nut",3.46111879915513,22,10,12,5.91988511867417,16.0801148813258
"2000","riches",3.46111879915513,22,10,12,5.91988511867417,16.0801148813258
"2000","things ive",3.46111879915513,22,10,12,5.91988511867417,16.0801148813258
"2000","trying find",3.46111879915513,22,10,12,5.91988511867417,16.0801148813258
"2000","wack",3.46111879915513,22,10,12,5.91988511867417,16.0801148813258
"2010","spark",3.45276187518544,51,13,38,7.85209892290127,43.1479010770987
"1960","follow",3.45062612588966,218,20,198,13.0196735996465,204.980326400354
"1970","horse",3.45003167818051,46,11,35,6.29500302478251,39.7049969752175
"1970","said love",3.45003167818051,46,11,35,6.29500302478251,39.7049969752175
"1970","im talking",3.44798689794098,74,16,58,10.1267439963892,63.8732560036107
"1990","guess im",3.44661844388751,49,16,33,10.3950901005471,38.604909899453
"1990","jealous",3.44661844388751,49,16,33,10.3950901005471,38.604909899453
"1990","love make",3.44661844388751,49,16,33,10.3950901005471,38.604909899453
"1990","see way",3.44661844388751,49,16,33,10.3950901005471,38.604909899453
"1990","youre always",3.44661844388751,49,16,33,10.3950901005471,38.604909899453
"2000","twist",3.44605849767075,67,25,42,18.028741043235,48.971258956765
"2010","show",3.4438939207424,1443,248,1195,222.168210700912,1220.83178929909
"1990","arrow",3.44082078216713,17,7,10,3.60645983080204,13.393540169198
"1990","bat",3.44082078216713,17,7,10,3.60645983080204,13.393540169198
"1990","can barely",3.44082078216713,17,7,10,3.60645983080204,13.393540169198
"1990","can see can",3.44082078216713,17,7,10,3.60645983080204,13.393540169198
"1990","cry cause",3.44082078216713,17,7,10,3.60645983080204,13.393540169198
"1990","feel way feel",3.44082078216713,17,7,10,3.60645983080204,13.393540169198
"1990","healthy",3.44082078216713,17,7,10,3.60645983080204,13.393540169198
"1990","life take",3.44082078216713,17,7,10,3.60645983080204,13.393540169198
"1990","medont",3.44082078216713,17,7,10,3.60645983080204,13.393540169198
"1990","now forever",3.44082078216713,17,7,10,3.60645983080204,13.393540169198
"1990","roll roll roll",3.44082078216713,17,7,10,3.60645983080204,13.393540169198
"1990","socks",3.44082078216713,17,7,10,3.60645983080204,13.393540169198
"1990","sweet lovin",3.44082078216713,17,7,10,3.60645983080204,13.393540169198
"1990","take us",3.44082078216713,17,7,10,3.60645983080204,13.393540169198
"1990","time close",3.44082078216713,17,7,10,3.60645983080204,13.393540169198
"1990","yeahits",3.44082078216713,17,7,10,3.60645983080204,13.393540169198
"1990","youre dont",3.44082078216713,17,7,10,3.60645983080204,13.393540169198
"1970","rhythm",3.43865695515098,252,45,207,34.4856687444607,217.514331255539
"1980","dont cry dont",3.43776436178992,25,8,17,4.20589319108945,20.7941068089106
"1980","get want",3.43776436178992,25,8,17,4.20589319108945,20.7941068089106
"1980","gonna hold",3.43776436178992,25,8,17,4.20589319108945,20.7941068089106
"1980","hear song",3.43776436178992,25,8,17,4.20589319108945,20.7941068089106
"1980","im tellin",3.43776436178992,25,8,17,4.20589319108945,20.7941068089106
"1980","like little",3.43776436178992,25,8,17,4.20589319108945,20.7941068089106
"1980","sweetheart",3.43776436178992,25,8,17,4.20589319108945,20.7941068089106
"1980","tears im",3.43776436178992,25,8,17,4.20589319108945,20.7941068089106
"1980","till break",3.43776436178992,25,8,17,4.20589319108945,20.7941068089106
"1980","want taste",3.43776436178992,25,8,17,4.20589319108945,20.7941068089106
"2000","really need",3.43607344921209,115,40,75,30.9448540294332,84.0551459705668
"1960","cure",3.43563917033803,55,7,48,3.28478003660807,51.7152199633919
"1960","im gonna love",3.43563917033803,55,7,48,3.28478003660807,51.7152199633919
"1960","just got",3.43563917033803,55,7,48,3.28478003660807,51.7152199633919
"1980","will still",3.43546403402358,47,13,34,7.90707919924816,39.0929208007518
"1960","chase",3.43295185223242,78,9,69,4.65841532464417,73.3415846753558
"1960","filled",3.43295185223242,78,9,69,4.65841532464417,73.3415846753558
"1980","got moves",3.43203481695913,38,11,27,6.39295765045596,31.607042349544
"1980","mas",3.43203481695913,38,11,27,6.39295765045596,31.607042349544
"1980","shape",3.43203481695913,38,11,27,6.39295765045596,31.607042349544
"1980","spend life",3.43203481695913,38,11,27,6.39295765045596,31.607042349544
"1980","travel",3.43203481695913,38,11,27,6.39295765045596,31.607042349544
"1960","lovely",3.42776145372034,127,13,114,7.58485572089499,119.415144279105
"2010","moonlight",3.42158018808825,103,23,80,15.858160569781,87.141839430219
"1970","far away",3.41874810664113,158,30,128,21.6219669112095,136.378033088791
"1980","changing",3.41086274828353,61,16,45,10.2623793862583,50.7376206137417
"1980","now oh",3.41086274828353,61,16,45,10.2623793862583,50.7376206137417
"1980","turn back",3.41086274828353,61,16,45,10.2623793862583,50.7376206137417
"1990","cant escape",3.41062234935035,38,13,25,8.0614984453222,29.9385015546778
"1990","sensation",3.41062234935035,38,13,25,8.0614984453222,29.9385015546778
"1990","team",3.40932567466118,76,23,53,16.1229968906444,59.8770031093556
"2000","mood",3.40744883097759,64,24,40,17.2214839815976,46.7785160184024
"2000","speed",3.40744883097759,64,24,40,17.2214839815976,46.7785160184024
"1960","across",3.40581823742131,192,18,174,11.4668684914318,180.533131508568
"1990","games",3.40523904666659,165,45,120,35.0038748283727,129.996125171627
"1990","together",3.40370212151963,954,226,728,202.386039916773,751.613960083227
"1980","love dont",3.39621599300294,280,59,221,47.1060037402018,232.893996259798
"1990","youd",3.39253602192001,412,103,309,87.403614722967,324.596385277033
"1990","nothing",3.39206145145165,1236,289,947,262.210844168901,973.789155831099
"1990","one else",3.387151389428,120,34,86,25.4573635115438,94.5426364884562
"1960","hurt",3.38452348056303,542,43,499,32.3700141789377,509.629985821062
"1980","bad make",3.37762665857744,21,7,14,3.53295028051514,17.4670497194849
"1980","dies",3.37762665857744,21,7,14,3.53295028051514,17.4670497194849
"1980","display",3.37762665857744,21,7,14,3.53295028051514,17.4670497194849
"1980","every move make",3.37762665857744,21,7,14,3.53295028051514,17.4670497194849
"1980","every step take",3.37762665857744,21,7,14,3.53295028051514,17.4670497194849
"1980","glance",3.37762665857744,21,7,14,3.53295028051514,17.4670497194849
"1980","gonna turn",3.37762665857744,21,7,14,3.53295028051514,17.4670497194849
"1980","like us",3.37762665857744,21,7,14,3.53295028051514,17.4670497194849
"1980","live dont",3.37762665857744,21,7,14,3.53295028051514,17.4670497194849
"1980","music play",3.37762665857744,21,7,14,3.53295028051514,17.4670497194849
"1980","oh oh dont",3.37762665857744,21,7,14,3.53295028051514,17.4670497194849
"1980","still dont",3.37762665857744,21,7,14,3.53295028051514,17.4670497194849
"1980","together cant",3.37762665857744,21,7,14,3.53295028051514,17.4670497194849
"1980","will catch",3.37762665857744,21,7,14,3.53295028051514,17.4670497194849
"1990","really dont",3.37634084728944,84,25,59,17.8201544580807,66.1798455419193
"1990","aint good",3.37596232037631,53,17,36,11.2436688842652,41.7563311157348
"1990","heart soul",3.37596232037631,53,17,36,11.2436688842652,41.7563311157348
"2010","deep",3.37462740428716,606,110,496,93.3014107309445,512.698589269055
"2000","boom boom boom",3.37092695635358,61,23,38,16.4142269199602,44.5857730800398
"2000","hard say",3.37092695635358,61,23,38,16.4142269199602,44.5857730800398
"1970","york",3.36848272082212,177,33,144,24.2220768562283,152.777923143772
"1980","boy play",3.36676214789738,17,6,11,2.86000736994083,14.1399926300592
"1980","bring love",3.36676214789738,17,6,11,2.86000736994083,14.1399926300592
"1980","can see can",3.36676214789738,17,6,11,2.86000736994083,14.1399926300592
"1980","clearer",3.36676214789738,17,6,11,2.86000736994083,14.1399926300592
"1980","dreams made",3.36676214789738,17,6,11,2.86000736994083,14.1399926300592
"1980","ever change",3.36676214789738,17,6,11,2.86000736994083,14.1399926300592
"1980","every word say",3.36676214789738,17,6,11,2.86000736994083,14.1399926300592
"1980","feel thing",3.36676214789738,17,6,11,2.86000736994083,14.1399926300592
"1980","forever baby",3.36676214789738,17,6,11,2.86000736994083,14.1399926300592
"1980","gonna hurt",3.36676214789738,17,6,11,2.86000736994083,14.1399926300592
"1980","got rhythm",3.36676214789738,17,6,11,2.86000736994083,14.1399926300592
"1980","hasnt",3.36676214789738,17,6,11,2.86000736994083,14.1399926300592
"1980","heaven sent",3.36676214789738,17,6,11,2.86000736994083,14.1399926300592
"1980","just oh",3.36676214789738,17,6,11,2.86000736994083,14.1399926300592
"1980","never win",3.36676214789738,17,6,11,2.86000736994083,14.1399926300592
"1980","nowhere run",3.36676214789738,17,6,11,2.86000736994083,14.1399926300592
"1980","reputation",3.36676214789738,17,6,11,2.86000736994083,14.1399926300592
"1980","said never",3.36676214789738,17,6,11,2.86000736994083,14.1399926300592
"1980","say youve",3.36676214789738,17,6,11,2.86000736994083,14.1399926300592
"1980","someone will",3.36676214789738,17,6,11,2.86000736994083,14.1399926300592
"1980","sweet lovin",3.36676214789738,17,6,11,2.86000736994083,14.1399926300592
"1980","thinking baby",3.36676214789738,17,6,11,2.86000736994083,14.1399926300592
"1980","ton",3.36676214789738,17,6,11,2.86000736994083,14.1399926300592
"1980","way love baby",3.36676214789738,17,6,11,2.86000736994083,14.1399926300592
"2000","checking",3.3603222811574,25,11,14,6.72714218031156,18.2728578196884
"2000","confidence",3.3603222811574,25,11,14,6.72714218031156,18.2728578196884
"2000","dance cant",3.3603222811574,25,11,14,6.72714218031156,18.2728578196884
"2000","dont cry dont",3.3603222811574,25,11,14,6.72714218031156,18.2728578196884
"2000","dont love dont",3.3603222811574,25,11,14,6.72714218031156,18.2728578196884
"2000","droppin",3.3603222811574,25,11,14,6.72714218031156,18.2728578196884
"2000","frame",3.3603222811574,25,11,14,6.72714218031156,18.2728578196884
"2000","lonely dont",3.3603222811574,25,11,14,6.72714218031156,18.2728578196884
"2000","say ill",3.3603222811574,25,11,14,6.72714218031156,18.2728578196884
"2000","see whats",3.3603222811574,25,11,14,6.72714218031156,18.2728578196884
"2000","tonight cause",3.3603222811574,25,11,14,6.72714218031156,18.2728578196884
"2000","version",3.3603222811574,25,11,14,6.72714218031156,18.2728578196884
"1990","best friend",3.36002790208778,92,27,65,19.5173120255169,72.4826879744831
"1990","coast",3.36002790208778,92,27,65,19.5173120255169,72.4826879744831
"2000","know youre",3.35892660256986,448,138,310,120.550387871183,327.449612128817
"2000","aka",3.35846132204972,14,7,7,3.76719962097447,10.2328003790255
"2000","away night",3.35846132204972,14,7,7,3.76719962097447,10.2328003790255
"2000","back everybody",3.35846132204972,14,7,7,3.76719962097447,10.2328003790255
"2000","booze",3.35846132204972,14,7,7,3.76719962097447,10.2328003790255
"2000","break rules",3.35846132204972,14,7,7,3.76719962097447,10.2328003790255
"2000","cant like",3.35846132204972,14,7,7,3.76719962097447,10.2328003790255
"2000","come shake",3.35846132204972,14,7,7,3.76719962097447,10.2328003790255
"2000","dealer",3.35846132204972,14,7,7,3.76719962097447,10.2328003790255
"2000","dome",3.35846132204972,14,7,7,3.76719962097447,10.2328003790255
"2000","enough dont",3.35846132204972,14,7,7,3.76719962097447,10.2328003790255
"2000","everything got",3.35846132204972,14,7,7,3.76719962097447,10.2328003790255
"2000","everything know",3.35846132204972,14,7,7,3.76719962097447,10.2328003790255
"2000","football",3.35846132204972,14,7,7,3.76719962097447,10.2328003790255
"2000","go day",3.35846132204972,14,7,7,3.76719962097447,10.2328003790255
"2000","hater",3.35846132204972,14,7,7,3.76719962097447,10.2328003790255
"2000","know can know",3.35846132204972,14,7,7,3.76719962097447,10.2328003790255
"2000","love baby baby baby",3.35846132204972,14,7,7,3.76719962097447,10.2328003790255
"2000","make alright",3.35846132204972,14,7,7,3.76719962097447,10.2328003790255
"2000","nate",3.35846132204972,14,7,7,3.76719962097447,10.2328003790255
"2000","nobody like",3.35846132204972,14,7,7,3.76719962097447,10.2328003790255
"2000","now im back",3.35846132204972,14,7,7,3.76719962097447,10.2328003790255
"2000","overwhelmed",3.35846132204972,14,7,7,3.76719962097447,10.2328003790255
"2000","pick phone",3.35846132204972,14,7,7,3.76719962097447,10.2328003790255
"2000","promise youll",3.35846132204972,14,7,7,3.76719962097447,10.2328003790255
"2000","right direction",3.35846132204972,14,7,7,3.76719962097447,10.2328003790255
"2000","ropes",3.35846132204972,14,7,7,3.76719962097447,10.2328003790255
"2000","satellite",3.35846132204972,14,7,7,3.76719962097447,10.2328003790255
"2000","scary",3.35846132204972,14,7,7,3.76719962097447,10.2328003790255
"2000","see thats",3.35846132204972,14,7,7,3.76719962097447,10.2328003790255
"2000","something way",3.35846132204972,14,7,7,3.76719962097447,10.2328003790255
"2000","sound voice",3.35846132204972,14,7,7,3.76719962097447,10.2328003790255
"2000","sun im",3.35846132204972,14,7,7,3.76719962097447,10.2328003790255
"2000","tables",3.35846132204972,14,7,7,3.76719962097447,10.2328003790255
"2000","texas",3.35846132204972,14,7,7,3.76719962097447,10.2328003790255
"2000","thing get",3.35846132204972,14,7,7,3.76719962097447,10.2328003790255
"2000","thought knew",3.35846132204972,14,7,7,3.76719962097447,10.2328003790255
"2000","wanna put",3.35846132204972,14,7,7,3.76719962097447,10.2328003790255
"2000","work baby",3.35846132204972,14,7,7,3.76719962097447,10.2328003790255
"2000","young boy",3.35846132204972,14,7,7,3.76719962097447,10.2328003790255
"2010","dont make",3.35640352336279,125,27,98,19.245340497307,105.754659502693
"1960","pray",3.35491052965639,206,19,187,12.302994318932,193.697005681068
"2000","ends",3.35453991511524,135,46,89,36.3265677736824,98.6734322263176
"1970","im coming",3.35029573669061,92,19,73,12.590006049565,79.409993950435
"1970","say youre",3.35029573669061,92,19,73,12.590006049565,79.409993950435
"1980","working",3.34900985306549,140,32,108,23.5530018701009,116.446998129899
"1970","beyond",3.34789363399961,41,10,31,5.61076356556702,35.389236434433
"1970","grace",3.34789363399961,41,10,31,5.61076356556702,35.389236434433
"1960","believe believe",3.34677270705401,67,8,59,4.00145931732255,62.9985406826774
"1980","huh huh",3.34665587474226,66,17,49,11.1035580244761,54.8964419755239
"2010","get come",3.34530969616322,32,9,23,4.9268071673106,27.0731928326894
"2010","make work",3.34530969616322,32,9,23,4.9268071673106,27.0731928326894
"2010","baby please",3.34301733101586,77,18,59,11.8551297463411,65.1448702536589
"1990","let",3.34019461922533,4927,1098,3829,1045.2369168448,3881.7630831552
"1990","taste",3.33689920375913,224,59,165,47.5204118882151,176.479588111785
"1980","sheets",3.32737418588621,52,14,38,8.74825783746605,43.251742162534
"1980","give give",3.32573815196566,125,29,96,21.0294659554472,103.970534044553
"1980","kept",3.32573815196566,125,29,96,21.0294659554472,103.970534044553
"1970","love ya",3.32516302112053,52,12,40,7.11609037584109,44.8839096241589
"1970","many things",3.32516302112053,52,12,40,7.11609037584109,44.8839096241589
"1970","want take",3.32516302112053,52,12,40,7.11609037584109,44.8839096241589
"1990","baby baby im",3.32412107754956,31,11,20,6.57648557381548,24.4235144261845
"1990","eagle",3.32412107754956,31,11,20,6.57648557381548,24.4235144261845
"1990","say bye bye",3.32412107754956,31,11,20,6.57648557381548,24.4235144261845
"1990","till end",3.32412107754956,31,11,20,6.57648557381548,24.4235144261845
"1980","hour",3.32343951580719,110,26,84,18.5059300407936,91.4940699592064
"1980","shed",3.32138631924758,115,27,88,19.3471086790115,95.6528913209885
"2000","trying",3.31848952250729,504,154,350,135.619186355081,368.380813644919
"1960","sun",3.31765705835393,675,52,623,40.3132095401899,634.68679045981
"1970","floor",3.31643697025697,648,105,543,88.6774339143275,559.322566085673
"1960","beg",3.31283587986704,91,10,81,5.43481787875153,85.5651821212485
"1960","waited",3.31256649257729,79,9,70,4.71813859803704,74.281861401963
"2010","head",3.30806659228721,1158,201,957,178.288834367052,979.711165632948
"1990","baby lets get",3.30695024108088,24,9,15,5.09147270230876,18.9085272976912
"1990","finest",3.30695024108088,24,9,15,5.09147270230876,18.9085272976912
"1990","helped",3.30695024108088,24,9,15,5.09147270230876,18.9085272976912
"1990","ill never leave",3.30695024108088,24,9,15,5.09147270230876,18.9085272976912
"1990","turn head",3.30695024108088,24,9,15,5.09147270230876,18.9085272976912
"1990","yeah give",3.30695024108088,24,9,15,5.09147270230876,18.9085272976912
"2010","thats just",3.30586530551174,93,21,72,14.3185333299964,78.6814666700036
"2000","ending",3.3054899929664,55,21,34,14.7997127966854,40.2002872033146
"1960","baby oh",3.30439661989342,154,15,139,9.19738410250259,144.802615897497
"2010","bank",3.30260917976267,72,17,55,11.0853161264489,60.9146838735512
"1990","area",3.29946686245088,14,6,8,2.97002574301344,11.0299742569866
"1990","away everything",3.29946686245088,14,6,8,2.97002574301344,11.0299742569866
"1990","back everybody",3.29946686245088,14,6,8,2.97002574301344,11.0299742569866
"1990","back place",3.29946686245088,14,6,8,2.97002574301344,11.0299742569866
"1990","beggin baby",3.29946686245088,14,6,8,2.97002574301344,11.0299742569866
"1990","boy aint",3.29946686245088,14,6,8,2.97002574301344,11.0299742569866
"1990","came true",3.29946686245088,14,6,8,2.97002574301344,11.0299742569866
"1990","can hang",3.29946686245088,14,6,8,2.97002574301344,11.0299742569866
"1990","couldnt hold",3.29946686245088,14,6,8,2.97002574301344,11.0299742569866
"1990","deserves",3.29946686245088,14,6,8,2.97002574301344,11.0299742569866
"1990","discover",3.29946686245088,14,6,8,2.97002574301344,11.0299742569866
"1990","djs",3.29946686245088,14,6,8,2.97002574301344,11.0299742569866
"1990","dome",3.29946686245088,14,6,8,2.97002574301344,11.0299742569866
"1990","dont get wrong",3.29946686245088,14,6,8,2.97002574301344,11.0299742569866
"1990","dont got",3.29946686245088,14,6,8,2.97002574301344,11.0299742569866
"1990","dues",3.29946686245088,14,6,8,2.97002574301344,11.0299742569866
"1990","far can",3.29946686245088,14,6,8,2.97002574301344,11.0299742569866
"1990","gonna push",3.29946686245088,14,6,8,2.97002574301344,11.0299742569866
"1990","hear voices",3.29946686245088,14,6,8,2.97002574301344,11.0299742569866
"1990","im deep",3.29946686245088,14,6,8,2.97002574301344,11.0299742569866
"1990","itbaby",3.29946686245088,14,6,8,2.97002574301344,11.0299742569866
"1990","know sometimes",3.29946686245088,14,6,8,2.97002574301344,11.0299742569866
"1990","life goes",3.29946686245088,14,6,8,2.97002574301344,11.0299742569866
"1990","look eyes know",3.29946686245088,14,6,8,2.97002574301344,11.0299742569866
"1990","makes wonder",3.29946686245088,14,6,8,2.97002574301344,11.0299742569866
"1990","mattered",3.29946686245088,14,6,8,2.97002574301344,11.0299742569866
"1990","much know",3.29946686245088,14,6,8,2.97002574301344,11.0299742569866
"1990","oh yeahi",3.29946686245088,14,6,8,2.97002574301344,11.0299742569866
"1990","see aint",3.29946686245088,14,6,8,2.97002574301344,11.0299742569866
"1990","sleeping bed",3.29946686245088,14,6,8,2.97002574301344,11.0299742569866
"1990","someone whos",3.29946686245088,14,6,8,2.97002574301344,11.0299742569866
"1990","sooner later",3.29946686245088,14,6,8,2.97002574301344,11.0299742569866
"1990","thing get",3.29946686245088,14,6,8,2.97002574301344,11.0299742569866
"1990","vivir",3.29946686245088,14,6,8,2.97002574301344,11.0299742569866
"1990","walking street",3.29946686245088,14,6,8,2.97002574301344,11.0299742569866
"1990","want none",3.29946686245088,14,6,8,2.97002574301344,11.0299742569866
"1990","watch step",3.29946686245088,14,6,8,2.97002574301344,11.0299742569866
"1990","wonders",3.29946686245088,14,6,8,2.97002574301344,11.0299742569866
"1990","work baby",3.29946686245088,14,6,8,2.97002574301344,11.0299742569866
"1990","world wont",3.29946686245088,14,6,8,2.97002574301344,11.0299742569866
"1990","ya feel",3.29946686245088,14,6,8,2.97002574301344,11.0299742569866
"1990","yo im",3.29946686245088,14,6,8,2.97002574301344,11.0299742569866
"1990","dont hear",3.29912421426314,42,14,28,8.91007722904033,33.0899227709597
"1990","easier",3.29912421426314,42,14,28,8.91007722904033,33.0899227709597
"2000","saying",3.29630797355351,314,99,215,84.4929057847131,229.507094215287
"1980","wanna tell",3.29565041344969,71,18,53,11.944736662694,59.055263337306
"1980","dont just",3.29545071959818,34,10,24,5.72001473988165,28.2799852601184
"1980","guess ill",3.29545071959818,34,10,24,5.72001473988165,28.2799852601184
"1980","ill anything",3.29545071959818,34,10,24,5.72001473988165,28.2799852601184
"1980","lesson",3.29545071959818,34,10,24,5.72001473988165,28.2799852601184
"1980","said goodbye",3.29545071959818,34,10,24,5.72001473988165,28.2799852601184
"1980","time one",3.29545071959818,34,10,24,5.72001473988165,28.2799852601184
"2000","appreciate",3.29324543219757,28,12,16,7.53439924194894,20.4656007580511
"2000","make make make",3.29324543219757,28,12,16,7.53439924194894,20.4656007580511
"2000","missy",3.29324543219757,28,12,16,7.53439924194894,20.4656007580511
"2000","mmm mmm mmm",3.29324543219757,28,12,16,7.53439924194894,20.4656007580511
"2000","oh never",3.29324543219757,28,12,16,7.53439924194894,20.4656007580511
"2000","ready cause",3.29324543219757,28,12,16,7.53439924194894,20.4656007580511
"2000","replace",3.29324543219757,28,12,16,7.53439924194894,20.4656007580511
"2000","shouldve known",3.29324543219757,28,12,16,7.53439924194894,20.4656007580511
"2000","throat",3.29324543219757,28,12,16,7.53439924194894,20.4656007580511
"2000","time turn",3.29324543219757,28,12,16,7.53439924194894,20.4656007580511
"2000","world world",3.29324543219757,28,12,16,7.53439924194894,20.4656007580511
"1960","hed",3.28915446532646,56,7,49,3.34450331000094,52.6554966899991
"1960","now ill",3.28915446532646,56,7,49,3.34450331000094,52.6554966899991
"1960","release",3.28915446532646,56,7,49,3.34450331000094,52.6554966899991
"2000","weather",3.28741623152047,77,28,49,20.7195979153596,56.2804020846404
"2000","wheel",3.28741623152047,77,28,49,20.7195979153596,56.2804020846404
"1980","dark",3.28726278471169,329,68,261,55.3495543947371,273.650445605263
"1980","claim",3.2798804367632,43,12,31,7.23413628867385,35.7658637113261
"1980","let go dont let",3.2798804367632,43,12,31,7.23413628867385,35.7658637113261
"1980","like child",3.2798804367632,43,12,31,7.23413628867385,35.7658637113261
"1960","come easy",3.27902234392391,45,6,39,2.68754730267933,42.3124526973207
"1960","day every",3.27902234392391,45,6,39,2.68754730267933,42.3124526973207
"2010","get close",3.27761336046054,23,7,16,3.5411426515045,19.4588573484955
"2010","give baby",3.27761336046054,23,7,16,3.5411426515045,19.4588573484955
"2010","know good",3.27761336046054,23,7,16,3.5411426515045,19.4588573484955
"2010","lap",3.27761336046054,23,7,16,3.5411426515045,19.4588573484955
"2010","loca",3.27761336046054,23,7,16,3.5411426515045,19.4588573484955
"2010","love deep love",3.27761336046054,23,7,16,3.5411426515045,19.4588573484955
"2010","obsessed",3.27761336046054,23,7,16,3.5411426515045,19.4588573484955
"2010","want back",3.27595483615258,131,28,103,20.1691168411778,110.830883158822
"2010","forever forever",3.26822262574979,37,10,27,5.69662078720288,31.3033792127971
"2010","get got",3.26822262574979,37,10,27,5.69662078720288,31.3033792127971
"2010","like bad",3.26822262574979,37,10,27,5.69662078720288,31.3033792127971
"2000","bring back",3.26456382659046,106,37,69,28.523082844521,77.476917155479
"1980","something",3.26314776164627,1202,226,976,202.219344627581,999.780655372419
"1970","looked",3.26231581048598,203,37,166,27.7801220441489,175.219877955851
"1980","across",3.25916270138851,192,42,150,32.301259707567,159.698740292433
"1970","right time",3.25876151584842,75,16,59,10.2635918882323,64.7364081117677
"1970","let make",3.25867886967739,36,9,27,4.92652410635153,31.0734758936485
"1980","turn",3.25472647366399,1733,320,1413,291.552516006321,1441.44748399368
"2010","let get",3.25332996881253,104,23,81,16.0121232937595,87.9878767062406
"2000","get high",3.25324320017222,49,19,30,13.1851986734107,35.8148013265894
"2000","see way",3.25324320017222,49,19,30,13.1851986734107,35.8148013265894
"2000","wood",3.25324320017222,49,19,30,13.1851986734107,35.8148013265894
"2000","another man",3.25024619725474,31,13,18,8.34165630358633,22.6583436964137
"2000","like cant",3.25024619725474,31,13,18,8.34165630358633,22.6583436964137
"2000","months",3.25024619725474,31,13,18,8.34165630358633,22.6583436964137
"2000","still feel",3.25024619725474,31,13,18,8.34165630358633,22.6583436964137
"1980","dont know dont know",3.24290490870458,57,15,42,9.58943647568394,47.4105635243161
"2000","can keep",3.2397539414492,74,27,47,19.9123408537222,54.0876591462778
"2010","champagne",3.2380943193023,62,15,47,9.54568888666429,52.4543111133357
"1990","baby thats",3.23771302485074,65,20,45,13.7894052354196,51.2105947645804
"1970","la la",3.23678609542939,1558,238,1320,213.209015491547,1344.79098450845
"1960","alone",3.2339965166545,975,72,903,58.2301915580521,916.769808441948
"2000","want leave",3.23364868238825,46,18,28,12.3779416117733,33.6220583882267
"1980","lose",3.22894603416539,684,133,551,115.073237708207,568.926762291793
"1980","rain",3.22887499123482,767,148,619,129.036803102624,637.963196897376
"2000","wishing",3.2284218525901,90,32,58,24.2177118491216,65.7822881508784
"1960","shes got",3.22833356319087,168,16,152,10.0335099300028,157.966490069997
"1970","love im",3.2267379901238,267,47,220,36.5383871221071,230.461612877893
"2010","wanna kiss",3.22553466790283,42,11,31,6.46643440709516,35.5335655929048
"2000","foreign",3.22505379620777,34,14,20,9.14891336522372,24.8510866347763
"2000","give dont",3.22505379620777,34,14,20,9.14891336522372,24.8510866347763
"2000","look im",3.22505379620777,34,14,20,9.14891336522372,24.8510866347763
"2000","path",3.22505379620777,34,14,20,9.14891336522372,24.8510866347763
"2000","say yes",3.22505379620777,34,14,20,9.14891336522372,24.8510866347763
"1970","shoes",3.22354951968032,172,32,140,23.5378373970128,148.462162602987
"1960","take time",3.22329895266721,155,15,140,9.25710737589546,145.742892624105
"1970","die",3.21986579336461,516,85,431,70.6135121910385,445.386487808961
"2000","onto",3.21959802904574,43,17,26,11.5706845501359,31.4293154498641
"2010","wont let",3.21563578001906,221,44,177,34.0257619992388,186.974238000761
"2000","bringin",3.21340874552741,37,15,22,9.9561704268611,27.0438295731389
"2000","everything want",3.21340874552741,37,15,22,9.9561704268611,27.0438295731389
"2000","meif",3.21340874552741,37,15,22,9.9561704268611,27.0438295731389
"2000","bars",3.21231394127523,40,16,24,10.7634274884985,29.2365725115015
"2000","like can",3.21231394127523,40,16,24,10.7634274884985,29.2365725115015
"2000","minutes",3.21231394127523,40,16,24,10.7634274884985,29.2365725115015
"2000","nigga like",3.21231394127523,40,16,24,10.7634274884985,29.2365725115015
"1990","im saying",3.21163698505775,46,15,31,9.75865601275846,36.2413439872415
"2010","rocking",3.20675364924284,47,12,35,7.23624802698745,39.7637519730126
"2010","sat",3.20675364924284,47,12,35,7.23624802698745,39.7637519730126
"2010","life ive",3.20527365721612,52,13,39,8.00606164687973,43.9939383531203
"2010","pole",3.20527365721612,52,13,39,8.00606164687973,43.9939383531203
"1970","began",3.20449355565937,47,11,36,6.4318509166256,40.5681490833744
"1970","day im",3.20449355565937,47,11,36,6.4318509166256,40.5681490833744
"1970","goodnight",3.20449355565937,47,11,36,6.4318509166256,40.5681490833744
"1970","ill find",3.20449355565937,47,11,36,6.4318509166256,40.5681490833744
"1970","time oh",3.20449355565937,47,11,36,6.4318509166256,40.5681490833744
"1980","mountain",3.20050477374941,141,32,109,23.7212375977445,117.278762402256
"1980","go way",3.19970311689879,86,21,65,14.4682725773477,71.5317274226523
"2010","older",3.19843371993947,83,19,64,12.7789060902119,70.2210939097881
"2010","right back",3.19843371993947,83,19,64,12.7789060902119,70.2210939097881
"1970","strong",3.1900741869519,470,78,392,64.318509166256,405.681490833744
"1970","baby baby im",3.18831592020952,31,8,23,4.24228464713604,26.757715352864
"1970","burnin burnin",3.18831592020952,31,8,23,4.24228464713604,26.757715352864
"1970","can oh",3.18831592020952,31,8,23,4.24228464713604,26.757715352864
"1970","chair",3.18831592020952,31,8,23,4.24228464713604,26.757715352864
"1970","feels right",3.18831592020952,31,8,23,4.24228464713604,26.757715352864
"1970","im free",3.18831592020952,31,8,23,4.24228464713604,26.757715352864
"1970","just leave",3.18831592020952,31,8,23,4.24228464713604,26.757715352864
"1970","love hate",3.18831592020952,31,8,23,4.24228464713604,26.757715352864
"1970","now right",3.18831592020952,31,8,23,4.24228464713604,26.757715352864
"1970","smiled",3.18831592020952,31,8,23,4.24228464713604,26.757715352864
"1970","youwell",3.18831592020952,31,8,23,4.24228464713604,26.757715352864
"1990","just hold",3.18738396754065,73,22,51,15.4865628028558,57.5134371971442
"1990","passed",3.18738396754065,73,22,51,15.4865628028558,57.5134371971442
"1990","time get",3.18738396754065,73,22,51,15.4865628028558,57.5134371971442
"1990","seen",3.18457196110052,576,140,436,122.19534485541,453.80465514459
"1980","love give",3.18171392085846,91,22,69,15.3094512155656,75.6905487844344
"1980","got much",3.17660723910441,62,16,46,10.4306151139018,51.5693848860982
"1990","ever get",3.17608843518051,35,12,23,7.42506435753361,27.5749356424664
"1990","everybody say",3.17608843518051,35,12,23,7.42506435753361,27.5749356424664
"1990","heart will",3.17608843518051,35,12,23,7.42506435753361,27.5749356424664
"1990","kicked",3.17608843518051,35,12,23,7.42506435753361,27.5749356424664
"1990","oh go",3.17608843518051,35,12,23,7.42506435753361,27.5749356424664
"1990","one way",3.17608843518051,35,12,23,7.42506435753361,27.5749356424664
"1990","place can",3.17608843518051,35,12,23,7.42506435753361,27.5749356424664
"1990","woman can",3.17608843518051,35,12,23,7.42506435753361,27.5749356424664
"1990","yeah yeah oh",3.17608843518051,35,12,23,7.42506435753361,27.5749356424664
"2000","see youre",3.1749719023409,87,31,56,23.4104547874842,63.5895452125158
"1990","train",3.17420954293386,221,58,163,46.8839778004265,174.116022199574
"1990","lick",3.17097428565554,77,23,54,16.3351415865739,60.6648584134261
"1980","im looking",3.16896602637087,96,23,73,16.1506298537835,79.8493701462165
"1980","can leave",3.16780704016958,30,9,21,5.04707182930734,24.9529281706927
"1980","cant understand",3.16780704016958,30,9,21,5.04707182930734,24.9529281706927
"1980","everything alright",3.16780704016958,30,9,21,5.04707182930734,24.9529281706927
"1980","home oh",3.16780704016958,30,9,21,5.04707182930734,24.9529281706927
"1980","ive learned",3.16780704016958,30,9,21,5.04707182930734,24.9529281706927
"1980","together love",3.16780704016958,30,9,21,5.04707182930734,24.9529281706927
"1990","whisper",3.16689080419622,109,31,78,23.1237718563189,85.8762281436811
"1970","running",3.16504166541477,365,62,303,49.9494805227307,315.050519477269
"1980","embrace",3.16430258757183,48,13,35,8.07531492689174,39.9246850731083
"1980","let one",3.16430258757183,48,13,35,8.07531492689174,39.9246850731083
"1970","cant find",3.16409289198176,64,14,50,8.75826507795827,55.2417349220417
"1980","take hand",3.16179232495491,121,28,93,20.3565230448729,100.643476955127
"1980","youll see",3.16179232495491,121,28,93,20.3565230448729,100.643476955127
"1980","want dont",3.15632864248025,106,25,81,17.8329871302193,88.1670128697807
"1970","believe magic",3.15423071096699,21,6,15,2.87380572870506,18.1261942712949
"1970","cant buy",3.15423071096699,21,6,15,2.87380572870506,18.1261942712949
"1970","covered",3.15423071096699,21,6,15,2.87380572870506,18.1261942712949
"1970","dont want see",3.15423071096699,21,6,15,2.87380572870506,18.1261942712949
"1970","familiar",3.15423071096699,21,6,15,2.87380572870506,18.1261942712949
"1970","heartaches",3.15423071096699,21,6,15,2.87380572870506,18.1261942712949
"1970","love oh oh oh",3.15423071096699,21,6,15,2.87380572870506,18.1261942712949
"1970","much need",3.15423071096699,21,6,15,2.87380572870506,18.1261942712949
"1970","music just",3.15423071096699,21,6,15,2.87380572870506,18.1261942712949
"1970","music play",3.15423071096699,21,6,15,2.87380572870506,18.1261942712949
"1970","night life",3.15423071096699,21,6,15,2.87380572870506,18.1261942712949
"1970","swear im",3.15423071096699,21,6,15,2.87380572870506,18.1261942712949
"1970","tell need",3.15423071096699,21,6,15,2.87380572870506,18.1261942712949
"1970","went wrong",3.15423071096699,21,6,15,2.87380572870506,18.1261942712949
"1970","youre every",3.15423071096699,21,6,15,2.87380572870506,18.1261942712949
"1970","youve got love",3.15423071096699,21,6,15,2.87380572870506,18.1261942712949
"1990","til",3.15334283537132,594,144,450,126.013949382142,467.986050617858
"1990","someone else",3.15166019591213,85,25,60,18.0322991540102,66.9677008459898
"1970","loved",3.14880117893676,398,67,331,54.465460953553,343.534539046447
"1990","falling love",3.14831066342594,97,28,69,20.5780355051646,76.4219644948354
"1990","lift",3.14831066342594,97,28,69,20.5780355051646,76.4219644948354
"1960","groovin",3.14777273656716,57,7,50,3.40422658339381,53.5957734166062
"1960","love aint",3.14777273656716,57,7,50,3.40422658339381,53.5957734166062
"1960","plain",3.14777273656716,57,7,50,3.40422658339381,53.5957734166062
"1970","beep",3.14704203309111,26,7,19,3.55804518792055,22.4419548120795
"1970","came back",3.14704203309111,26,7,19,3.55804518792055,22.4419548120795
"1970","oh oh youre",3.14704203309111,26,7,19,3.55804518792055,22.4419548120795
"1970","real thing",3.14704203309111,26,7,19,3.55804518792055,22.4419548120795
"1970","spanish",3.14704203309111,26,7,19,3.55804518792055,22.4419548120795
"1970","wrong just",3.14704203309111,26,7,19,3.55804518792055,22.4419548120795
"1990","woo",3.14456449891357,217,57,160,46.0353990167084,170.964600983292
"1960","someday",3.14449188845397,143,14,129,8.54042809518097,134.459571904819
"1990","softly",3.14260539354824,50,16,34,10.6072347964766,39.3927652035234
"2000","aint trying",3.13772274039411,17,8,9,4.57445668261186,12.4255433173881
"2000","away cant",3.13772274039411,17,8,9,4.57445668261186,12.4255433173881
"2000","babei",3.13772274039411,17,8,9,4.57445668261186,12.4255433173881
"2000","beat like",3.13772274039411,17,8,9,4.57445668261186,12.4255433173881
"2000","believe oh",3.13772274039411,17,8,9,4.57445668261186,12.4255433173881
"2000","bro",3.13772274039411,17,8,9,4.57445668261186,12.4255433173881
"2000","bronx",3.13772274039411,17,8,9,4.57445668261186,12.4255433173881
"2000","bull",3.13772274039411,17,8,9,4.57445668261186,12.4255433173881
"2000","dont mean thing",3.13772274039411,17,8,9,4.57445668261186,12.4255433173881
"2000","everyday like",3.13772274039411,17,8,9,4.57445668261186,12.4255433173881
"2000","fans",3.13772274039411,17,8,9,4.57445668261186,12.4255433173881
"2000","feel way feel",3.13772274039411,17,8,9,4.57445668261186,12.4255433173881
"2000","gentlemen",3.13772274039411,17,8,9,4.57445668261186,12.4255433173881
"2000","girl makes",3.13772274039411,17,8,9,4.57445668261186,12.4255433173881
"2000","girls get",3.13772274039411,17,8,9,4.57445668261186,12.4255433173881
"2000","im top",3.13772274039411,17,8,9,4.57445668261186,12.4255433173881
"2000","just take time",3.13772274039411,17,8,9,4.57445668261186,12.4255433173881
"2000","know dont want",3.13772274039411,17,8,9,4.57445668261186,12.4255433173881
"2000","look baby",3.13772274039411,17,8,9,4.57445668261186,12.4255433173881
"2000","mail",3.13772274039411,17,8,9,4.57445668261186,12.4255433173881
"2000","megirl",3.13772274039411,17,8,9,4.57445668261186,12.4255433173881
"2000","need right",3.13772274039411,17,8,9,4.57445668261186,12.4255433173881
"2000","need worry",3.13772274039411,17,8,9,4.57445668261186,12.4255433173881
"2000","night now",3.13772274039411,17,8,9,4.57445668261186,12.4255433173881
"2000","reppin",3.13772274039411,17,8,9,4.57445668261186,12.4255433173881
"2000","picture",3.13011251371836,166,55,111,44.6682240772687,121.331775922731
"1980","cause never",3.12744877322997,39,11,28,6.56119337809954,32.4388066219005
"1980","completely",3.12744877322997,39,11,28,6.56119337809954,32.4388066219005
"1980","mind dont",3.12744877322997,39,11,28,6.56119337809954,32.4388066219005
"1980","rip",3.12744877322997,39,11,28,6.56119337809954,32.4388066219005
"1980","wanna give",3.12744877322997,39,11,28,6.56119337809954,32.4388066219005
"1980","cry dont",3.12459456141448,67,17,50,11.2717937521197,55.7282062478803
"1970","brand",3.12365531621318,148,28,120,20.2534879927785,127.746512007221
"2000","else",3.12218820009672,625,188,437,168.178554507789,456.821445492211
"2000","away love",3.12199922916905,84,30,54,22.6031977258468,61.3968022741532
"2010","ill one",3.12129352073447,28,8,20,4.31095627139678,23.6890437286032
"2010","killin",3.12129352073447,28,8,20,4.31095627139678,23.6890437286032
"2010","think might",3.12129352073447,28,8,20,4.31095627139678,23.6890437286032
"1960","better better",3.11934799132789,46,6,40,2.7472705760722,43.2527294239278
"1990","brand new",3.11386996272998,142,39,103,30.1245468219935,111.875453178007
"2000","will go",3.103609645765,65,24,41,17.49056966881,47.50943033119
"1970","brand new",3.10229946170406,142,27,115,19.4324006417199,122.56759935828
"1970","starts",3.10229946170406,142,27,115,19.4324006417199,122.56759935828
"2010","always right",3.10064114212191,19,6,13,2.92529175559067,16.0747082444093
"2010","baby work",3.10064114212191,19,6,13,2.92529175559067,16.0747082444093
"2010","breaking heart",3.10064114212191,19,6,13,2.92529175559067,16.0747082444093
"2010","cheeks",3.10064114212191,19,6,13,2.92529175559067,16.0747082444093
"2010","dropping",3.10064114212191,19,6,13,2.92529175559067,16.0747082444093
"2010","get ass",3.10064114212191,19,6,13,2.92529175559067,16.0747082444093
"2010","gon give",3.10064114212191,19,6,13,2.92529175559067,16.0747082444093
"2010","gonna sing",3.10064114212191,19,6,13,2.92529175559067,16.0747082444093
"2010","homei",3.10064114212191,19,6,13,2.92529175559067,16.0747082444093
"2010","important",3.10064114212191,19,6,13,2.92529175559067,16.0747082444093
"2010","light take",3.10064114212191,19,6,13,2.92529175559067,16.0747082444093
"2010","night aint",3.10064114212191,19,6,13,2.92529175559067,16.0747082444093
"2010","now world",3.10064114212191,19,6,13,2.92529175559067,16.0747082444093
"2010","oh look",3.10064114212191,19,6,13,2.92529175559067,16.0747082444093
"2010","put together",3.10064114212191,19,6,13,2.92529175559067,16.0747082444093
"2010","tell got",3.10064114212191,19,6,13,2.92529175559067,16.0747082444093
"2010","thing yeah",3.10064114212191,19,6,13,2.92529175559067,16.0747082444093
"2010","things didnt",3.10064114212191,19,6,13,2.92529175559067,16.0747082444093
"2010","worry baby",3.10064114212191,19,6,13,2.92529175559067,16.0747082444093
"1970","good baby",3.10044875434905,53,12,41,7.25293826768419,45.7470617323158
"1970","limit",3.10044875434905,53,12,41,7.25293826768419,45.7470617323158
"1970","sunny",3.10044875434905,53,12,41,7.25293826768419,45.7470617323158
"1990","dont think youre",3.09705450979848,21,8,13,4.45503861452016,16.5449613854798
"1990","everything just",3.09705450979848,21,8,13,4.45503861452016,16.5449613854798
"1990","eyes love",3.09705450979848,21,8,13,4.45503861452016,16.5449613854798
"1990","heart oh",3.09705450979848,21,8,13,4.45503861452016,16.5449613854798
"1990","hold just",3.09705450979848,21,8,13,4.45503861452016,16.5449613854798
"1990","id take",3.09705450979848,21,8,13,4.45503861452016,16.5449613854798
"1990","just can",3.09705450979848,21,8,13,4.45503861452016,16.5449613854798
"1990","man home",3.09705450979848,21,8,13,4.45503861452016,16.5449613854798
"1990","need nobody",3.09705450979848,21,8,13,4.45503861452016,16.5449613854798
"1990","ooh thats",3.09705450979848,21,8,13,4.45503861452016,16.5449613854798
"1990","real close",3.09705450979848,21,8,13,4.45503861452016,16.5449613854798
"1990","round round round round",3.09705450979848,21,8,13,4.45503861452016,16.5449613854798
"1990","said whatever",3.09705450979848,21,8,13,4.45503861452016,16.5449613854798
"1990","sympathy",3.09705450979848,21,8,13,4.45503861452016,16.5449613854798
"1990","untrue",3.09705450979848,21,8,13,4.45503861452016,16.5449613854798
"1990","want play",3.09705450979848,21,8,13,4.45503861452016,16.5449613854798
"1990","believe youre",3.09523664687717,28,10,18,5.94005148602689,22.0599485139731
"1990","can stop",3.09523664687717,28,10,18,5.94005148602689,22.0599485139731
"1990","dont ya",3.09523664687717,28,10,18,5.94005148602689,22.0599485139731
"1990","love every",3.09523664687717,28,10,18,5.94005148602689,22.0599485139731
"1990","love hold",3.09523664687717,28,10,18,5.94005148602689,22.0599485139731
"1990","one said",3.09523664687717,28,10,18,5.94005148602689,22.0599485139731
"1990","right oh",3.09523664687717,28,10,18,5.94005148602689,22.0599485139731
"1990","see every",3.09523664687717,28,10,18,5.94005148602689,22.0599485139731
"1990","peace",3.09419205493085,167,45,122,35.4281642202318,131.571835779768
"1960","little love",3.09326415552611,118,12,106,7.04734626035913,110.952653739641
"1960","sang",3.09240334742973,69,8,61,4.1209058641083,64.8790941358917
"1960","ha ha",3.09013105482747,237,21,216,14.1544157941111,222.845584205889
"1990","lovei",3.08807175531491,54,17,37,11.4558135801947,42.5441864198053
"1990","yes yes",3.08807175531491,54,17,37,11.4558135801947,42.5441864198053
"1960","fine",3.07716865393307,608,47,561,36.3117502228674,571.688249777133
"1970","upside",3.0767686051965,76,16,60,10.4004397800754,65.5995602199246
"1980","heart dont",3.07545075033716,53,14,39,8.91649356510963,44.0835064348904
"1980","like first",3.07545075033716,53,14,39,8.91649356510963,44.0835064348904
"2000","truth",3.0741440173453,302,95,207,81.2638775381636,220.736122461836
"1980","run",3.07227568683864,1088,205,883,183.040471676213,904.959528323787
"2000","dollars",3.06955631927567,81,29,52,21.7959406642094,59.2040593357906
"2000","gotta get",3.06446785915712,227,73,154,61.0824509972289,165.917549002771
"1990","someone like",3.06347248467291,39,13,26,8.27364314125173,30.7263568587483
"1960","last night",3.06234477210878,144,14,130,8.60015136857385,135.399848631426
"2000","bullet",3.0610529893572,62,23,39,16.6833126071727,45.3166873928273
"2000","either",3.0610529893572,62,23,39,16.6833126071727,45.3166873928273
"2010","feel im",3.06052351573841,68,16,52,10.469465230535,57.530534769465
"2010","wasted",3.06052351573841,68,16,52,10.469465230535,57.530534769465
"1980","belonged",3.05307762403377,26,8,18,4.37412891873303,21.625871081267
"1980","cowboy",3.05307762403377,26,8,18,4.37412891873303,21.625871081267
"1980","cry just little",3.05307762403377,26,8,18,4.37412891873303,21.625871081267
"1980","hard believe",3.05307762403377,26,8,18,4.37412891873303,21.625871081267
"1980","thing ive",3.05307762403377,26,8,18,4.37412891873303,21.625871081267
"1980","union",3.05307762403377,26,8,18,4.37412891873303,21.625871081267
"1980","well meet",3.05307762403377,26,8,18,4.37412891873303,21.625871081267
"1980","younow",3.05307762403377,26,8,18,4.37412891873303,21.625871081267
"1980","yeah yeah yeah yeah",3.05176380149922,549,108,441,92.3614144763243,456.638585523676
"1960","knees",3.05045690800354,197,18,179,11.7654848583962,185.234515141604
"1960","tomorrow",3.04676450166999,279,24,255,16.6627932766118,262.337206723388
"1970","share",3.03402559664485,237,42,195,32.4329503668142,204.567049633186
"2010","come give",3.03114206022935,33,9,24,5.08076989128906,27.9192301087109
"2010","like need",3.03114206022935,33,9,24,5.08076989128906,27.9192301087109
"2010","los",3.03114206022935,33,9,24,5.08076989128906,27.9192301087109
"2010","love dance",3.03114206022935,33,9,24,5.08076989128906,27.9192301087109
"2010","now take",3.03114206022935,33,9,24,5.08076989128906,27.9192301087109
"2010","promise ill",3.03114206022935,33,9,24,5.08076989128906,27.9192301087109
"2010","wont forget",3.03114206022935,33,9,24,5.08076989128906,27.9192301087109
"1970","dont mind",3.02517263576489,155,29,126,21.2114232356802,133.78857676432
"1970","ooo",3.02495805648208,180,33,147,24.6326205317576,155.367379468242
"1970","hard find",3.02440989653843,59,13,46,8.07402561874278,50.9259743812572
"1970","whats name",3.02440989653843,59,13,46,8.07402561874278,50.9259743812572
"1970","wont long",3.02440989653843,59,13,46,8.07402561874278,50.9259743812572
"1970","youre everything",3.02440989653843,59,13,46,8.07402561874278,50.9259743812572
"1990","anywhere",3.02134245581073,122,34,88,25.8816529034029,96.1183470965971
"2000","mistakes",3.02026250501092,59,22,37,15.8760555455353,43.1239444544647
"1960","someone",3.01792402390736,862,64,798,51.4814616646573,810.518538335343
"2000","fame",3.01707294355526,140,47,93,37.6719962097447,102.328003790255
"1980","falls",3.01191869726019,87,21,66,14.6365083049913,72.3634916950087
"1990","got much",3.0116337628158,62,19,43,13.152971147631,48.847028852369
"1990","guide",3.0116337628158,62,19,43,13.152971147631,48.847028852369
"1960","direction",3.01130415545734,58,7,51,3.46394985678669,54.5360501432133
"1960","find somebody",3.01130415545734,58,7,51,3.46394985678669,54.5360501432133
"1960","go im",3.01130415545734,58,7,51,3.46394985678669,54.5360501432133
"1960","rhythm",3.01084998353675,252,22,230,15.0502648950042,236.949735104996
"2000","yeah im",3.00982171443304,160,53,107,43.053709953994,116.946290046006
"1980","gentle",3.00673464190239,58,15,43,9.75767220332752,48.2423277966725
"1990","kisses",3.00570523502487,118,33,85,25.0330741196847,92.9669258803153
"1980","love well",3.00270611230631,44,12,32,7.40237201631743,36.5976279836826
"1970","dreams",3.00173063270911,640,103,537,87.5826507795827,552.417349220417
"1980","zone",3.00009459199051,92,22,70,15.4776869432092,76.5223130567908
"2000","clubs",2.99960383248053,20,9,11,5.38171374424925,14.6182862557508
"2000","cups",2.99960383248053,20,9,11,5.38171374424925,14.6182862557508
"2000","dimes",2.99960383248053,20,9,11,5.38171374424925,14.6182862557508
"2000","expression",2.99960383248053,20,9,11,5.38171374424925,14.6182862557508
"2000","girlfriends",2.99960383248053,20,9,11,5.38171374424925,14.6182862557508
"2000","hand take",2.99960383248053,20,9,11,5.38171374424925,14.6182862557508
"2000","ill put",2.99960383248053,20,9,11,5.38171374424925,14.6182862557508
"2000","just try",2.99960383248053,20,9,11,5.38171374424925,14.6182862557508
"2000","let hit",2.99960383248053,20,9,11,5.38171374424925,14.6182862557508
"2000","long got",2.99960383248053,20,9,11,5.38171374424925,14.6182862557508
"2000","paralyzed",2.99960383248053,20,9,11,5.38171374424925,14.6182862557508
"2000","sweep",2.99960383248053,20,9,11,5.38171374424925,14.6182862557508
"2000","ya wanna",2.99960383248053,20,9,11,5.38171374424925,14.6182862557508
"2000","youre wrong",2.99960383248053,20,9,11,5.38171374424925,14.6182862557508
"2010","daughter",2.99304059268742,58,14,44,8.92983799075047,49.0701620092495
"2010","oh want",2.99304059268742,58,14,44,8.92983799075047,49.0701620092495
"2010","see see",2.99304059268742,58,14,44,8.92983799075047,49.0701620092495
"1980","can say",2.98831710291206,189,41,148,31.7965525246362,157.203447475364
"1960","far away",2.98822702704882,158,15,143,9.43627719607408,148.563722803926
"1970","say say say",2.98670740506902,37,9,28,5.06337199819462,31.9366280018054
"1970","wanna let",2.98670740506902,37,9,28,5.06337199819462,31.9366280018054
"1990","give everything",2.98589822198599,66,20,46,14.0015499313491,51.9984500686509
"1960","year",2.98552954834706,132,13,119,7.88347208785936,124.116527912141
"2010","teeth",2.98224554550555,38,10,28,5.85058351118134,32.1494164888187
"2010","trigger",2.98224554550555,38,10,28,5.85058351118134,32.1494164888187
"2000","heels",2.98151772710538,56,21,35,15.0687984838979,40.9312015161021
"2010","gold",2.9812489268558,304,58,246,46.8046680894507,257.195331910549
"2000","im gonna make",2.97976414853515,104,36,68,27.9849114700961,76.0150885299039
"1980","change life",2.97922188554715,35,10,25,5.88825046752523,29.1117495324748
"1980","one way",2.97922188554715,35,10,25,5.88825046752523,29.1117495324748
"1980","place can",2.97922188554715,35,10,25,5.88825046752523,29.1117495324748
"1980","romeo",2.97922188554715,35,10,25,5.88825046752523,29.1117495324748
"1980","walk door",2.97922188554715,35,10,25,5.88825046752523,29.1117495324748
"1990","ear",2.9781140425537,110,31,79,23.3359165522485,86.6640834477515
"1990","edge",2.9781140425537,110,31,79,23.3359165522485,86.6640834477515
"1990","fault",2.97674943034639,43,14,29,9.12222192496986,33.8777780750301
"1990","ive found",2.97674943034639,43,14,29,9.12222192496986,33.8777780750301
"1970","youre fine",2.97196173272668,48,11,37,6.5686988084687,41.4313011915313
"1970","youre right",2.97196173272668,48,11,37,6.5686988084687,41.4313011915313
"2010","chasing",2.97060920187296,53,13,40,8.16002437085818,44.8399756291418
"1960","know true",2.97060149399245,82,9,73,4.89730841821566,77.1026915817843
"1960","feelin",2.9687432104343,494,39,455,29.5032970560797,464.49670294392
"1990","make cry",2.96664086251443,70,21,49,14.8501287150672,55.1498712849328
"1990","thatll",2.96664086251443,70,21,49,14.8501287150672,55.1498712849328
"1990","know now",2.96643142062849,106,30,76,22.4873377685304,83.5126622314696
"1960","ill find",2.96619716228697,47,6,41,2.80699384946508,44.1930061505349
"1960","listen heart",2.96619716228697,47,6,41,2.80699384946508,44.1930061505349
"1960","shelter",2.96619716228697,47,6,41,2.80699384946508,44.1930061505349
"1960","things want",2.96619716228697,47,6,41,2.80699384946508,44.1930061505349
"1960","tricks",2.96619716228697,47,6,41,2.80699384946508,44.1930061505349
"1970","new york",2.96400012229614,168,31,137,22.9904458296404,145.00955417036
"2010","cause im",2.96176271675116,475,87,388,73.1322938897667,401.867706110233
"2010","feel alright",2.96084747287365,43,11,32,6.62039713107362,36.3796028689264
"2010","pound",2.96084747287365,43,11,32,6.62039713107362,36.3796028689264
"2010","wanna stay",2.96084747287365,43,11,32,6.62039713107362,36.3796028689264
"2010","want back want",2.95871414512258,48,12,36,7.3902107509659,40.6097892490341
"1980","better place",2.95801430863466,22,7,15,3.70118600815871,18.2988139918413
"1980","can share",2.95801430863466,22,7,15,3.70118600815871,18.2988139918413
"1980","go gotta",2.95801430863466,22,7,15,3.70118600815871,18.2988139918413
"1980","got life",2.95801430863466,22,7,15,3.70118600815871,18.2988139918413
"1980","got tell",2.95801430863466,22,7,15,3.70118600815871,18.2988139918413
"1980","heart belongs",2.95801430863466,22,7,15,3.70118600815871,18.2988139918413
"1980","love show",2.95801430863466,22,7,15,3.70118600815871,18.2988139918413
"1980","say words",2.95801430863466,22,7,15,3.70118600815871,18.2988139918413
"1980","sweetness",2.95801430863466,22,7,15,3.70118600815871,18.2988139918413
"1980","tales",2.95801430863466,22,7,15,3.70118600815871,18.2988139918413
"1980","things ive",2.95801430863466,22,7,15,3.70118600815871,18.2988139918413
"1990","dont cry",2.95637298614264,102,29,73,21.6387589848122,80.3612410151878
"1990","life oh",2.95637298614264,102,29,73,21.6387589848122,80.3612410151878
"1960","every night",2.95386950823169,185,17,168,11.0488055776817,173.951194422318
"1980","well never",2.95357395271172,63,16,47,10.5988508415454,52.4011491584546
"2000","burnin",2.94967956241655,157,52,105,42.2464528923566,114.753547107643
"1990","come take",2.94813258666117,98,28,70,20.7901802010941,77.2098197989059
"1960","light",2.94602946745674,1015,74,941,60.6191224937671,954.380877506233
"1960","dawn",2.94347803964976,107,11,96,6.39039025303751,100.609609746962
"1990","back cause",2.9417630791929,32,11,21,6.78863026974501,25.211369730255
"1990","hardest",2.9417630791929,32,11,21,6.78863026974501,25.211369730255
"1990","ill ill",2.9417630791929,32,11,21,6.78863026974501,25.211369730255
"1990","love inside",2.9417630791929,32,11,21,6.78863026974501,25.211369730255
"1990","nothin can",2.9417630791929,32,11,21,6.78863026974501,25.211369730255
"1990","oh theres",2.9417630791929,32,11,21,6.78863026974501,25.211369730255
"1990","pen",2.9417630791929,32,11,21,6.78863026974501,25.211369730255
"1990","want tonight",2.9417630791929,32,11,21,6.78863026974501,25.211369730255
"1990","set",2.94001016632681,395,98,297,83.797154892165,311.202845107835
"1990","want baby",2.93851487859321,82,24,58,17.3958650662216,64.6041349337784
"1990","want come",2.9367844666771,86,25,61,18.2444438499397,67.7555561500603
"1970","meaning",2.9348407138367,162,30,132,22.1693584785819,139.830641521418
"1970","happiness",2.92931732236869,71,15,56,9.71620032085995,61.2837996791401
"1970","love ive",2.92931732236869,71,15,56,9.71620032085995,61.2837996791401
"1980","one",2.91887978559167,5413,958,4455,910.659993734687,4502.34000626531
"1970","late",2.91772411058393,421,70,351,57.6129624659442,363.387037534056
"1970","happened",2.91618422176423,125,24,101,17.1059864803872,107.894013519613
"2000","bank",2.91606081538483,72,26,46,19.3741694792973,52.6258305207027
"2000","well make",2.91606081538483,72,26,46,19.3741694792973,52.6258305207027
"1960","smile",2.91340749081997,583,45,538,34.8186683880455,548.181331611955
"1980","sea",2.91309545512508,174,38,136,29.2730166099826,144.726983390017
"2000","baby keep",2.912094603812,23,10,13,6.18897080588663,16.8110291941134
"2000","downs",2.912094603812,23,10,13,6.18897080588663,16.8110291941134
"2000","fail",2.912094603812,23,10,13,6.18897080588663,16.8110291941134
"2000","get mad",2.912094603812,23,10,13,6.18897080588663,16.8110291941134
"2000","girls love",2.912094603812,23,10,13,6.18897080588663,16.8110291941134
"2000","hard get",2.912094603812,23,10,13,6.18897080588663,16.8110291941134
"2000","need get",2.912094603812,23,10,13,6.18897080588663,16.8110291941134
"2000","need help",2.912094603812,23,10,13,6.18897080588663,16.8110291941134
"2000","never mind",2.912094603812,23,10,13,6.18897080588663,16.8110291941134
"2000","sober",2.912094603812,23,10,13,6.18897080588663,16.8110291941134
"2000","boy boy",2.91161374109269,50,19,31,13.4542843606231,36.5457156393769
"2010","make sure",2.91085811684608,74,17,57,11.3932415744058,62.6067584255942
"2010","record",2.91085811684608,74,17,57,11.3932415744058,62.6067584255942
"1990","make happy",2.90954366293506,47,15,32,9.97080070868799,37.029199291312
"1990","time can",2.90954366293506,47,15,32,9.97080070868799,37.029199291312
"1980","fade away",2.9086220940692,49,13,36,8.24355065453532,40.7564493454647
"1980","got keep",2.9086220940692,49,13,36,8.24355065453532,40.7564493454647
"2010","bold",2.9045617404492,24,7,17,3.69510537548295,20.3048946245171
"2010","holy",2.9045617404492,24,7,17,3.69510537548295,20.3048946245171
"2010","lonely im",2.9045617404492,24,7,17,3.69510537548295,20.3048946245171
"2010","look just",2.9045617404492,24,7,17,3.69510537548295,20.3048946245171
"2010","makes feel like",2.9045617404492,24,7,17,3.69510537548295,20.3048946245171
"2010","mirror mirror",2.9045617404492,24,7,17,3.69510537548295,20.3048946245171
"2010","murder",2.9045617404492,24,7,17,3.69510537548295,20.3048946245171
"2010","oh aint",2.9045617404492,24,7,17,3.69510537548295,20.3048946245171
"2010","screams",2.9045617404492,24,7,17,3.69510537548295,20.3048946245171
"2010","touch sky",2.9045617404492,24,7,17,3.69510537548295,20.3048946245171
"2010","youre trying",2.9045617404492,24,7,17,3.69510537548295,20.3048946245171
"2010","night oh",2.90153472761062,90,20,70,13.8566451580611,76.1433548419389
"2000","special",2.89906461727024,201,65,136,54.0862231297049,146.913776870295
"1970","cmon cmon",2.89660343971325,32,8,24,4.37913253897913,27.6208674610209
"1970","get come",2.89660343971325,32,8,24,4.37913253897913,27.6208674610209
"1970","raining",2.89660343971325,32,8,24,4.37913253897913,27.6208674610209
"1970","things dont",2.89660343971325,32,8,24,4.37913253897913,27.6208674610209
"1990","baby baby like",2.89556699802242,18,7,11,3.81860452673157,14.1813954732684
"1990","baby makes",2.89556699802242,18,7,11,3.81860452673157,14.1813954732684
"1990","beginnin",2.89556699802242,18,7,11,3.81860452673157,14.1813954732684
"1990","clique",2.89556699802242,18,7,11,3.81860452673157,14.1813954732684
"1990","come running",2.89556699802242,18,7,11,3.81860452673157,14.1813954732684
"1990","despair",2.89556699802242,18,7,11,3.81860452673157,14.1813954732684
"1990","feel time",2.89556699802242,18,7,11,3.81860452673157,14.1813954732684
"1990","get dance",2.89556699802242,18,7,11,3.81860452673157,14.1813954732684
"1990","got secret",2.89556699802242,18,7,11,3.81860452673157,14.1813954732684
"1990","hands touch",2.89556699802242,18,7,11,3.81860452673157,14.1813954732684
"1990","just let know",2.89556699802242,18,7,11,3.81860452673157,14.1813954732684
"1990","love nothing",2.89556699802242,18,7,11,3.81860452673157,14.1813954732684
"1990","makes difference",2.89556699802242,18,7,11,3.81860452673157,14.1813954732684
"1990","money mind",2.89556699802242,18,7,11,3.81860452673157,14.1813954732684
"1990","now one",2.89556699802242,18,7,11,3.81860452673157,14.1813954732684
"1990","receive",2.89556699802242,18,7,11,3.81860452673157,14.1813954732684
"1990","say true",2.89556699802242,18,7,11,3.81860452673157,14.1813954732684
"1990","sides",2.89556699802242,18,7,11,3.81860452673157,14.1813954732684
"1990","theres one else",2.89556699802242,18,7,11,3.81860452673157,14.1813954732684
"1990","try oh",2.89556699802242,18,7,11,3.81860452673157,14.1813954732684
"1990","uhuh",2.89556699802242,18,7,11,3.81860452673157,14.1813954732684
"1990","undo",2.89556699802242,18,7,11,3.81860452673157,14.1813954732684
"1990","waiting time",2.89556699802242,18,7,11,3.81860452673157,14.1813954732684
"1990","work harder",2.89556699802242,18,7,11,3.81860452673157,14.1813954732684
"1990","wrapped around",2.89556699802242,18,7,11,3.81860452673157,14.1813954732684
"1990","yeah yeahi",2.89556699802242,18,7,11,3.81860452673157,14.1813954732684
"1960","run away",2.89525566452764,95,10,85,5.67371097232302,89.326289027677
"1980","cry now",2.89510856449494,18,6,12,3.0282430975844,14.9717569024156
"1980","deceive",2.89510856449494,18,6,12,3.0282430975844,14.9717569024156
"1980","decision",2.89510856449494,18,6,12,3.0282430975844,14.9717569024156
"1980","forget im",2.89510856449494,18,6,12,3.0282430975844,14.9717569024156
"1980","id never let",2.89510856449494,18,6,12,3.0282430975844,14.9717569024156
"1980","inside youre",2.89510856449494,18,6,12,3.0282430975844,14.9717569024156
"1980","ive lost",2.89510856449494,18,6,12,3.0282430975844,14.9717569024156
"1980","know sure",2.89510856449494,18,6,12,3.0282430975844,14.9717569024156
"1980","let slip away",2.89510856449494,18,6,12,3.0282430975844,14.9717569024156
"1980","sailing",2.89510856449494,18,6,12,3.0282430975844,14.9717569024156
"1980","say ive",2.89510856449494,18,6,12,3.0282430975844,14.9717569024156
"1980","somebody dont",2.89510856449494,18,6,12,3.0282430975844,14.9717569024156
"1980","somebody new",2.89510856449494,18,6,12,3.0282430975844,14.9717569024156
"1980","sooner",2.89510856449494,18,6,12,3.0282430975844,14.9717569024156
"1980","thats okay",2.89510856449494,18,6,12,3.0282430975844,14.9717569024156
"1980","time call",2.89510856449494,18,6,12,3.0282430975844,14.9717569024156
"1980","waiting time",2.89510856449494,18,6,12,3.0282430975844,14.9717569024156
"1980","wanna party",2.89510856449494,18,6,12,3.0282430975844,14.9717569024156
"1980","want love dont",2.89510856449494,18,6,12,3.0282430975844,14.9717569024156
"1980","well still",2.89510856449494,18,6,12,3.0282430975844,14.9717569024156
"1980","will understand",2.89510856449494,18,6,12,3.0282430975844,14.9717569024156
"1980","world aint",2.89510856449494,18,6,12,3.0282430975844,14.9717569024156
"1980","youre telling",2.89510856449494,18,6,12,3.0282430975844,14.9717569024156
"2000","turn around",2.88975438475275,218,70,148,58.6606798123168,159.339320187683
"2000","bitches",2.88884696410528,276,87,189,74.2676496706396,201.73235032936
"1970","trees",2.88393117841257,83,17,66,11.3583750229771,71.6416249770229
"1980","oh cant",2.88164690389887,73,18,55,12.2812081179812,60.7187918820188
"2000","gone youre",2.88140625858747,47,18,29,12.6470272989857,34.3529727010143
"2000","yeah cause",2.88140625858747,47,18,29,12.6470272989857,34.3529727010143
"1960","cats",2.87956930662378,59,7,52,3.52367313017956,55.4763268698204
"1960","girl girl",2.87956930662378,59,7,52,3.52367313017956,55.4763268698204
"1960","mister",2.87956930662378,59,7,52,3.52367313017956,55.4763268698204
"1960","tenderness",2.87956930662378,59,7,52,3.52367313017956,55.4763268698204
"2000","afro",2.87868113318547,12,6,6,3.22902824654955,8.77097175345045
"2000","airplane",2.87868113318547,12,6,6,3.22902824654955,8.77097175345045
"2000","baby dont worry",2.87868113318547,12,6,6,3.22902824654955,8.77097175345045
"2000","back whoa",2.87868113318547,12,6,6,3.22902824654955,8.77097175345045
"2000","behind back",2.87868113318547,12,6,6,3.22902824654955,8.77097175345045
"2000","belong together",2.87868113318547,12,6,6,3.22902824654955,8.77097175345045
"2000","blonde hair",2.87868113318547,12,6,6,3.22902824654955,8.77097175345045
"2000","boy cant",2.87868113318547,12,6,6,3.22902824654955,8.77097175345045
"2000","can mend",2.87868113318547,12,6,6,3.22902824654955,8.77097175345045
"2000","can say love",2.87868113318547,12,6,6,3.22902824654955,8.77097175345045
"2000","carrying",2.87868113318547,12,6,6,3.22902824654955,8.77097175345045
"2000","cause right",2.87868113318547,12,6,6,3.22902824654955,8.77097175345045
"2000","doggy",2.87868113318547,12,6,6,3.22902824654955,8.77097175345045
"2000","dont trip",2.87868113318547,12,6,6,3.22902824654955,8.77097175345045
"2000","em just",2.87868113318547,12,6,6,3.22902824654955,8.77097175345045
"2000","everything never",2.87868113318547,12,6,6,3.22902824654955,8.77097175345045
"2000","false",2.87868113318547,12,6,6,3.22902824654955,8.77097175345045
"2000","focused",2.87868113318547,12,6,6,3.22902824654955,8.77097175345045
"2000","fun now",2.87868113318547,12,6,6,3.22902824654955,8.77097175345045
"2000","game im",2.87868113318547,12,6,6,3.22902824654955,8.77097175345045
"2000","girl next",2.87868113318547,12,6,6,3.22902824654955,8.77097175345045
"2000","got dont",2.87868113318547,12,6,6,3.22902824654955,8.77097175345045
"2000","got twisted",2.87868113318547,12,6,6,3.22902824654955,8.77097175345045
"2000","head back",2.87868113318547,12,6,6,3.22902824654955,8.77097175345045
"2000","im stay",2.87868113318547,12,6,6,3.22902824654955,8.77097175345045
"2000","keep goin",2.87868113318547,12,6,6,3.22902824654955,8.77097175345045
"2000","leanin",2.87868113318547,12,6,6,3.22902824654955,8.77097175345045
"2000","like youll",2.87868113318547,12,6,6,3.22902824654955,8.77097175345045
"2000","live inside",2.87868113318547,12,6,6,3.22902824654955,8.77097175345045
"2000","love now love",2.87868113318547,12,6,6,3.22902824654955,8.77097175345045
"2000","mink",2.87868113318547,12,6,6,3.22902824654955,8.77097175345045
"2000","need gotta",2.87868113318547,12,6,6,3.22902824654955,8.77097175345045
"2000","new york new york",2.87868113318547,12,6,6,3.22902824654955,8.77097175345045
"2000","oh oh uh",2.87868113318547,12,6,6,3.22902824654955,8.77097175345045
"2000","oh ooh oh",2.87868113318547,12,6,6,3.22902824654955,8.77097175345045
"2000","oh way",2.87868113318547,12,6,6,3.22902824654955,8.77097175345045
"2000","oh whoa whoa",2.87868113318547,12,6,6,3.22902824654955,8.77097175345045
"2000","one big",2.87868113318547,12,6,6,3.22902824654955,8.77097175345045
"2000","people want",2.87868113318547,12,6,6,3.22902824654955,8.77097175345045
"2000","pero",2.87868113318547,12,6,6,3.22902824654955,8.77097175345045
"2000","pills",2.87868113318547,12,6,6,3.22902824654955,8.77097175345045
"2000","promise love",2.87868113318547,12,6,6,3.22902824654955,8.77097175345045
"2000","put money",2.87868113318547,12,6,6,3.22902824654955,8.77097175345045
"2000","real dont",2.87868113318547,12,6,6,3.22902824654955,8.77097175345045
"2000","real shit",2.87868113318547,12,6,6,3.22902824654955,8.77097175345045
"2000","remember told",2.87868113318547,12,6,6,3.22902824654955,8.77097175345045
"2000","rep",2.87868113318547,12,6,6,3.22902824654955,8.77097175345045
"2000","rows",2.87868113318547,12,6,6,3.22902824654955,8.77097175345045
"2000","says im",2.87868113318547,12,6,6,3.22902824654955,8.77097175345045
"2000","see come",2.87868113318547,12,6,6,3.22902824654955,8.77097175345045
"2000","shouldve known better",2.87868113318547,12,6,6,3.22902824654955,8.77097175345045
"2000","situations",2.87868113318547,12,6,6,3.22902824654955,8.77097175345045
"2000","something dont",2.87868113318547,12,6,6,3.22902824654955,8.77097175345045
"2000","still rock",2.87868113318547,12,6,6,3.22902824654955,8.77097175345045
"2000","stop stop stop",2.87868113318547,12,6,6,3.22902824654955,8.77097175345045
"2000","strap",2.87868113318547,12,6,6,3.22902824654955,8.77097175345045
"2000","thought someone",2.87868113318547,12,6,6,3.22902824654955,8.77097175345045
"2000","time big",2.87868113318547,12,6,6,3.22902824654955,8.77097175345045
"2000","toll",2.87868113318547,12,6,6,3.22902824654955,8.77097175345045
"2000","trying tell",2.87868113318547,12,6,6,3.22902824654955,8.77097175345045
"2000","upyou",2.87868113318547,12,6,6,3.22902824654955,8.77097175345045
"2000","way play",2.87868113318547,12,6,6,3.22902824654955,8.77097175345045
"2000","weaker",2.87868113318547,12,6,6,3.22902824654955,8.77097175345045
"2000","well baby",2.87868113318547,12,6,6,3.22902824654955,8.77097175345045
"2000","wouldnt give",2.87868113318547,12,6,6,3.22902824654955,8.77097175345045
"2000","yeah go",2.87868113318547,12,6,6,3.22902824654955,8.77097175345045
"2000","york new york",2.87868113318547,12,6,6,3.22902824654955,8.77097175345045
"2000","youll give",2.87868113318547,12,6,6,3.22902824654955,8.77097175345045
"2000","youre playing",2.87868113318547,12,6,6,3.22902824654955,8.77097175345045
"1960","meet",2.87210761369151,381,31,350,22.754567162685,358.245432837315
"2000","just take",2.87179926866601,85,30,55,22.8722834130593,62.1277165869407
"1970","wanna dance",2.87015991540845,95,19,76,13.0005497250943,81.9994502749057
"1970","talking",2.86973916246388,323,55,268,44.2018690653206,278.798130934679
"1980","dont mean",2.8685397077441,128,29,99,21.534173138378,106.465826861622
"1990","average",2.86795759350156,25,9,16,5.30361739823829,19.6963826017617
"1990","better watch",2.86795759350156,25,9,16,5.30361739823829,19.6963826017617
"1990","common",2.86795759350156,25,9,16,5.30361739823829,19.6963826017617
"1990","im standing",2.86795759350156,25,9,16,5.30361739823829,19.6963826017617
"1990","makes hard",2.86795759350156,25,9,16,5.30361739823829,19.6963826017617
"1990","shattered",2.86795759350156,25,9,16,5.30361739823829,19.6963826017617
"1990","thats gonna",2.86795759350156,25,9,16,5.30361739823829,19.6963826017617
"1990","will remember",2.86795759350156,25,9,16,5.30361739823829,19.6963826017617
"1990","yeah tell",2.86795759350156,25,9,16,5.30361739823829,19.6963826017617
"1990","still love",2.86781277665347,156,42,114,33.0945725650069,122.905427434993
"2010","cant hold",2.86285360703444,69,16,53,10.6234279545135,58.3765720454865
"1980","fools",2.85864220040552,78,19,59,13.1223867561991,64.8776132438009
"2000","hurts bad",2.85791244183334,26,11,15,6.99622786752402,19.003772132476
"2000","knows just",2.85791244183334,26,11,15,6.99622786752402,19.003772132476
"2000","meits",2.85791244183334,26,11,15,6.99622786752402,19.003772132476
"2000","ordinary",2.85791244183334,26,11,15,6.99622786752402,19.003772132476
"2000","well meet",2.85791244183334,26,11,15,6.99622786752402,19.003772132476
"1990","mystery",2.85742168936422,51,16,35,10.8193794924061,40.1806205075939
"1960","moment",2.855827145449,410,33,377,24.4865420910783,385.513457908922
"1980","call name",2.8556814345493,123,28,95,20.6929945001601,102.30700549984
"2000","want know want",2.85520907154574,44,17,27,11.8397702373483,32.1602297626517
"1960","early",2.85324676631282,71,8,63,4.24035241089405,66.759647589106
"2010","plan",2.85003157519393,112,24,88,17.2438250855871,94.7561749144129
"1970","get lost",2.84854292610842,43,10,33,5.88445934925321,37.1155406507468
"1970","incomprehensible",2.84854292610842,43,10,33,5.88445934925321,37.1155406507468
"1970","night just",2.84854292610842,43,10,33,5.88445934925321,37.1155406507468
"1980","make feel good",2.84301882123186,40,11,29,6.72942910574312,33.2705708942569
"2010","broken",2.83944994301463,329,62,267,50.6537361889121,278.346263811088
"1980","cant give",2.83678123480227,31,9,22,5.21530755695092,25.7846924430491
"1980","certain",2.83678123480227,31,9,22,5.21530755695092,25.7846924430491
"1980","chills",2.83678123480227,31,9,22,5.21530755695092,25.7846924430491
"1980","come alive",2.83678123480227,31,9,22,5.21530755695092,25.7846924430491
"1980","give chance",2.83678123480227,31,9,22,5.21530755695092,25.7846924430491
"1980","happening",2.83678123480227,31,9,22,5.21530755695092,25.7846924430491
"1980","higher higher",2.83678123480227,31,9,22,5.21530755695092,25.7846924430491
"1980","hold now",2.83678123480227,31,9,22,5.21530755695092,25.7846924430491
"1980","holding back",2.83678123480227,31,9,22,5.21530755695092,25.7846924430491
"1980","im giving",2.83678123480227,31,9,22,5.21530755695092,25.7846924430491
"1980","longing",2.83678123480227,31,9,22,5.21530755695092,25.7846924430491
"1980","night oh night",2.83678123480227,31,9,22,5.21530755695092,25.7846924430491
"1980","pretending",2.83678123480227,31,9,22,5.21530755695092,25.7846924430491
"1980","oh im",2.83550063017157,113,26,87,19.0106372237243,93.9893627762757
"2000","happy people",2.83388627788945,41,16,25,11.032513175711,29.9674868242891
"2000","im alive",2.83388627788945,41,16,25,11.032513175711,29.9674868242891
"2000","roll baby",2.83388627788945,41,16,25,11.032513175711,29.9674868242891
"1980","strange",2.82867419190779,108,25,83,18.1694585855064,89.8305414144936
"1990","baby youve",2.82782075508267,36,12,24,7.63720905346314,28.3627909465369
"1990","dont know can",2.82782075508267,36,12,24,7.63720905346314,28.3627909465369
"1990","life love",2.82782075508267,36,12,24,7.63720905346314,28.3627909465369
"1990","numbers",2.82782075508267,36,12,24,7.63720905346314,28.3627909465369
"1990","police",2.82782075508267,36,12,24,7.63720905346314,28.3627909465369
"1990","theres one thing",2.82782075508267,36,12,24,7.63720905346314,28.3627909465369
"1990","touch like",2.82782075508267,36,12,24,7.63720905346314,28.3627909465369
"1970","card",2.82780967645597,27,7,20,3.69489307976364,23.3051069202364
"1970","got take",2.82780967645597,27,7,20,3.69489307976364,23.3051069202364
"1970","hoped",2.82780967645597,27,7,20,3.69489307976364,23.3051069202364
"1970","mellow",2.82780967645597,27,7,20,3.69489307976364,23.3051069202364
"1970","whats wrong",2.82780967645597,27,7,20,3.69489307976364,23.3051069202364
"1970","wire",2.82780967645597,27,7,20,3.69489307976364,23.3051069202364
"2000","amor",2.82687253957576,29,12,17,7.80348492916141,21.1965150708386
"2000","bad girl",2.82687253957576,29,12,17,7.80348492916141,21.1965150708386
"2000","better days",2.82687253957576,29,12,17,7.80348492916141,21.1965150708386
"2000","cause dont know",2.82687253957576,29,12,17,7.80348492916141,21.1965150708386
"2000","go yeah",2.82687253957576,29,12,17,7.80348492916141,21.1965150708386
"2000","love dont know",2.82687253957576,29,12,17,7.80348492916141,21.1965150708386
"2000","toast",2.82687253957576,29,12,17,7.80348492916141,21.1965150708386
"1970","just give",2.82567559115665,60,13,47,8.21087351058588,51.7891264894141
"1960","anyone",2.82041562631106,134,13,121,8.00291863464511,125.997081365355
"1960","oh yes",2.82041562631106,134,13,121,8.00291863464511,125.997081365355
"1960","come dance",2.81927525599412,48,6,42,2.86671712285795,45.1332828771421
"2000","cant escape",2.81857021751359,38,15,23,10.2252561140736,27.7747438859264
"2000","mine oh",2.81857021751359,38,15,23,10.2252561140736,27.7747438859264
"2000","say ooh",2.81857021751359,38,15,23,10.2252561140736,27.7747438859264
"2000","ill keep",2.81778534130328,66,24,42,17.7596553560225,48.2403446439775
"2000","iti",2.81778534130328,66,24,42,17.7596553560225,48.2403446439775
"2000","player",2.81778534130328,66,24,42,17.7596553560225,48.2403446439775
"2010","ill take",2.81753534621938,151,31,120,23.2483713207469,127.751628679253
"1990","girl cause",2.81720267274008,55,17,38,11.6679582761242,43.3320417238758
"1990","right just",2.81720267274008,55,17,38,11.6679582761242,43.3320417238758
"2000","showed",2.81687701947362,82,29,53,22.0650263514219,59.9349736485781
"2000","como",2.81257111075803,32,13,19,8.61074199079879,23.3892580092012
"2000","dropped",2.81257111075803,32,13,19,8.61074199079879,23.3892580092012
"2000","home alone",2.81257111075803,32,13,19,8.61074199079879,23.3892580092012
"2000","jones",2.81257111075803,32,13,19,8.61074199079879,23.3892580092012
"2000","long know",2.81257111075803,32,13,19,8.61074199079879,23.3892580092012
"2000","raining",2.81257111075803,32,13,19,8.61074199079879,23.3892580092012
"2000","soldiers",2.81257111075803,32,13,19,8.61074199079879,23.3892580092012
"2000","cause shes",2.81077469861583,35,14,21,9.41799905243618,25.5820009475638
"1980","belong",2.80866040774494,302,62,240,50.8071897483605,251.192810251639
"1990","saying",2.80324745677237,314,79,235,66.6134345218729,247.386565478127
"1960","love oh",2.80258484011471,228,20,208,13.6169063335753,214.383093666425
"1990","joy",2.800816434308,169,45,124,35.8524536120908,133.147546387909
"1960","mary",2.79719577312486,96,10,86,5.7334342457159,90.2665657542841
"1960","number one",2.79719577312486,96,10,86,5.7334342457159,90.2665657542841
"1960","sail",2.79719577312486,96,10,86,5.7334342457159,90.2665657542841
"1960","shouldnt",2.79719577312486,96,10,86,5.7334342457159,90.2665657542841
"2000","meant",2.79716160265221,318,99,219,85.569248533563,232.430751466437
"2010","colder",2.79662311126533,29,8,21,4.46491899537523,24.5350810046248
"2010","good dont",2.79662311126533,29,8,21,4.46491899537523,24.5350810046248
"2010","id make",2.79662311126533,29,8,21,4.46491899537523,24.5350810046248
"2010","playin song",2.79662311126533,29,8,21,4.46491899537523,24.5350810046248
"2010","show got",2.79662311126533,29,8,21,4.46491899537523,24.5350810046248
"2010","thought youd",2.79662311126533,29,8,21,4.46491899537523,24.5350810046248
"2010","traffic",2.79662311126533,29,8,21,4.46491899537523,24.5350810046248
"1970","da da da la",2.7939669228382,22,6,16,3.01065362054815,18.9893463794518
"1970","enough youre",2.7939669228382,22,6,16,3.01065362054815,18.9893463794518
"1970","feel need",2.7939669228382,22,6,16,3.01065362054815,18.9893463794518
"1970","got life",2.7939669228382,22,6,16,3.01065362054815,18.9893463794518
"1970","hey whats",2.7939669228382,22,6,16,3.01065362054815,18.9893463794518
"1970","ill say",2.7939669228382,22,6,16,3.01065362054815,18.9893463794518
"1970","oh hes",2.7939669228382,22,6,16,3.01065362054815,18.9893463794518
"1970","sons",2.7939669228382,22,6,16,3.01065362054815,18.9893463794518
"1970","way cant",2.7939669228382,22,6,16,3.01065362054815,18.9893463794518
"1970","wrong wrong",2.7939669228382,22,6,16,3.01065362054815,18.9893463794518
"1970","yeah id",2.7939669228382,22,6,16,3.01065362054815,18.9893463794518
"1980","life",2.78833732536965,2901,522,2379,488.05184589402,2412.94815410598
"1990","torn",2.78654398421722,59,18,41,12.5165370598424,46.4834629401576
"1980","im happy",2.78259572917305,59,15,44,9.9259079309711,49.0740920690289
"1980","view",2.78259572917305,59,15,44,9.9259079309711,49.0740920690289
"2010","screamin",2.78033144742978,59,14,45,9.08380071472892,49.9161992852711
"1980","beside",2.7797096554534,144,32,112,24.2259447806752,119.774055219325
"1970","wanna get",2.77471619679978,195,35,160,26.6853389094041,168.314661090596
"1990","ahead",2.77350476107388,165,44,121,35.0038748283727,129.996125171627
"1970","turns",2.76725049984856,120,23,97,16.4217470211718,103.578252978828
"1990","doo doo doo",2.76368147875729,63,19,44,13.3651158435605,49.6348841564395
"1990","now want",2.76368147875729,63,19,44,13.3651158435605,49.6348841564395
"1970","love girl",2.76229687614767,151,28,123,20.6640316683078,130.335968331692
"2010","gun",2.76221298587224,191,38,153,29.4068802798852,161.593119720115
"1960","baby got",2.76010757429084,109,11,98,6.50983679982326,102.490163200177
"1960","gonna love",2.76010757429084,109,11,98,6.50983679982326,102.490163200177
"1960","lyin",2.75779869057371,84,9,75,5.01675496500141,78.9832450349986
"1960","tree",2.75779869057371,84,9,75,5.01675496500141,78.9832450349986
"1990","got time",2.75611839292368,99,28,71,21.0023248970236,77.9976751029764
"1990","steal",2.75611839292368,99,28,71,21.0023248970236,77.9976751029764
"1970","isnt",2.75475169565583,240,42,198,32.8434940423435,207.156505957657
"1970","searchin",2.75272259137216,72,15,57,9.85304821270305,62.146951787297
"1960","boots",2.75239843897255,60,7,53,3.58339640357244,56.4166035964276
"1970","back",2.74969521324182,3938,575,3363,538.90699807812,3399.09300192188
"1960","hurts",2.74849974048966,148,14,134,8.83904446214534,139.160955537855
"2010","long im",2.74821186780538,54,13,41,8.31398709483664,45.6860129051634
"1990","oh yeah",2.74285570794391,542,131,411,114.982425193806,427.017574806194
"1980","nite",2.74258350499,45,12,33,7.57060774396101,37.429392256039
"1980","tells",2.74258350499,45,12,33,7.57060774396101,37.429392256039
"1990","never end",2.74197700130976,40,13,27,8.48578783718126,31.5142121628187
"1990","peter",2.74197700130976,40,13,27,8.48578783718126,31.5142121628187
"1990","wanna leave",2.74197700130976,40,13,27,8.48578783718126,31.5142121628187
"1980","never seen",2.74134970401914,64,16,48,10.767086569189,53.232913430811
"2010","drives",2.73971654753752,34,9,25,5.23473261526751,28.7652673847325
"2010","find someone",2.73971654753752,34,9,25,5.23473261526751,28.7652673847325
"2010","im gonna find",2.73971654753752,34,9,25,5.23473261526751,28.7652673847325
"2010","life baby",2.73971654753752,34,9,25,5.23473261526751,28.7652673847325
"2010","like thats",2.73971654753752,34,9,25,5.23473261526751,28.7652673847325
"2010","looking like",2.73971654753752,34,9,25,5.23473261526751,28.7652673847325
"1990","insane",2.73755168761397,91,26,65,19.3051673295874,71.6948326704126
"1970","little time",2.73363303737508,78,16,62,10.6741355637616,67.3258644362384
"1990","sip",2.72784135370837,83,24,59,17.6080097621511,65.3919902378489
"2010","get high",2.72456766198221,49,12,37,7.54417347494436,41.4558265250556
"2010","motherfuckin",2.72456766198221,49,12,37,7.54417347494436,41.4558265250556
"2000","let em",2.72387411331036,60,22,38,16.1451412327477,43.8548587672523
"2000","one knows",2.72387411331036,60,22,38,16.1451412327477,43.8548587672523
"1970","part",2.72342543744801,338,57,281,46.2545874429671,291.745412557033
"1970","wont come",2.72296361451909,84,17,67,11.4952229148202,72.5047770851798
"1970","rise",2.71909886722905,90,18,72,12.3163102658788,77.6836897341212
"2010","fifty",2.71507457371334,39,10,29,6.0045462351598,32.9954537648402
"2010","im caught",2.71507457371334,39,10,29,6.0045462351598,32.9954537648402
"2010","nervous",2.71507457371334,39,10,29,6.0045462351598,32.9954537648402
"2010","night love",2.71507457371334,39,10,29,6.0045462351598,32.9954537648402
"2010","back like",2.71215463302903,44,11,33,6.77435985505208,37.2256401449479
"2010","feel heat",2.71215463302903,44,11,33,6.77435985505208,37.2256401449479
"2010","get baby",2.71215463302903,44,11,33,6.77435985505208,37.2256401449479
"2010","got feelin",2.71215463302903,44,11,33,6.77435985505208,37.2256401449479
"2010","got good",2.71215463302903,44,11,33,6.77435985505208,37.2256401449479
"2010","meoh",2.71215463302903,44,11,33,6.77435985505208,37.2256401449479
"1980","oh got",2.71057893423658,69,17,52,11.6082652074069,57.3917347925931
"1980","worse",2.71057893423658,69,17,52,11.6082652074069,57.3917347925931
"2010","bottle",2.70874927586067,124,26,98,19.0913777733286,104.908622226671
"2000","flying",2.70827084732771,76,27,49,20.4505122281471,55.5494877718529
"1990","command",2.70771066205854,29,10,19,6.15219618195642,22.8478038180436
"1990","day can",2.70771066205854,29,10,19,6.15219618195642,22.8478038180436
"1990","every moment",2.70771066205854,29,10,19,6.15219618195642,22.8478038180436
"1990","im gonna give",2.70771066205854,29,10,19,6.15219618195642,22.8478038180436
"1990","make every",2.70771066205854,29,10,19,6.15219618195642,22.8478038180436
"1990","plain see",2.70771066205854,29,10,19,6.15219618195642,22.8478038180436
"1990","theres love",2.70771066205854,29,10,19,6.15219618195642,22.8478038180436
"1990","also",2.70742544430902,15,6,9,3.18217043894297,11.817829561057
"1990","baby got need",2.70742544430902,15,6,9,3.18217043894297,11.817829561057
"1990","blink",2.70742544430902,15,6,9,3.18217043894297,11.817829561057
"1990","break us",2.70742544430902,15,6,9,3.18217043894297,11.817829561057
"1990","cause youre one",2.70742544430902,15,6,9,3.18217043894297,11.817829561057
"1990","childhood",2.70742544430902,15,6,9,3.18217043894297,11.817829561057
"1990","cloudy",2.70742544430902,15,6,9,3.18217043894297,11.817829561057
"1990","concern",2.70742544430902,15,6,9,3.18217043894297,11.817829561057
"1990","dance wanna dance",2.70742544430902,15,6,9,3.18217043894297,11.817829561057
"1990","every time close",2.70742544430902,15,6,9,3.18217043894297,11.817829561057
"1990","every time close eyes",2.70742544430902,15,6,9,3.18217043894297,11.817829561057
"1990","first saw",2.70742544430902,15,6,9,3.18217043894297,11.817829561057
"1990","fling",2.70742544430902,15,6,9,3.18217043894297,11.817829561057
"1990","friend oh",2.70742544430902,15,6,9,3.18217043894297,11.817829561057
"1990","gonna cause",2.70742544430902,15,6,9,3.18217043894297,11.817829561057
"1990","heaven earth",2.70742544430902,15,6,9,3.18217043894297,11.817829561057
"1990","honey aint",2.70742544430902,15,6,9,3.18217043894297,11.817829561057
"1990","ill need",2.70742544430902,15,6,9,3.18217043894297,11.817829561057
"1990","im dying",2.70742544430902,15,6,9,3.18217043894297,11.817829561057
"1990","just matter",2.70742544430902,15,6,9,3.18217043894297,11.817829561057
"1990","just stop",2.70742544430902,15,6,9,3.18217043894297,11.817829561057
"1990","keep gettin",2.70742544430902,15,6,9,3.18217043894297,11.817829561057
"1990","keep looking",2.70742544430902,15,6,9,3.18217043894297,11.817829561057
"1990","link",2.70742544430902,15,6,9,3.18217043894297,11.817829561057
"1990","long hair",2.70742544430902,15,6,9,3.18217043894297,11.817829561057
"1990","mamma",2.70742544430902,15,6,9,3.18217043894297,11.817829561057
"1990","must admit",2.70742544430902,15,6,9,3.18217043894297,11.817829561057
"1990","night everything",2.70742544430902,15,6,9,3.18217043894297,11.817829561057
"1990","ohif",2.70742544430902,15,6,9,3.18217043894297,11.817829561057
"1990","one made",2.70742544430902,15,6,9,3.18217043894297,11.817829561057
"1990","queens",2.70742544430902,15,6,9,3.18217043894297,11.817829561057
"1990","set mind",2.70742544430902,15,6,9,3.18217043894297,11.817829561057
"1990","think hes",2.70742544430902,15,6,9,3.18217043894297,11.817829561057
"1990","treats",2.70742544430902,15,6,9,3.18217043894297,11.817829561057
"1990","want dont want dont",2.70742544430902,15,6,9,3.18217043894297,11.817829561057
"1990","whatever dont",2.70742544430902,15,6,9,3.18217043894297,11.817829561057
"1990","yeah every",2.70742544430902,15,6,9,3.18217043894297,11.817829561057
"2000","ring",2.70508226942739,274,86,188,73.7294782962147,200.270521703785
"1980","cuts",2.70261717058017,27,8,19,4.5423646463766,22.4576353536234
"1980","dont fight",2.70261717058017,27,8,19,4.5423646463766,22.4576353536234
"1980","im crying",2.70261717058017,27,8,19,4.5423646463766,22.4576353536234
"1980","now girl",2.70261717058017,27,8,19,4.5423646463766,22.4576353536234
"1980","tell cant",2.70261717058017,27,8,19,4.5423646463766,22.4576353536234
"1980","afraid",2.70195405909196,239,50,189,40.2083389068151,198.791661093185
"2010","back got",2.6993370612251,20,6,14,3.07925447956913,16.9207455204309
"2010","bring fire",2.6993370612251,20,6,14,3.07925447956913,16.9207455204309
"2010","can kiss",2.6993370612251,20,6,14,3.07925447956913,16.9207455204309
"2010","enemy",2.6993370612251,20,6,14,3.07925447956913,16.9207455204309
"2010","hey boy",2.6993370612251,20,6,14,3.07925447956913,16.9207455204309
"2010","high love",2.6993370612251,20,6,14,3.07925447956913,16.9207455204309
"2010","itnow",2.6993370612251,20,6,14,3.07925447956913,16.9207455204309
"2010","lost can",2.6993370612251,20,6,14,3.07925447956913,16.9207455204309
"2010","maybe just",2.6993370612251,20,6,14,3.07925447956913,16.9207455204309
"2010","paying",2.6993370612251,20,6,14,3.07925447956913,16.9207455204309
"2010","think every",2.6993370612251,20,6,14,3.07925447956913,16.9207455204309
"2010","tomorrow will",2.6993370612251,20,6,14,3.07925447956913,16.9207455204309
"1980","losing",2.69240470310603,155,34,121,26.0765377847546,128.923462215245
"2010","felt",2.68613132233031,325,61,264,50.0378852929983,274.962114707002
"1980","things said",2.6858637642735,36,10,26,6.05648619516881,29.9435138048312
"1970","joe",2.68369908848859,55,12,43,7.52663405137039,47.4733659486296
"1970","vain",2.68369908848859,55,12,43,7.52663405137039,47.4733659486296
"2000","baby give",2.67897991142825,57,21,36,15.3378841711103,41.6621158288897
"2000","wishin",2.67897991142825,57,21,36,15.3378841711103,41.6621158288897
"1960","see way",2.67830721622315,49,6,43,2.92644039625082,46.0735596037492
"1960","youre always",2.67830721622315,49,6,43,2.92644039625082,46.0735596037492
"1990","touching",2.67683801622224,44,14,30,9.33436662089939,34.6656333791006
"2010","dope",2.67316714005529,86,19,67,13.2407942621472,72.7592057378528
"2010","im alone",2.67316714005529,86,19,67,13.2407942621472,72.7592057378528
"1980","storm",2.67279996956991,79,19,60,13.2906224838427,65.7093775161573
"1960","ear",2.67153204719882,110,11,99,6.56956007321613,103.430439926784
"1980","knees",2.66837650138034,197,42,155,33.1424383457849,163.857561654215
"1980","years",2.66778314073597,412,82,330,69.3131197891541,342.686880210846
"1980","tide",2.66768514252899,50,13,37,8.4117863821789,41.5882136178211
"1980","wasting",2.66768514252899,50,13,37,8.4117863821789,41.5882136178211
"1990","love know",2.66723321284169,149,40,109,31.6095596935002,117.3904403065
"2000","aint got nothing",2.66580118885756,15,7,8,4.03628530818693,10.9637146918131
"2000","anything wanna",2.66580118885756,15,7,8,4.03628530818693,10.9637146918131
"2000","awayyou",2.66580118885756,15,7,8,4.03628530818693,10.9637146918131
"2000","breath take",2.66580118885756,15,7,8,4.03628530818693,10.9637146918131
"2000","buns",2.66580118885756,15,7,8,4.03628530818693,10.9637146918131
"2000","dont baby",2.66580118885756,15,7,8,4.03628530818693,10.9637146918131
"2000","eighty degrees",2.66580118885756,15,7,8,4.03628530818693,10.9637146918131
"2000","every time come",2.66580118885756,15,7,8,4.03628530818693,10.9637146918131
"2000","feel arms",2.66580118885756,15,7,8,4.03628530818693,10.9637146918131
"2000","feeling right",2.66580118885756,15,7,8,4.03628530818693,10.9637146918131
"2000","go hey",2.66580118885756,15,7,8,4.03628530818693,10.9637146918131
"2000","got game",2.66580118885756,15,7,8,4.03628530818693,10.9637146918131
"2000","got problem",2.66580118885756,15,7,8,4.03628530818693,10.9637146918131
"2000","heh",2.66580118885756,15,7,8,4.03628530818693,10.9637146918131
"2000","itcause",2.66580118885756,15,7,8,4.03628530818693,10.9637146918131
"2000","know man",2.66580118885756,15,7,8,4.03628530818693,10.9637146918131
"2000","love let go",2.66580118885756,15,7,8,4.03628530818693,10.9637146918131
"2000","meshe",2.66580118885756,15,7,8,4.03628530818693,10.9637146918131
"2000","niggas dont",2.66580118885756,15,7,8,4.03628530818693,10.9637146918131
"2000","pad",2.66580118885756,15,7,8,4.03628530818693,10.9637146918131
"2000","real nice",2.66580118885756,15,7,8,4.03628530818693,10.9637146918131
"2000","right now dont",2.66580118885756,15,7,8,4.03628530818693,10.9637146918131
"2000","rooms",2.66580118885756,15,7,8,4.03628530818693,10.9637146918131
"2000","say id",2.66580118885756,15,7,8,4.03628530818693,10.9637146918131
"2000","thing im",2.66580118885756,15,7,8,4.03628530818693,10.9637146918131
"2000","think hes",2.66580118885756,15,7,8,4.03628530818693,10.9637146918131
"2000","thousand miles",2.66580118885756,15,7,8,4.03628530818693,10.9637146918131
"2000","three got",2.66580118885756,15,7,8,4.03628530818693,10.9637146918131
"2000","touch baby",2.66580118885756,15,7,8,4.03628530818693,10.9637146918131
"2000","way felt",2.66580118885756,15,7,8,4.03628530818693,10.9637146918131
"2000","way never",2.66580118885756,15,7,8,4.03628530818693,10.9637146918131
"2000","will carry",2.66580118885756,15,7,8,4.03628530818693,10.9637146918131
"2000","world one",2.66580118885756,15,7,8,4.03628530818693,10.9637146918131
"2000","youre talkin",2.66580118885756,15,7,8,4.03628530818693,10.9637146918131
"1980","away love",2.66306331395541,84,20,64,14.1318011220605,69.8681988779394
"1980","precious",2.66306331395541,84,20,64,14.1318011220605,69.8681988779394
"1960","looked",2.65760801221221,203,18,185,12.1238244987534,190.876175501247
"2010","river",2.64493036939633,215,42,173,33.1019856553681,181.898014344632
"2010","kissed",2.64452265841471,97,21,76,14.9343842259103,82.0656157740897
"1990","back youre",2.64293254216626,22,8,14,4.6671833104497,17.3328166895503
"1990","dont want dont want",2.64293254216626,22,8,14,4.6671833104497,17.3328166895503
"1990","every way",2.64293254216626,22,8,14,4.6671833104497,17.3328166895503
"1990","get weak",2.64293254216626,22,8,14,4.6671833104497,17.3328166895503
"1990","give want",2.64293254216626,22,8,14,4.6671833104497,17.3328166895503
"1990","gonna get get",2.64293254216626,22,8,14,4.6671833104497,17.3328166895503
"1990","love around",2.64293254216626,22,8,14,4.6671833104497,17.3328166895503
"1990","nut",2.64293254216626,22,8,14,4.6671833104497,17.3328166895503
"1990","phase",2.64293254216626,22,8,14,4.6671833104497,17.3328166895503
"1990","power love",2.64293254216626,22,8,14,4.6671833104497,17.3328166895503
"1990","spine",2.64293254216626,22,8,14,4.6671833104497,17.3328166895503
"1990","think want",2.64293254216626,22,8,14,4.6671833104497,17.3328166895503
"1990","trying find",2.64293254216626,22,8,14,4.6671833104497,17.3328166895503
"1990","whispering",2.64293254216626,22,8,14,4.6671833104497,17.3328166895503
"1970","john",2.63616281172345,61,13,48,8.34772140242897,52.652278597571
"1990","knew",2.63479060042618,712,169,543,151.047023501827,560.952976498173
"1960","away",2.63336308274324,2580,174,2406,154.086045353615,2425.91395464639
"1960","bend",2.62963078296687,61,7,54,3.64311967696531,57.3568803230347
"1960","just call",2.62963078296687,61,7,54,3.64311967696531,57.3568803230347
"1960","fate",2.6284046877532,73,8,65,4.3597989576798,68.6402010423202
"1990","let one",2.62740411465086,48,15,33,10.1829454046175,37.8170545953825
"1990","youbaby",2.62740411465086,48,15,33,10.1829454046175,37.8170545953825
"2010","saying",2.62616071632952,314,59,255,48.3442953292353,265.655704670765
"1970","let rain",2.62573824546335,33,8,25,4.51598043082223,28.4840195691778
"1970","make little",2.62573824546335,33,8,25,4.51598043082223,28.4840195691778
"2010","bus",2.62399011366237,65,15,50,10.0075770585997,54.9924229414003
"2010","just need",2.62399011366237,65,15,50,10.0075770585997,54.9924229414003
"1970","now thats",2.62041040470571,44,10,34,6.02130724109631,37.9786927589037
"1970","often",2.62041040470571,44,10,34,6.02130724109631,37.9786927589037
"1970","wont make",2.62041040470571,44,10,34,6.02130724109631,37.9786927589037
"1970","youre angel",2.62041040470571,44,10,34,6.02130724109631,37.9786927589037
"1960","along",2.61892018322938,401,32,369,23.9490326305424,377.050967369458
"1980","eyes see",2.61166910213167,55,14,41,9.25296502039679,45.7470349796032
"2000","drink",2.60734357143575,292,91,201,78.573020666039,213.426979333961
"1990","bump",2.60404687465451,108,30,78,22.9116271603894,85.0883728396106
"2000","night im",2.60166602430753,70,25,45,18.8359981048724,51.1640018951276
"1970","others",2.60148914796806,109,21,88,14.9164202108977,94.0835797891023
"1980","believe",2.595632650554,1245,231,1014,209.453480916255,1035.54651908375
"2000","cherry",2.59450893767341,51,19,32,13.7233700478356,37.2766299521644
"2000","dressed",2.59450893767341,51,19,32,13.7233700478356,37.2766299521644
"2010","right right",2.59361666672864,136,28,108,20.9389304610701,115.06106953893
"1990","can hardly",2.59216902549246,33,11,22,7.00077496567454,25.9992250343255
"1990","can play",2.59216902549246,33,11,22,7.00077496567454,25.9992250343255
"1990","flex",2.59216902549246,33,11,22,7.00077496567454,25.9992250343255
"1990","im beggin",2.59216902549246,33,11,22,7.00077496567454,25.9992250343255
"1990","show im",2.59216902549246,33,11,22,7.00077496567454,25.9992250343255
"1990","well together",2.59216902549246,33,11,22,7.00077496567454,25.9992250343255
"1990","deep",2.59082898530658,606,145,461,128.559685733296,477.440314266704
"1990","heart break",2.5901704198806,52,16,36,11.0315241883356,40.9684758116644
"1970","woh",2.58735202225529,103,20,83,14.0953328598391,88.9046671401609
"2000","smokin",2.58533860304659,96,33,63,25.8322259723964,70.1677740276036
"1980","climbing",2.58089381186666,23,7,16,3.86942173580229,19.1305782641977
"1980","ive loved",2.58089381186666,23,7,16,3.86942173580229,19.1305782641977
"1980","know good",2.58089381186666,23,7,16,3.86942173580229,19.1305782641977
"1980","like river",2.58089381186666,23,7,16,3.86942173580229,19.1305782641977
"1980","may seem",2.58089381186666,23,7,16,3.86942173580229,19.1305782641977
"1980","never thought id",2.58089381186666,23,7,16,3.86942173580229,19.1305782641977
"1980","one one one",2.58089381186666,23,7,16,3.86942173580229,19.1305782641977
"1980","sits",2.58089381186666,23,7,16,3.86942173580229,19.1305782641977
"1980","take home take",2.58089381186666,23,7,16,3.86942173580229,19.1305782641977
"1980","til see",2.58089381186666,23,7,16,3.86942173580229,19.1305782641977
"1980","yeah ive",2.58089381186666,23,7,16,3.86942173580229,19.1305782641977
"1960","dont leave",2.57863916213371,124,12,112,7.40568590071637,116.594314099284
"2010","quiet",2.57817047703136,60,14,46,9.23776343870738,50.7622365612926
"1960","mama",2.5781113206743,460,36,424,27.472705760722,432.527294239278
"1980","money dont",2.57756285070764,41,11,30,6.8976648333867,34.1023351666133
"1980","separate",2.57756285070764,41,11,30,6.8976648333867,34.1023351666133
"2010","nobody else",2.57753189685825,92,20,72,14.164570606018,77.835429393982
"1970","falling love",2.57660612320223,97,19,78,13.2742455087805,83.7257544912195
"1970","kissed",2.57660612320223,97,19,78,13.2742455087805,83.7257544912195
"1970","leaves",2.57660612320223,97,19,78,13.2742455087805,83.7257544912195
"1970","climb",2.57208978755043,79,16,63,10.8109834556047,68.1890165443953
"1970","fair",2.57208978755043,79,16,63,10.8109834556047,68.1890165443953
"1990","never know",2.572071780922,100,28,72,21.2144695929532,78.7855304070468
"1990","holding",2.56988970448107,299,75,224,63.43126408293,235.56873591707
"1970","diggin",2.56803781904967,85,17,68,11.6320708066633,73.3679291933367
"1970","killing",2.56803781904967,85,17,68,11.6320708066633,73.3679291933367
"1990","deny",2.56698942150302,133,36,97,28.2152445586277,104.784755441372
"2010","day youll",2.56586765780195,25,7,18,3.84906809946141,21.1509319005386
"2010","night gonna",2.56586765780195,25,7,18,3.84906809946141,21.1509319005386
"2010","something good",2.56586765780195,25,7,18,3.84906809946141,21.1509319005386
"2010","sweetheart",2.56586765780195,25,7,18,3.84906809946141,21.1509319005386
"2010","thats thats",2.56586765780195,25,7,18,3.84906809946141,21.1509319005386
"2010","till break",2.56586765780195,25,7,18,3.84906809946141,21.1509319005386
"2010","whenever youre",2.56586765780195,25,7,18,3.84906809946141,21.1509319005386
"1990","baby like",2.56260560540491,56,17,39,11.8801029720538,44.1198970279462
"1990","tried",2.55838246789821,408,100,308,86.5550359392489,321.444964060751
"1960","dont come",2.5564281038068,86,9,77,5.13620151178716,80.8637984882128
"1980","know",2.55625578081293,11166,1942,9224,1878.52013486819,9287.47986513181
"2000","aint gon",2.55558662323318,48,18,30,12.9161129861982,35.0838870138018
"1960","another",2.55521789865328,1121,80,1041,66.9497894734117,1054.05021052659
"1980","turns",2.55204600144676,120,27,93,20.1882873172294,99.8117126827707
"2010","class",2.55136547069869,76,17,59,11.7011670223627,64.2988329776373
"2010","beat",2.54716016692954,765,134,631,117.781483843519,647.218516156481
"1970","finding",2.54349849280271,50,11,39,6.8423945921549,43.1576054078451
"1970","misery",2.54349849280271,50,11,39,6.8423945921549,43.1576054078451
"1970","want give",2.54349849280271,50,11,39,6.8423945921549,43.1576054078451
"1960","alright alright alright",2.54303583748007,50,6,44,2.9861636696437,47.0138363303563
"1960","forward",2.54303583748007,50,6,44,2.9861636696437,47.0138363303563
"1960","grew",2.54303583748007,50,6,44,2.9861636696437,47.0138363303563
"1960","lyrics",2.54303583748007,50,6,44,2.9861636696437,47.0138363303563
"2000","grabbed",2.5421707124164,18,8,10,4.84354236982432,13.1564576301757
"2000","happy ending",2.5421707124164,18,8,10,4.84354236982432,13.1564576301757
"2000","music makes",2.5421707124164,18,8,10,4.84354236982432,13.1564576301757
"2000","one time one",2.5421707124164,18,8,10,4.84354236982432,13.1564576301757
"2000","really matter",2.5421707124164,18,8,10,4.84354236982432,13.1564576301757
"2000","sing just",2.5421707124164,18,8,10,4.84354236982432,13.1564576301757
"2000","toys",2.5421707124164,18,8,10,4.84354236982432,13.1564576301757
"2000","way back home",2.5421707124164,18,8,10,4.84354236982432,13.1564576301757
"2000","yeah party",2.5421707124164,18,8,10,4.84354236982432,13.1564576301757
"2000","youll never see",2.5421707124164,18,8,10,4.84354236982432,13.1564576301757
"2000","youre bad",2.5421707124164,18,8,10,4.84354236982432,13.1564576301757
"1980","baby thats",2.53954386490848,65,16,49,10.9353222968326,54.0646777031674
"1980","just need",2.53954386490848,65,16,49,10.9353222968326,54.0646777031674
"1980","race",2.53954386490848,65,16,49,10.9353222968326,54.0646777031674
"1970","fill",2.53905131011791,191,34,157,26.1379473420317,164.862052657968
"1970","dance wanna",2.53452800974909,28,7,21,3.83174097160674,24.1682590283933
"1970","ill come",2.53452800974909,28,7,21,3.83174097160674,24.1682590283933
"1970","im waiting",2.53452800974909,28,7,21,3.83174097160674,24.1682590283933
"1970","love bring",2.53452800974909,28,7,21,3.83174097160674,24.1682590283933
"1970","miss baby",2.53452800974909,28,7,21,3.83174097160674,24.1682590283933
"1970","replace",2.53452800974909,28,7,21,3.83174097160674,24.1682590283933
"1970","thing can",2.53452800974909,28,7,21,3.83174097160674,24.1682590283933
"1970","womans",2.53452800974909,28,7,21,3.83174097160674,24.1682590283933
"1980","baby night",2.53216852827413,32,9,23,5.38354328459449,26.6164567154055
"1980","cant resist",2.53216852827413,32,9,23,5.38354328459449,26.6164567154055
"1980","love youll",2.53216852827413,32,9,23,5.38354328459449,26.6164567154055
"1980","never give",2.53216852827413,32,9,23,5.38354328459449,26.6164567154055
"1980","showin",2.53216852827413,32,9,23,5.38354328459449,26.6164567154055
"1980","want tonight",2.53216852827413,32,9,23,5.38354328459449,26.6164567154055
"1990","cant get enough",2.52132815672969,68,20,48,14.4258393232082,53.5741606767919
"1990","youll find",2.52096018906679,80,23,57,16.9715756743625,63.0284243256375
"2000","way im",2.52090143842551,80,28,52,21.526854976997,58.473145023003
"1980","without without",2.51795119540486,70,17,53,11.7765009350505,58.2234990649496
"1980","youre looking",2.51795119540486,70,17,53,11.7765009350505,58.2234990649496
"1990","cos",2.51764225519778,72,21,51,15.2744181069263,56.7255818930737
"1960","im man",2.51734340722664,99,10,89,5.91260406589452,93.0873959341055
"1990","wanted",2.51616039945195,448,109,339,95.0408237764302,352.95917622357
"1980","know aint",2.51175738979916,105,24,81,17.6647514025757,87.3352485974243
"2010","starting",2.51151007303292,87,19,68,13.3947569861257,73.6052430138743
"1960","sorrow",2.51111392721913,62,7,55,3.70284295035818,58.2971570496418
"1990","boyz",2.50734783548127,37,12,25,7.84935374939267,29.1506462506073
"1990","come together",2.50734783548127,37,12,25,7.84935374939267,29.1506462506073
"1990","dont think can",2.50734783548127,37,12,25,7.84935374939267,29.1506462506073
"1990","open heart",2.50734783548127,37,12,25,7.84935374939267,29.1506462506073
"1990","woop",2.50734783548127,37,12,25,7.84935374939267,29.1506462506073
"2010","shake ass",2.50366265525254,50,12,38,7.69813619892281,42.3018638010772
"1990","hear",2.503519174606,1398,321,1077,296.578284909485,1101.42171509051
"1970","almost",2.50191040553043,185,33,152,25.3168599909731,159.683140009027
"1970","story",2.50191040553043,185,33,152,25.3168599909731,159.683140009027
"2000","lets",2.5008036300352,1662,476,1186,447.220412147112,1214.77958785289
"2010","thinking",2.49880601307047,452,82,370,69.5911512382622,382.408848761738
"1980","theres way",2.4986281340336,46,12,34,7.73884347160458,38.2611565283954
"1980","yeah ooh",2.4986281340336,46,12,34,7.73884347160458,38.2611565283954
"1980","youve done",2.4986281340336,46,12,34,7.73884347160458,38.2611565283954
"2010","girl im",2.49854540667139,148,30,118,22.7864831488115,125.213516851188
"2010","can leave",2.49824763184445,30,8,22,4.61888171935369,25.3811182806463
"2010","deuce",2.49824763184445,30,8,22,4.61888171935369,25.3811182806463
"2010","make last",2.49824763184445,30,8,22,4.61888171935369,25.3811182806463
"2010","mike",2.49824763184445,30,8,22,4.61888171935369,25.3811182806463
"2010","one know",2.49824763184445,30,8,22,4.61888171935369,25.3811182806463
"2010","singer",2.49824763184445,30,8,22,4.61888171935369,25.3811182806463
"2010","sounds like",2.49824763184445,30,8,22,4.61888171935369,25.3811182806463
"2010","uh oh oh",2.49824763184445,30,8,22,4.61888171935369,25.3811182806463
"2000","pulled",2.49761931763922,64,23,41,17.2214839815976,46.7785160184024
"1980","let hear",2.49556511446691,95,22,73,15.9823941261399,79.0176058738601
"1990","kill",2.4943464242873,146,39,107,30.9731256057116,115.026874394288
"1970","againi",2.4938722658404,39,9,30,5.33706778188082,33.6629322181192
"1970","ill try",2.4938722658404,39,9,30,5.33706778188082,33.6629322181192
"1970","letters",2.4938722658404,39,9,30,5.33706778188082,33.6629322181192
"2010","im never",2.49168915148705,109,23,86,16.7819369136517,92.2180630863483
"1980","someone else",2.49129474227343,85,20,65,14.3000368497041,70.6999631502959
"1970","keep movin",2.49076663353093,56,12,44,7.66348194321348,48.3365180567865
"1970","sings",2.49076663353093,56,12,44,7.66348194321348,48.3365180567865
"2000","get tonight",2.48669463609071,42,16,26,11.3015988629234,30.6984011370766
"2000","goi",2.48669463609071,42,16,26,11.3015988629234,30.6984011370766
"1960","know love",2.48164012656335,318,26,292,18.9920009389339,299.007999061066
"1980","open",2.47958522909016,519,101,418,87.3143426470169,431.685657352983
"1980","among",2.47914674912038,19,6,13,3.19647882522798,15.803521174772
"1980","day love",2.47914674912038,19,6,13,3.19647882522798,15.803521174772
"1980","doll",2.47914674912038,19,6,13,3.19647882522798,15.803521174772
"1980","find oh",2.47914674912038,19,6,13,3.19647882522798,15.803521174772
"1980","give hand",2.47914674912038,19,6,13,3.19647882522798,15.803521174772
"1980","hands time",2.47914674912038,19,6,13,3.19647882522798,15.803521174772
"1980","just getting",2.47914674912038,19,6,13,3.19647882522798,15.803521174772
"1980","love found",2.47914674912038,19,6,13,3.19647882522798,15.803521174772
"1980","oh look",2.47914674912038,19,6,13,3.19647882522798,15.803521174772
"1980","ooh im",2.47914674912038,19,6,13,3.19647882522798,15.803521174772
"1980","open arms",2.47914674912038,19,6,13,3.19647882522798,15.803521174772
"1980","piano",2.47914674912038,19,6,13,3.19647882522798,15.803521174772
"1980","remembering",2.47914674912038,19,6,13,3.19647882522798,15.803521174772
"1980","right tonight",2.47914674912038,19,6,13,3.19647882522798,15.803521174772
"1980","shes fine",2.47914674912038,19,6,13,3.19647882522798,15.803521174772
"1980","thing cant",2.47914674912038,19,6,13,3.19647882522798,15.803521174772
"1980","time saw",2.47914674912038,19,6,13,3.19647882522798,15.803521174772
"1980","want money",2.47914674912038,19,6,13,3.19647882522798,15.803521174772
"1980","well will",2.47914674912038,19,6,13,3.19647882522798,15.803521174772
"1980","wont keep",2.47914674912038,19,6,13,3.19647882522798,15.803521174772
"1980","youi know",2.47914674912038,19,6,13,3.19647882522798,15.803521174772
"2010","arent",2.47861867332933,45,11,34,6.92832257903053,38.0716774209695
"2010","get next",2.47861867332933,45,11,34,6.92832257903053,38.0716774209695
"2010","shades",2.47861867332933,45,11,34,6.92832257903053,38.0716774209695
"1970","wind",2.47540948111121,348,58,290,47.6230663613981,300.376933638602
"1990","back bring",2.4740251065555,26,9,17,5.51576209416782,20.4842379058322
"1990","can buy",2.4740251065555,26,9,17,5.51576209416782,20.4842379058322
"1990","downi",2.4740251065555,26,9,17,5.51576209416782,20.4842379058322
"1990","gate",2.4740251065555,26,9,17,5.51576209416782,20.4842379058322
"1990","huh uh huh uh",2.4740251065555,26,9,17,5.51576209416782,20.4842379058322
"1990","killed",2.4740251065555,26,9,17,5.51576209416782,20.4842379058322
"1990","love everything",2.4740251065555,26,9,17,5.51576209416782,20.4842379058322
"1990","tag",2.4740251065555,26,9,17,5.51576209416782,20.4842379058322
"1990","upon time",2.4740251065555,26,9,17,5.51576209416782,20.4842379058322
"1990","without",2.47203398213217,1367,314,1053,290.00179933567,1076.99820066433
"2000","bucks",2.46993407414818,21,9,12,5.65079943146171,15.3492005685383
"2000","damn thing",2.46993407414818,21,9,12,5.65079943146171,15.3492005685383
"2000","drop top",2.46993407414818,21,9,12,5.65079943146171,15.3492005685383
"2000","grave",2.46993407414818,21,9,12,5.65079943146171,15.3492005685383
"2000","laughs",2.46993407414818,21,9,12,5.65079943146171,15.3492005685383
"2000","much need",2.46993407414818,21,9,12,5.65079943146171,15.3492005685383
"2000","remedy",2.46993407414818,21,9,12,5.65079943146171,15.3492005685383
"2000","show can",2.46993407414818,21,9,12,5.65079943146171,15.3492005685383
"2000","someone can",2.46993407414818,21,9,12,5.65079943146171,15.3492005685383
"2000","thing just",2.46993407414818,21,9,12,5.65079943146171,15.3492005685383
"2000","till get",2.46993407414818,21,9,12,5.65079943146171,15.3492005685383
"2000","way love way",2.46993407414818,21,9,12,5.65079943146171,15.3492005685383
"2000","wont find",2.46993407414818,21,9,12,5.65079943146171,15.3492005685383
"2010","boy really",2.46948036859538,35,9,26,5.38869533924597,29.611304660754
"2010","gang",2.46948036859538,35,9,26,5.38869533924597,29.611304660754
"2010","love deep",2.46948036859538,35,9,26,5.38869533924597,29.611304660754
"2010","mix",2.46948036859538,35,9,26,5.38869533924597,29.611304660754
"2010","tell world",2.46948036859538,35,9,26,5.38869533924597,29.611304660754
"2010","youll ever",2.46948036859538,35,9,26,5.38869533924597,29.611304660754
"2000","wont stop",2.46802717896072,90,31,59,24.2177118491216,65.7822881508784
"1970","around see",2.46784422074821,23,6,17,3.14750151239125,19.8524984876087
"1970","baby uh",2.46784422074821,23,6,17,3.14750151239125,19.8524984876087
"1970","better take",2.46784422074821,23,6,17,3.14750151239125,19.8524984876087
"1970","can im",2.46784422074821,23,6,17,3.14750151239125,19.8524984876087
"1970","dayi",2.46784422074821,23,6,17,3.14750151239125,19.8524984876087
"1970","got find",2.46784422074821,23,6,17,3.14750151239125,19.8524984876087
"1970","id like know",2.46784422074821,23,6,17,3.14750151239125,19.8524984876087
"1970","look see",2.46784422074821,23,6,17,3.14750151239125,19.8524984876087
"1970","love made",2.46784422074821,23,6,17,3.14750151239125,19.8524984876087
"1970","rendezvous",2.46784422074821,23,6,17,3.14750151239125,19.8524984876087
"1970","sends",2.46784422074821,23,6,17,3.14750151239125,19.8524984876087
"1970","sits",2.46784422074821,23,6,17,3.14750151239125,19.8524984876087
"1970","way see",2.46784422074821,23,6,17,3.14750151239125,19.8524984876087
"1970","ya im",2.46784422074821,23,6,17,3.14750151239125,19.8524984876087
"2010","fall apart",2.46559512093549,40,10,30,6.15850895913825,33.8414910408617
"2010","pressure",2.46559512093549,40,10,30,6.15850895913825,33.8414910408617
"2010","take long",2.46559512093549,40,10,30,6.15850895913825,33.8414910408617
"2010","wrong right",2.46559512093549,40,10,30,6.15850895913825,33.8414910408617
"2000","call baby",2.46453302389983,77,27,50,20.7195979153596,56.2804020846404
"1960","feet",2.46256899815807,347,28,319,20.7239758673273,326.276024132673
"1970","drinking",2.45553135960658,62,13,49,8.48456929427207,53.5154307057279
"1970","judge",2.45553135960658,62,13,49,8.48456929427207,53.5154307057279
"1970","love good",2.45553135960658,62,13,49,8.48456929427207,53.5154307057279
"1970","mountains",2.45553135960658,62,13,49,8.48456929427207,53.5154307057279
"1990","cant live",2.45398833101232,113,31,82,23.9723506400371,89.0276493599629
"1970","within",2.45222658424281,104,20,84,14.2321807516822,89.7678192483178
"1980","jump",2.45072187119906,404,80,324,67.9672339680055,336.032766031995
"1970","warm",2.45036390876865,237,41,196,32.4329503668142,204.567049633186
"2000","see get",2.44678850026948,61,22,39,16.4142269199602,44.5857730800398
"2010","flame",2.44663062286281,82,18,64,12.6249433662334,69.3750566337666
"1970","first time",2.44570059486389,135,25,110,18.4744653988182,116.525534601182
"2010","back",2.445176941656,3938,642,3296,606.305207027161,3331.69479297284
"2010","drop",2.44505919934742,417,76,341,64.2024558990163,352.797544100984
"2010","baby let",2.44471580774517,126,26,100,19.3993032212855,106.600696778715
"1980","mystery",2.44080616059537,51,13,38,8.58002210982247,42.4199778901775
"1980","youim",2.44080616059537,51,13,38,8.58002210982247,42.4199778901775
"2010","daddys",2.43820696538448,66,15,51,10.1615397825781,55.8384602174219
"1990","sun",2.43519797992644,675,160,515,143.197669752434,531.802330247566
"2000","youre still",2.43482629871107,100,34,66,26.9085687212462,73.0914312787538
"2000","closing",2.43461908796091,36,14,22,9.68708473964864,26.3129152603514
"2000","well well well",2.43461908796091,36,14,22,9.68708473964864,26.3129152603514
"1990","baby got",2.43361899426834,109,30,79,23.1237718563189,85.8762281436811
"1990","gotta gotta",2.43361899426834,109,30,79,23.1237718563189,85.8762281436811
"1970","seemed",2.43337093078286,68,14,54,9.30565664533066,58.6943433546693
"2000","baby dont wanna",2.43008470562269,24,10,14,6.45805649309909,17.5419435069009
"2000","bad yeah",2.43008470562269,24,10,14,6.45805649309909,17.5419435069009
"2000","call want",2.43008470562269,24,10,14,6.45805649309909,17.5419435069009
"2000","clue",2.43008470562269,24,10,14,6.45805649309909,17.5419435069009
"2000","far cause",2.43008470562269,24,10,14,6.45805649309909,17.5419435069009
"2000","huh know",2.43008470562269,24,10,14,6.45805649309909,17.5419435069009
"2000","husband",2.43008470562269,24,10,14,6.45805649309909,17.5419435069009
"2000","say look",2.43008470562269,24,10,14,6.45805649309909,17.5419435069009
"2000","shes mine",2.43008470562269,24,10,14,6.45805649309909,17.5419435069009
"2000","young lets",2.43008470562269,24,10,14,6.45805649309909,17.5419435069009
"2000","dress",2.42796274027999,150,49,101,40.3628530818693,109.637146918131
"2010","stronger",2.42769121278242,115,24,91,17.7057132575225,97.2942867424775
"1970","lying",2.42611139885179,92,18,74,12.590006049565,79.409993950435
"2010","stare",2.42466533443999,93,20,73,14.3185333299964,78.6814666700036
"1970","can",2.42463290872577,8122,1160,6962,1111.47857754964,7010.52142245036
"1960","baby let",2.42125017239315,126,12,114,7.52513244750212,118.474867552498
"1960","slowly",2.42125017239315,126,12,114,7.52513244750212,118.474867552498
"1990","always right",2.4212143278301,19,7,12,4.0307492226611,14.9692507773389
"1990","amazed",2.4212143278301,19,7,12,4.0307492226611,14.9692507773389
"1990","among",2.4212143278301,19,7,12,4.0307492226611,14.9692507773389
"1990","baby baby ooo baby",2.4212143278301,19,7,12,4.0307492226611,14.9692507773389
"1990","baby ooo baby",2.4212143278301,19,7,12,4.0307492226611,14.9692507773389
"1990","baby ooo baby baby",2.4212143278301,19,7,12,4.0307492226611,14.9692507773389
"1990","baby work",2.4212143278301,19,7,12,4.0307492226611,14.9692507773389
"1990","body now",2.4212143278301,19,7,12,4.0307492226611,14.9692507773389
"1990","body right",2.4212143278301,19,7,12,4.0307492226611,14.9692507773389
"1990","boy like",2.4212143278301,19,7,12,4.0307492226611,14.9692507773389
"1990","comfortable",2.4212143278301,19,7,12,4.0307492226611,14.9692507773389
"1990","dedicate",2.4212143278301,19,7,12,4.0307492226611,14.9692507773389
"1990","dont deny",2.4212143278301,19,7,12,4.0307492226611,14.9692507773389
"1990","give got",2.4212143278301,19,7,12,4.0307492226611,14.9692507773389
"1990","just reach",2.4212143278301,19,7,12,4.0307492226611,14.9692507773389
"1990","lay bed",2.4212143278301,19,7,12,4.0307492226611,14.9692507773389
"1990","make whole",2.4212143278301,19,7,12,4.0307492226611,14.9692507773389
"1990","oh oh baby",2.4212143278301,19,7,12,4.0307492226611,14.9692507773389
"1990","put arms around",2.4212143278301,19,7,12,4.0307492226611,14.9692507773389
"1990","remembering",2.4212143278301,19,7,12,4.0307492226611,14.9692507773389
"1990","suffer",2.4212143278301,19,7,12,4.0307492226611,14.9692507773389
"1990","swept",2.4212143278301,19,7,12,4.0307492226611,14.9692507773389
"1990","theres nobody",2.4212143278301,19,7,12,4.0307492226611,14.9692507773389
"1990","though youre",2.4212143278301,19,7,12,4.0307492226611,14.9692507773389
"1990","want money",2.4212143278301,19,7,12,4.0307492226611,14.9692507773389
"1990","yeah make",2.4212143278301,19,7,12,4.0307492226611,14.9692507773389
"1990","years old",2.4212143278301,19,7,12,4.0307492226611,14.9692507773389
"2010","baby lets",2.41995168003922,104,22,82,16.0121232937595,87.9878767062406
"2010","way make",2.41995168003922,104,22,82,16.0121232937595,87.9878767062406
"1960","break heart",2.41777541809236,113,11,102,6.74872989339476,106.251270106605
"2000","punk",2.41769765753166,33,13,20,8.87982767801125,24.1201723219887
"2000","wipe",2.41769765753166,33,13,20,8.87982767801125,24.1201723219887
"1970","love need",2.41766213976023,129,24,105,17.6533780477596,111.34662195224
"1960","adore",2.41705620506731,75,8,67,4.47924550446555,70.5207544955345
"1960","comfort",2.41705620506731,75,8,67,4.47924550446555,70.5207544955345
"1960","take look",2.41705620506731,75,8,67,4.47924550446555,70.5207544955345
"1970","california",2.41697677087027,80,16,64,10.9478313474478,69.0521686525522
"1970","movie",2.41697677087027,80,16,64,10.9478313474478,69.0521686525522
"1970","oh youre",2.41697677087027,80,16,64,10.9478313474478,69.0521686525522
"2000","ear",2.41602443943609,110,37,73,29.5994255933708,80.4005744066291
"1990","callin",2.41536879194375,134,36,98,28.4273892545572,105.572610745443
"1980","bless",2.41388499415783,37,10,27,6.22472192281238,30.7752780771876
"1980","come together",2.41388499415783,37,10,27,6.22472192281238,30.7752780771876
"1980","fish",2.41388499415783,37,10,27,6.22472192281238,30.7752780771876
"1960","come along",2.41322025100471,51,6,45,3.04588694303657,47.9541130569634
"1960","couldnt get",2.41322025100471,51,6,45,3.04588694303657,47.9541130569634
"1960","shower",2.41322025100471,51,6,45,3.04588694303657,47.9541130569634
"1960","spinnin",2.41322025100471,51,6,45,3.04588694303657,47.9541130569634
"1980","moment",2.41261592310998,410,81,329,68.9766483338669,341.023351666133
"2000","actin like",2.41199282386725,27,11,16,7.26531355473648,19.7346864452635
"2000","dudes",2.41199282386725,27,11,16,7.26531355473648,19.7346864452635
"2000","girl dont know",2.41199282386725,27,11,16,7.26531355473648,19.7346864452635
"2000","go now go",2.41199282386725,27,11,16,7.26531355473648,19.7346864452635
"2000","just stay",2.41199282386725,27,11,16,7.26531355473648,19.7346864452635
"2000","know came",2.41199282386725,27,11,16,7.26531355473648,19.7346864452635
"2000","love dont love",2.41199282386725,27,11,16,7.26531355473648,19.7346864452635
"2000","mrs",2.41199282386725,27,11,16,7.26531355473648,19.7346864452635
"2000","thats got",2.41199282386725,27,11,16,7.26531355473648,19.7346864452635
"2000","whats wrong",2.41199282386725,27,11,16,7.26531355473648,19.7346864452635
"2000","youre one want",2.41199282386725,27,11,16,7.26531355473648,19.7346864452635
"2000","falls",2.40953056477698,87,30,57,23.4104547874842,63.5895452125158
"2000","like never",2.40953056477698,87,30,57,23.4104547874842,63.5895452125158
"2000","cant turn",2.40923545595643,30,12,18,8.07257061637387,21.9274293836261
"2000","get hot",2.40923545595643,30,12,18,8.07257061637387,21.9274293836261
"2000","made cry",2.40923545595643,30,12,18,8.07257061637387,21.9274293836261
"2000","mississippi",2.40923545595643,30,12,18,8.07257061637387,21.9274293836261
"2000","rapper",2.40923545595643,30,12,18,8.07257061637387,21.9274293836261
"2000","whole world",2.4085246384979,130,43,87,34.9811393376201,95.0188606623799
"2000","never see",2.40847291072832,74,26,48,19.9123408537222,54.0876591462778
"2000","night long",2.40821939091685,242,76,166,65.1187363054159,176.881263694584
"2010","made",2.40614549486369,1068,183,885,164.432189208991,903.567810791009
"1970","love still",2.40565143719056,45,10,35,6.15815513293941,38.8418448670606
"1970","recall",2.40565143719056,45,10,35,6.15815513293941,38.8418448670606
"1970","whose",2.40565143719056,45,10,35,6.15815513293941,38.8418448670606
"1970","wise",2.40565143719056,45,10,35,6.15815513293941,38.8418448670606
"1960","wont let",2.40493675763069,221,19,202,13.1988434198251,207.801156580175
"1990","baby take",2.39814716057283,45,14,31,9.54651131682892,35.4534886831711
"1990","day every",2.39814716057283,45,14,31,9.54651131682892,35.4534886831711
"1990","guarantee",2.39814716057283,45,14,31,9.54651131682892,35.4534886831711
"1990","take another",2.39814716057283,45,14,31,9.54651131682892,35.4534886831711
"2000","just turn",2.39691527855893,58,21,37,15.6069698583228,42.3930301416772
"1960","brighter",2.39670324831177,63,7,56,3.76256622375106,59.2374337762489
"1990","love wont",2.39580350648161,101,28,73,21.4266142888827,79.5733857111173
"1960","look",2.39565059700727,1903,130,1773,113.653389266639,1789.34661073336
"1980","died",2.39518856483498,116,26,90,19.515344406655,96.484655593345
"2010","giving",2.39051443363422,235,45,190,36.1812401349372,198.818759865063
"1990","crowd",2.38984398054451,130,35,95,27.5788104708391,102.421189529161
"1990","cryin",2.38984398054451,130,35,95,27.5788104708391,102.421189529161
"1990","love now",2.38984398054451,130,35,95,27.5788104708391,102.421189529161
"1980","new york",2.38363036681381,168,36,132,28.2636022441211,139.736397755879
"1980","better let",2.38337750843772,28,8,20,4.71060037402018,23.2893996259798
"1980","give just one",2.38337750843772,28,8,20,4.71060037402018,23.2893996259798
"1980","ill wait",2.38337750843772,28,8,20,4.71060037402018,23.2893996259798
"1980","look look",2.38337750843772,28,8,20,4.71060037402018,23.2893996259798
"1980","love comes",2.38337750843772,28,8,20,4.71060037402018,23.2893996259798
"1980","love hard",2.38337750843772,28,8,20,4.71060037402018,23.2893996259798
"1980","make make make",2.38337750843772,28,8,20,4.71060037402018,23.2893996259798
"1980","see every",2.38337750843772,28,8,20,4.71060037402018,23.2893996259798
"1980","youre pretty",2.38337750843772,28,8,20,4.71060037402018,23.2893996259798
"1990","tryin",2.3752434845861,516,124,392,109.466663099638,406.533336900362
"2000","can call",2.37523877046366,97,33,64,26.1013116596088,70.8986883403912
"1970","evry",2.37427905870575,34,8,26,4.65282832266533,29.3471716773347
"1970","home baby",2.37427905870575,34,8,26,4.65282832266533,29.3471716773347
"1970","indian",2.37427905870575,34,8,26,4.65282832266533,29.3471716773347
"1970","lesson",2.37427905870575,34,8,26,4.65282832266533,29.3471716773347
"1970","now hold",2.37427905870575,34,8,26,4.65282832266533,29.3471716773347
"1970","old man",2.37427905870575,34,8,26,4.65282832266533,29.3471716773347
"1970","take baby",2.37427905870575,34,8,26,4.65282832266533,29.3471716773347
"1970","wearin",2.37427905870575,34,8,26,4.65282832266533,29.3471716773347
"1970","wrong dont",2.37427905870575,34,8,26,4.65282832266533,29.3471716773347
"1980","think",2.37150765850397,2640,474,2166,444.142320979046,2195.85767902095
"1980","just call",2.36854819229431,61,15,46,10.2623793862583,50.7376206137417
"1980","looks like",2.36854819229431,61,15,46,10.2623793862583,50.7376206137417
"1980","time life",2.36854819229431,61,15,46,10.2623793862583,50.7376206137417
"1990","just think",2.36421022460087,49,15,34,10.3950901005471,38.604909899453
"1970","waitin",2.36322168738841,142,26,116,19.4324006417199,122.56759935828
"1990","death",2.36270538017695,93,26,67,19.7294567214464,73.2705432785536
"1980","just dont",2.36038739339539,184,39,145,30.9553738864183,153.044626113582
"1990","believe true",2.35651729590223,30,10,20,6.36434087788595,23.6356591221141
"1990","cant turn",2.35651729590223,30,10,20,6.36434087788595,23.6356591221141
"1990","flat",2.35651729590223,30,10,20,6.36434087788595,23.6356591221141
"1990","get see",2.35651729590223,30,10,20,6.36434087788595,23.6356591221141
"1990","roll come",2.35651729590223,30,10,20,6.36434087788595,23.6356591221141
"1990","round go",2.35651729590223,30,10,20,6.36434087788595,23.6356591221141
"1990","youre leaving",2.35651729590223,30,10,20,6.36434087788595,23.6356591221141
"2000","friends",2.3536076167803,762,224,538,205.043293655896,556.956706344104
"2000","cmon",2.35320592473197,239,75,164,64.3114792437785,174.688520756222
"2000","baby cause",2.35115508526919,84,29,55,22.6031977258468,61.3968022741532
"2000","make make",2.35115508526919,84,29,55,22.6031977258468,61.3968022741532
"2010","favorite",2.34859883689782,99,21,78,15.2423096738672,83.7576903261328
"2010","two three",2.34859883689782,99,21,78,15.2423096738672,83.7576903261328
"2000","problem",2.34841373843202,127,42,85,34.1738822759827,92.8261177240173
"1990","im sure",2.34831383242147,89,25,64,18.8808779377283,70.1191220622717
"1970","take place",2.34646112538521,51,11,40,6.97924248399799,44.020757516002
"2010","scream",2.34360469256148,155,31,124,23.8642222166607,131.135777783339
"2010","back said",2.34097014055085,21,6,15,3.23321720354758,17.7667827964524
"2010","chance dont",2.34097014055085,21,6,15,3.23321720354758,17.7667827964524
"2010","come close",2.34097014055085,21,6,15,3.23321720354758,17.7667827964524
"2010","come take hand",2.34097014055085,21,6,15,3.23321720354758,17.7667827964524
"2010","ever ever ever",2.34097014055085,21,6,15,3.23321720354758,17.7667827964524
"2010","freakin",2.34097014055085,21,6,15,3.23321720354758,17.7667827964524
"2010","go wont",2.34097014055085,21,6,15,3.23321720354758,17.7667827964524
"2010","halfway",2.34097014055085,21,6,15,3.23321720354758,17.7667827964524
"2010","laid back",2.34097014055085,21,6,15,3.23321720354758,17.7667827964524
"2010","like every",2.34097014055085,21,6,15,3.23321720354758,17.7667827964524
"2010","model",2.34097014055085,21,6,15,3.23321720354758,17.7667827964524
"2010","music just",2.34097014055085,21,6,15,3.23321720354758,17.7667827964524
"2010","oh oh oh yeah",2.34097014055085,21,6,15,3.23321720354758,17.7667827964524
"2010","ooh thats",2.34097014055085,21,6,15,3.23321720354758,17.7667827964524
"2010","rage",2.34097014055085,21,6,15,3.23321720354758,17.7667827964524
"2010","swear im",2.34097014055085,21,6,15,3.23321720354758,17.7667827964524
"1990","heart dont",2.34001794317945,53,16,37,11.2436688842652,41.7563311157348
"1960","nothing can",2.3370559925195,114,11,103,6.80845316678763,107.191546833212
"2010","fell",2.33500612667235,224,43,181,34.4876501711742,189.512349828826
"1990","knock",2.33287156845395,164,43,121,34.7917301324432,129.208269867557
"1980","learning",2.33000057260799,42,11,31,7.06590056103027,34.9340994389697
"1980","toe",2.33000057260799,42,11,31,7.06590056103027,34.9340994389697
"1980","ill make",2.32791397598964,158,34,124,26.5812449676853,131.418755032315
"1990","never leave",2.32488503072131,81,23,58,17.1837203702921,63.8162796297079
"2010","spot",2.32298934416159,178,35,143,27.4053648681652,150.594635131835
"2010","cool",2.32287051466851,389,71,318,59.8914996276195,329.10850037238
"1980","know know know",2.32267059542151,132,29,103,22.2071160489523,109.792883951048
"1970","means",2.32250467474251,155,28,127,21.2114232356802,133.78857676432
"2010","clock",2.32122778208848,72,16,56,11.0853161264489,60.9146838735512
"1990","night day",2.31638988951951,77,22,55,16.3351415865739,60.6648584134261
"1990","although",2.31341473688655,61,18,43,12.9408264517014,48.0591735482986
"1990","butt",2.31049884095452,73,21,52,15.4865628028558,57.5134371971442
"1980","set",2.3099873759401,395,78,317,66.4531124192133,328.546887580787
"1990","let take",2.30839593089259,65,19,46,13.7894052354196,51.2105947645804
"1990","stage",2.30839593089259,65,19,46,13.7894052354196,51.2105947645804
"1970","just cant stop",2.30757645389737,57,12,45,7.80032983505658,49.1996701649434
"2010","next",2.30653042064795,491,88,403,75.595697473422,415.404302526578
"2010","didnt know",2.30604088305399,144,29,115,22.1706322528977,121.829367747102
"1990","know like",2.30311794572684,160,42,118,33.9431513487251,126.056848651275
"1970","cryin",2.30204846194517,130,24,106,17.7902259396027,112.209774060397
"1980","girl like",2.30028345662906,127,28,99,21.3659374107344,105.634062589266
"2000","baby baby baby",2.29846287517838,267,83,184,71.8458784857274,195.154121514273
"2000","playin",2.29734394581793,212,67,145,57.046165689042,154.953834310958
"1990","door",2.29588315171781,597,142,455,126.65038346993,470.34961653007
"2010","bags",2.29539263680382,51,12,39,7.85209892290127,43.1479010770987
"2010","just come",2.29539263680382,51,12,39,7.85209892290127,43.1479010770987
"2010","shower",2.29539263680382,51,12,39,7.85209892290127,43.1479010770987
"1960","go back",2.29176325400884,141,13,128,8.42098154839523,132.579018451605
"1960","since",2.28811104869031,497,38,459,29.6824668762583,467.317533123742
"1960","cares",2.28626138847837,64,7,57,3.82228949714393,60.1777105028561
"1970","chevy",2.28345960448468,63,13,50,8.62141718611517,54.3785828138848
"1980","fantasy",2.27885785102097,122,27,95,20.5247587725165,101.475241227483
"2010","finger",2.27769109844772,94,20,74,14.4724960539749,79.5275039460251
"1990","acting like",2.27290005387879,34,11,23,7.21291966160408,26.7870803383959
"1990","blaze",2.27290005387879,34,11,23,7.21291966160408,26.7870803383959
"1990","break dawn",2.27290005387879,34,11,23,7.21291966160408,26.7870803383959
"1990","oh ill",2.27290005387879,34,11,23,7.21291966160408,26.7870803383959
"1990","say yes",2.27290005387879,34,11,23,7.21291966160408,26.7870803383959
"1990","shock",2.27290005387879,34,11,23,7.21291966160408,26.7870803383959
"1990","wolf",2.27290005387879,34,11,23,7.21291966160408,26.7870803383959
"1980","joy",2.27133475609486,169,36,133,28.4318379717647,140.568162028235
"1970","get now",2.27101680983431,40,9,31,5.47391567372392,34.5260843262761
"1970","take care",2.27101680983431,40,9,31,5.47391567372392,34.5260843262761
"1970","youif",2.27101680983431,40,9,31,5.47391567372392,34.5260843262761
"1970","im goin",2.2704232435884,69,14,55,9.44250453717376,59.5574954628262
"1980","baby shes",2.27002309024513,47,12,35,7.90707919924816,39.0929208007518
"1980","endless",2.27002309024513,47,12,35,7.90707919924816,39.0929208007518
"1980","life im",2.27002309024513,47,12,35,7.90707919924816,39.0929208007518
"1980","tick",2.27002309024513,47,12,35,7.90707919924816,39.0929208007518
"1990","ends",2.26923116815136,135,36,99,28.6395339504868,106.360466049513
"1970","shes just",2.2650767003738,29,7,22,3.96858886344984,25.0314111365502
"1970","sunset",2.2650767003738,29,7,22,3.96858886344984,25.0314111365502
"1970","tell really",2.2650767003738,29,7,22,3.96858886344984,25.0314111365502
"1970","wore",2.2650767003738,29,7,22,3.96858886344984,25.0314111365502
"2010","see got",2.25946662373216,46,11,35,7.08228530300899,38.917714696991
"2010","always one",2.25832056586854,26,7,19,4.00303082343986,21.9969691765601
"2010","argue",2.25832056586854,26,7,19,4.00303082343986,21.9969691765601
"2010","just something",2.25832056586854,26,7,19,4.00303082343986,21.9969691765601
"2010","keep dancing",2.25832056586854,26,7,19,4.00303082343986,21.9969691765601
"2010","mark",2.25832056586854,26,7,19,4.00303082343986,21.9969691765601
"2010","never say",2.25832056586854,26,7,19,4.00303082343986,21.9969691765601
"2010","photo",2.25832056586854,26,7,19,4.00303082343986,21.9969691765601
"2010","walked away",2.25832056586854,26,7,19,4.00303082343986,21.9969691765601
"2000","fly away",2.25618482866282,91,31,60,24.4867975363341,66.5132024636659
"1960","changed",2.25290402798692,155,14,141,9.25710737589546,145.742892624105
"1980","keep us",2.25202958422973,33,9,24,5.55177901223807,27.4482209877619
"1980","remain",2.25202958422973,33,9,24,5.55177901223807,27.4482209877619
"2010","win",2.24766116031243,196,38,158,30.1766938997774,165.823306100223
"1990","look eyes",2.24410787303619,152,40,112,32.2459937812888,119.754006218711
"2000","nice",2.24358430878779,233,73,160,62.6969651205037,170.303034879496
"1980","disagree",2.2418708837448,24,7,17,4.03765746344587,19.9623425365541
"1980","disease",2.2418708837448,24,7,17,4.03765746344587,19.9623425365541
"1980","forever oh",2.2418708837448,24,7,17,4.03765746344587,19.9623425365541
"1980","forty",2.2418708837448,24,7,17,4.03765746344587,19.9623425365541
"1980","like used",2.2418708837448,24,7,17,4.03765746344587,19.9623425365541
"1980","love makes",2.2418708837448,24,7,17,4.03765746344587,19.9623425365541
"1980","love sweet love",2.2418708837448,24,7,17,4.03765746344587,19.9623425365541
"1980","mind time",2.2418708837448,24,7,17,4.03765746344587,19.9623425365541
"1980","onand",2.2418708837448,24,7,17,4.03765746344587,19.9623425365541
"1980","preacher",2.2418708837448,24,7,17,4.03765746344587,19.9623425365541
"1980","pretty girl",2.2418708837448,24,7,17,4.03765746344587,19.9623425365541
"1980","rushing",2.2418708837448,24,7,17,4.03765746344587,19.9623425365541
"1980","say look",2.2418708837448,24,7,17,4.03765746344587,19.9623425365541
"1980","stay together",2.2418708837448,24,7,17,4.03765746344587,19.9623425365541
"1980","wayi",2.2418708837448,24,7,17,4.03765746344587,19.9623425365541
"1990","baby dont want",2.24084902155296,23,8,15,4.87932800637923,18.1206719936208
"1990","bout baby",2.24084902155296,23,8,15,4.87932800637923,18.1206719936208
"1990","caused",2.24084902155296,23,8,15,4.87932800637923,18.1206719936208
"1990","every breath",2.24084902155296,23,8,15,4.87932800637923,18.1206719936208
"1990","feel baby",2.24084902155296,23,8,15,4.87932800637923,18.1206719936208
"1990","fills",2.24084902155296,23,8,15,4.87932800637923,18.1206719936208
"1990","get mad",2.24084902155296,23,8,15,4.87932800637923,18.1206719936208
"1990","keep head",2.24084902155296,23,8,15,4.87932800637923,18.1206719936208
"1990","know life",2.24084902155296,23,8,15,4.87932800637923,18.1206719936208
"1990","lace",2.24084902155296,23,8,15,4.87932800637923,18.1206719936208
"1990","make understand",2.24084902155296,23,8,15,4.87932800637923,18.1206719936208
"1990","need get",2.24084902155296,23,8,15,4.87932800637923,18.1206719936208
"1990","pain im",2.24084902155296,23,8,15,4.87932800637923,18.1206719936208
"1990","say dont know",2.24084902155296,23,8,15,4.87932800637923,18.1206719936208
"1990","sipping",2.24084902155296,23,8,15,4.87932800637923,18.1206719936208
"1990","sweet like",2.24084902155296,23,8,15,4.87932800637923,18.1206719936208
"1990","time never",2.24084902155296,23,8,15,4.87932800637923,18.1206719936208
"1990","times im",2.24084902155296,23,8,15,4.87932800637923,18.1206719936208
"2010","life",2.24074913073821,2901,476,2425,446.645862261502,2454.3541377385
"1980","telling",2.23669299406555,260,53,207,43.7412891873303,216.25871081267
"2000","corner",2.23596787105834,131,43,88,35.2502250248326,95.7497749751674
"2000","chase",2.23482311140139,78,27,51,20.9886836025721,57.0113163974279
"1990","mei",2.23439443752112,169,44,125,35.8524536120908,133.147546387909
"2010","baby go",2.2327894763577,41,10,31,6.31247168311671,34.6875283168833
"2010","blew",2.2327894763577,41,10,31,6.31247168311671,34.6875283168833
"2010","see cry",2.2327894763577,41,10,31,6.31247168311671,34.6875283168833
"2010","youve never",2.2327894763577,41,10,31,6.31247168311671,34.6875283168833
"2000","wonderful",2.22747369952541,111,37,74,29.8685112805833,81.1314887194167
"1980","heart just",2.22734663451554,52,13,39,8.74825783746605,43.251742162534
"1980","wrapped",2.22734663451554,52,13,39,8.74825783746605,43.251742162534
"2010","lets go",2.22626121844422,202,39,163,31.1004702436482,170.899529756352
"2010","add",2.2241335561805,31,8,23,4.77284444333215,26.2271555566679
"2010","around around",2.2241335561805,31,8,23,4.77284444333215,26.2271555566679
"2010","chair",2.2241335561805,31,8,23,4.77284444333215,26.2271555566679
"2010","freaks",2.2241335561805,31,8,23,4.77284444333215,26.2271555566679
"2010","home tonight",2.2241335561805,31,8,23,4.77284444333215,26.2271555566679
"2010","tape",2.2241335561805,31,8,23,4.77284444333215,26.2271555566679
"1980","need love",2.22310315745909,180,38,142,30.282430975844,149.717569024156
"2010","love ever",2.21903560884193,36,9,27,5.54265806322443,30.4573419367756
"1980","hide",2.21533588847783,358,71,287,60.2283904964009,297.771609503599
"2010","gonna",2.21309871955883,4550,737,3813,700.530394101976,3849.46960589802
"1990","chances",2.21283562617821,38,12,26,8.0614984453222,29.9385015546778
"1990","guess thats",2.21283562617821,38,12,26,8.0614984453222,29.9385015546778
"1990","need love need",2.21283562617821,38,12,26,8.0614984453222,29.9385015546778
"1990","please come",2.21283562617821,38,12,26,8.0614984453222,29.9385015546778
"1990","spend life",2.21283562617821,38,12,26,8.0614984453222,29.9385015546778
"1990","think need",2.21283562617821,38,12,26,8.0614984453222,29.9385015546778
"2000","oh baby baby",2.21069193542555,46,17,29,12.3779416117733,33.6220583882267
"1990","straight",2.20777208496137,255,64,191,54.0968974620306,200.903102537969
"1990","make move",2.20698767624884,98,27,71,20.7901802010941,77.2098197989059
"1960","wear",2.20598542369625,183,16,167,10.9293590308959,172.070640969104
"1990","anger",2.20463349405392,16,6,10,3.39431513487251,12.6056848651275
"1990","bout im",2.20463349405392,16,6,10,3.39431513487251,12.6056848651275
"1990","boy girl",2.20463349405392,16,6,10,3.39431513487251,12.6056848651275
"1990","cant cant cant cant",2.20463349405392,16,6,10,3.39431513487251,12.6056848651275
"1990","carries",2.20463349405392,16,6,10,3.39431513487251,12.6056848651275
"1990","dont shy",2.20463349405392,16,6,10,3.39431513487251,12.6056848651275
"1990","every hour",2.20463349405392,16,6,10,3.39431513487251,12.6056848651275
"1990","everything ill",2.20463349405392,16,6,10,3.39431513487251,12.6056848651275
"1990","eyes will",2.20463349405392,16,6,10,3.39431513487251,12.6056848651275
"1990","gave away",2.20463349405392,16,6,10,3.39431513487251,12.6056848651275
"1990","get paid",2.20463349405392,16,6,10,3.39431513487251,12.6056848651275
"1990","getting better",2.20463349405392,16,6,10,3.39431513487251,12.6056848651275
"1990","girl ya",2.20463349405392,16,6,10,3.39431513487251,12.6056848651275
"1990","ha yeah",2.20463349405392,16,6,10,3.39431513487251,12.6056848651275
"1990","hand cause",2.20463349405392,16,6,10,3.39431513487251,12.6056848651275
"1990","heart hope",2.20463349405392,16,6,10,3.39431513487251,12.6056848651275
"1990","like like yeah",2.20463349405392,16,6,10,3.39431513487251,12.6056848651275
"1990","matter youre",2.20463349405392,16,6,10,3.39431513487251,12.6056848651275
"1990","pray god",2.20463349405392,16,6,10,3.39431513487251,12.6056848651275
"1990","right beside",2.20463349405392,16,6,10,3.39431513487251,12.6056848651275
"1990","see shes",2.20463349405392,16,6,10,3.39431513487251,12.6056848651275
"1990","sleepless",2.20463349405392,16,6,10,3.39431513487251,12.6056848651275
"1990","stores",2.20463349405392,16,6,10,3.39431513487251,12.6056848651275
"1990","swallow pride",2.20463349405392,16,6,10,3.39431513487251,12.6056848651275
"1990","tell oh",2.20463349405392,16,6,10,3.39431513487251,12.6056848651275
"1990","time wanna",2.20463349405392,16,6,10,3.39431513487251,12.6056848651275
"1990","turn back time",2.20463349405392,16,6,10,3.39431513487251,12.6056848651275
"1990","want lose",2.20463349405392,16,6,10,3.39431513487251,12.6056848651275
"1990","warmth",2.20463349405392,16,6,10,3.39431513487251,12.6056848651275
"1990","watch fall",2.20463349405392,16,6,10,3.39431513487251,12.6056848651275
"1990","well walk",2.20463349405392,16,6,10,3.39431513487251,12.6056848651275
"2010","gonna stop",2.20391020367451,62,14,48,9.54568888666429,52.4543111133357
"2010","tip",2.20391020367451,62,14,48,9.54568888666429,52.4543111133357
"1960","walkin",2.19763124979262,129,12,117,7.70430226768074,121.295697732319
"2000","advantage",2.19630398067917,13,6,7,3.49811393376201,9.50188606623799
"2000","aint tryin",2.19630398067917,13,6,7,3.49811393376201,9.50188606623799
"2000","alright ill",2.19630398067917,13,6,7,3.49811393376201,9.50188606623799
"2000","back ooh",2.19630398067917,13,6,7,3.49811393376201,9.50188606623799
"2000","better can",2.19630398067917,13,6,7,3.49811393376201,9.50188606623799
"2000","bit harder",2.19630398067917,13,6,7,3.49811393376201,9.50188606623799
"2000","blocks",2.19630398067917,13,6,7,3.49811393376201,9.50188606623799
"2000","boy youll",2.19630398067917,13,6,7,3.49811393376201,9.50188606623799
"2000","bumper",2.19630398067917,13,6,7,3.49811393376201,9.50188606623799
"2000","care people",2.19630398067917,13,6,7,3.49811393376201,9.50188606623799
"2000","chronic",2.19630398067917,13,6,7,3.49811393376201,9.50188606623799
"2000","closin",2.19630398067917,13,6,7,3.49811393376201,9.50188606623799
"2000","deep know",2.19630398067917,13,6,7,3.49811393376201,9.50188606623799
"2000","dont scared",2.19630398067917,13,6,7,3.49811393376201,9.50188606623799
"2000","even know name",2.19630398067917,13,6,7,3.49811393376201,9.50188606623799
"2000","full moon",2.19630398067917,13,6,7,3.49811393376201,9.50188606623799
"2000","go still",2.19630398067917,13,6,7,3.49811393376201,9.50188606623799
"2000","going youre",2.19630398067917,13,6,7,3.49811393376201,9.50188606623799
"2000","gravity",2.19630398067917,13,6,7,3.49811393376201,9.50188606623799
"2000","id rather stay",2.19630398067917,13,6,7,3.49811393376201,9.50188606623799
"2000","james dean",2.19630398067917,13,6,7,3.49811393376201,9.50188606623799
"2000","just lose",2.19630398067917,13,6,7,3.49811393376201,9.50188606623799
"2000","late last",2.19630398067917,13,6,7,3.49811393376201,9.50188606623799
"2000","lets forget",2.19630398067917,13,6,7,3.49811393376201,9.50188606623799
"2000","like like got",2.19630398067917,13,6,7,3.49811393376201,9.50188606623799
"2000","long will",2.19630398067917,13,6,7,3.49811393376201,9.50188606623799
"2000","mean dont",2.19630398067917,13,6,7,3.49811393376201,9.50188606623799
"2000","night im gonna",2.19630398067917,13,6,7,3.49811393376201,9.50188606623799
"2000","night lets",2.19630398067917,13,6,7,3.49811393376201,9.50188606623799
"2000","now back",2.19630398067917,13,6,7,3.49811393376201,9.50188606623799
"2000","now found",2.19630398067917,13,6,7,3.49811393376201,9.50188606623799
"2000","one give",2.19630398067917,13,6,7,3.49811393376201,9.50188606623799
"2000","pat",2.19630398067917,13,6,7,3.49811393376201,9.50188606623799
"2000","place im",2.19630398067917,13,6,7,3.49811393376201,9.50188606623799
"2000","please come back",2.19630398067917,13,6,7,3.49811393376201,9.50188606623799
"2000","please im",2.19630398067917,13,6,7,3.49811393376201,9.50188606623799
"2000","practice",2.19630398067917,13,6,7,3.49811393376201,9.50188606623799
"2000","purse",2.19630398067917,13,6,7,3.49811393376201,9.50188606623799
"2000","rat",2.19630398067917,13,6,7,3.49811393376201,9.50188606623799
"2000","rather stay",2.19630398067917,13,6,7,3.49811393376201,9.50188606623799
"2000","scheme",2.19630398067917,13,6,7,3.49811393376201,9.50188606623799
"2000","see coming",2.19630398067917,13,6,7,3.49811393376201,9.50188606623799
"2000","see id",2.19630398067917,13,6,7,3.49811393376201,9.50188606623799
"2000","see make",2.19630398067917,13,6,7,3.49811393376201,9.50188606623799
"2000","selfish",2.19630398067917,13,6,7,3.49811393376201,9.50188606623799
"2000","swear youre",2.19630398067917,13,6,7,3.49811393376201,9.50188606623799
"2000","sweet memories",2.19630398067917,13,6,7,3.49811393376201,9.50188606623799
"2000","tooth",2.19630398067917,13,6,7,3.49811393376201,9.50188606623799
"2000","try can",2.19630398067917,13,6,7,3.49811393376201,9.50188606623799
"2000","uno",2.19630398067917,13,6,7,3.49811393376201,9.50188606623799
"2000","wanna mess",2.19630398067917,13,6,7,3.49811393376201,9.50188606623799
"2000","world come",2.19630398067917,13,6,7,3.49811393376201,9.50188606623799
"2000","yeahi dont",2.19630398067917,13,6,7,3.49811393376201,9.50188606623799
"2000","youre away",2.19630398067917,13,6,7,3.49811393376201,9.50188606623799
"2000","youre loving",2.19630398067917,13,6,7,3.49811393376201,9.50188606623799
"1970","corner",2.18991822143126,131,24,107,17.9270738314458,113.072926168554
"1990","dont love",2.18791060600555,94,26,68,19.941601417376,74.058398582624
"1960","afraid",2.18697357872103,239,20,219,14.2738623408969,224.726137659103
"1960","go oh",2.18579894770811,90,9,81,5.37509460535865,84.6249053946413
"1960","way move",2.18579894770811,90,9,81,5.37509460535865,84.6249053946413
"1970","street",2.18442960604735,339,56,283,46.3914353348102,292.60856466519
"1970","ooh baby",2.18418706282577,150,27,123,20.5271837764647,129.472816223535
"1960","race",2.17965777639896,65,7,58,3.88201277053681,61.1179872294632
"1980","got right",2.17777436919599,62,15,47,10.4306151139018,51.5693848860982
"1980","let hold",2.17777436919599,62,15,47,10.4306151139018,51.5693848860982
"2000","search",2.17689993272666,75,26,49,20.1814265409347,54.8185734590653
"1970","last",2.17290220586924,827,128,699,113.173206554242,713.826793445758
"1970","appear",2.17245257978494,24,6,18,3.28434940423435,20.7156505957656
"1970","flag",2.17245257978494,24,6,18,3.28434940423435,20.7156505957656
"1970","fourth",2.17245257978494,24,6,18,3.28434940423435,20.7156505957656
"1970","friends say",2.17245257978494,24,6,18,3.28434940423435,20.7156505957656
"1970","girl gonna",2.17245257978494,24,6,18,3.28434940423435,20.7156505957656
"1970","got soul",2.17245257978494,24,6,18,3.28434940423435,20.7156505957656
"1970","ill never leave",2.17245257978494,24,6,18,3.28434940423435,20.7156505957656
"1970","long going",2.17245257978494,24,6,18,3.28434940423435,20.7156505957656
"1970","love last",2.17245257978494,24,6,18,3.28434940423435,20.7156505957656
"1970","love makes",2.17245257978494,24,6,18,3.28434940423435,20.7156505957656
"1970","love sweet love",2.17245257978494,24,6,18,3.28434940423435,20.7156505957656
"1970","say remember",2.17245257978494,24,6,18,3.28434940423435,20.7156505957656
"1970","sayi",2.17245257978494,24,6,18,3.28434940423435,20.7156505957656
"1970","something just",2.17245257978494,24,6,18,3.28434940423435,20.7156505957656
"1970","stormy",2.17245257978494,24,6,18,3.28434940423435,20.7156505957656
"1970","turn head",2.17245257978494,24,6,18,3.28434940423435,20.7156505957656
"1970","youre cold",2.17245257978494,24,6,18,3.28434940423435,20.7156505957656
"1990","night oh",2.17003906221212,90,25,65,19.0930226336578,70.9069773663421
"1990","wishing",2.17003906221212,90,25,65,19.0930226336578,70.9069773663421
"1990","holler",2.16981609064872,42,13,29,8.91007722904033,33.0899227709597
"1990","man got",2.16981609064872,42,13,29,8.91007722904033,33.0899227709597
"1990","wanna touch",2.16981609064872,42,13,29,8.91007722904033,33.0899227709597
"1960","chasing",2.16906666191672,53,6,47,3.16533348982232,49.8346665101777
"1960","decide",2.16906666191672,53,6,47,3.16533348982232,49.8346665101777
"1960","need somebody",2.16906666191672,53,6,47,3.16533348982232,49.8346665101777
"2000","boy know",2.16882149990789,43,16,27,11.5706845501359,31.4293154498641
"2000","dre",2.16882149990789,43,16,27,11.5706845501359,31.4293154498641
"2000","get em",2.16882149990789,43,16,27,11.5706845501359,31.4293154498641
"2000","weight",2.16882149990789,43,16,27,11.5706845501359,31.4293154498641
"2000","takin",2.16810886881856,118,39,79,31.7521110910705,86.2478889089295
"2000","quick",2.16727170764633,108,36,72,29.0612542189459,78.9387457810541
"2000","turnin",2.16727170764633,108,36,72,29.0612542189459,78.9387457810541
"2000","bar",2.16646281886309,172,55,117,46.2827382005435,125.717261799456
"1980","youre alone",2.16572809519227,67,16,51,11.2717937521197,55.7282062478803
"1960","song",2.16282960033747,816,59,757,48.7341910885851,767.265808911415
"1980","away just",2.16193660580305,38,10,28,6.39295765045596,31.607042349544
"1980","awayi",2.16193660580305,38,10,28,6.39295765045596,31.607042349544
"1980","dont want go",2.16193660580305,38,10,28,6.39295765045596,31.607042349544
"1980","know really wanna",2.16193660580305,38,10,28,6.39295765045596,31.607042349544
"1980","try tell",2.16193660580305,38,10,28,6.39295765045596,31.607042349544
"1970","life just",2.16021076808298,52,11,41,7.11609037584109,44.8839096241589
"1970","shoulders",2.16021076808298,52,11,41,7.11609037584109,44.8839096241589
"1990","feet",2.15757190465359,347,85,262,73.6142094875475,273.385790512453
"2010","butt",2.15690940124819,73,16,57,11.2392788504273,61.7607211495727
"2010","missed",2.15690940124819,73,16,57,11.2392788504273,61.7607211495727
"1970","lines",2.15428183171302,94,18,76,12.8637018332512,81.1362981667488
"1970","wherever",2.15428183171302,94,18,76,12.8637018332512,81.1362981667488
"1990","change",2.15153917725893,823,192,631,174.595084750005,648.404915249995
"2010","gotta",2.149736435538,1926,320,1606,296.532206382507,1629.46779361749
"2010","hold back",2.14957383179447,57,13,44,8.77587526677201,48.224124733228
"1980","mind",2.14544574495824,1930,349,1581,324.694954352105,1605.30504564789
"1970","love deep",2.14092991210911,35,8,27,4.78967621450843,30.2103237854916
"1970","stay dont",2.14092991210911,35,8,27,4.78967621450843,30.2103237854916
"1970","tell world",2.14092991210911,35,8,27,4.78967621450843,30.2103237854916
"1970","time like",2.14092991210911,35,8,27,4.78967621450843,30.2103237854916
"1990","blown",2.13953552453091,46,14,32,9.75865601275846,36.2413439872415
"1990","love take",2.13953552453091,46,14,32,9.75865601275846,36.2413439872415
"1990","meand",2.13953552453091,46,14,32,9.75865601275846,36.2413439872415
"1990","needing",2.13953552453091,46,14,32,9.75865601275846,36.2413439872415
"1970","dont take",2.13795280009532,88,17,71,12.0426144821926,75.9573855178074
"2010","watchin",2.13752368139545,84,18,66,12.9328688141903,71.0671311858097
"2000","want say",2.1373207649009,85,29,56,22.8722834130593,62.1277165869407
"2010","lucky",2.13646771504595,95,20,75,14.6264587779533,80.3735412220467
"2010","none",2.13646771504595,95,20,75,14.6264587779533,80.3735412220467
"1970","gives",2.13374485796607,58,12,46,7.93717772689968,50.0628222731003
"1970","now come",2.13374485796607,58,12,46,7.93717772689968,50.0628222731003
"1970","without baby",2.13374485796607,58,12,46,7.93717772689968,50.0628222731003
"1980","turning",2.13216824633435,165,35,130,27.7588950611904,137.24110493881
"2000","can baby",2.12965551936098,40,15,25,10.7634274884985,29.2365725115015
"2000","cause ill",2.12965551936098,40,15,25,10.7634274884985,29.2365725115015
"2000","grip",2.12965551936098,40,15,25,10.7634274884985,29.2365725115015
"2000","wrong right",2.12965551936098,40,15,25,10.7634274884985,29.2365725115015
"1970","ive ever",2.12533043809728,82,16,66,11.221527131134,70.778472868866
"1970","woah",2.12533043809728,82,16,66,11.221527131134,70.778472868866
"1990","whatever",2.12518862392617,343,84,259,72.7656307038293,270.234369296171
"1990","away yeah",2.12086556631201,27,9,18,5.72790679009735,21.2720932099026
"1990","im gettin",2.12086556631201,27,9,18,5.72790679009735,21.2720932099026
"1990","make heart",2.12086556631201,27,9,18,5.72790679009735,21.2720932099026
"1990","oh ive",2.12086556631201,27,9,18,5.72790679009735,21.2720932099026
"1990","ooh girl",2.12086556631201,27,9,18,5.72790679009735,21.2720932099026
"1990","world see",2.12086556631201,27,9,18,5.72790679009735,21.2720932099026
"1970","cares",2.11964315149306,64,13,51,8.75826507795827,55.2417349220417
"1970","dont even know",2.11964315149306,64,13,51,8.75826507795827,55.2417349220417
"1970","feelin like",2.11964315149306,64,13,51,8.75826507795827,55.2417349220417
"1970","got got got",2.11964315149306,64,13,51,8.75826507795827,55.2417349220417
"1990","heart im",2.1190291875103,50,15,35,10.6072347964766,39.3927652035234
"1990","misery",2.1190291875103,50,15,35,10.6072347964766,39.3927652035234
"2000","baby come",2.11630059850809,125,41,84,33.6357109015578,91.3642890984422
"1970","god",2.11581526756477,501,80,421,68.5607938133921,432.439206186608
"1970","book",2.11485467451148,70,14,56,9.57935242901686,60.4206475709831
"1970","hoping",2.11485467451148,70,14,56,9.57935242901686,60.4206475709831
"1970","hours",2.11485467451148,70,14,56,9.57935242901686,60.4206475709831
"2010","second",2.11475252762366,244,46,198,37.5669046507433,206.433095349257
"1980","boy oh",2.11187136011306,20,6,14,3.36471455287156,16.6352854471284
"1980","chew",2.11187136011306,20,6,14,3.36471455287156,16.6352854471284
"1980","didnt love",2.11187136011306,20,6,14,3.36471455287156,16.6352854471284
"1980","dont break",2.11187136011306,20,6,14,3.36471455287156,16.6352854471284
"1980","dont care dont",2.11187136011306,20,6,14,3.36471455287156,16.6352854471284
"1980","ever find",2.11187136011306,20,6,14,3.36471455287156,16.6352854471284
"1980","find time",2.11187136011306,20,6,14,3.36471455287156,16.6352854471284
"1980","home dont",2.11187136011306,20,6,14,3.36471455287156,16.6352854471284
"1980","hunt",2.11187136011306,20,6,14,3.36471455287156,16.6352854471284
"1980","like told",2.11187136011306,20,6,14,3.36471455287156,16.6352854471284
"1980","lotta",2.11187136011306,20,6,14,3.36471455287156,16.6352854471284
"1980","love blind",2.11187136011306,20,6,14,3.36471455287156,16.6352854471284
"1980","magazine",2.11187136011306,20,6,14,3.36471455287156,16.6352854471284
"1980","meyoure",2.11187136011306,20,6,14,3.36471455287156,16.6352854471284
"1980","need somebody lean",2.11187136011306,20,6,14,3.36471455287156,16.6352854471284
"1980","ooh like",2.11187136011306,20,6,14,3.36471455287156,16.6352854471284
"1980","reminds",2.11187136011306,20,6,14,3.36471455287156,16.6352854471284
"1980","righti",2.11187136011306,20,6,14,3.36471455287156,16.6352854471284
"1980","said baby",2.11187136011306,20,6,14,3.36471455287156,16.6352854471284
"1980","seem like",2.11187136011306,20,6,14,3.36471455287156,16.6352854471284
"1980","somebody lean",2.11187136011306,20,6,14,3.36471455287156,16.6352854471284
"1980","stay ill",2.11187136011306,20,6,14,3.36471455287156,16.6352854471284
"1980","theres always",2.11187136011306,20,6,14,3.36471455287156,16.6352854471284
"1980","think every",2.11187136011306,20,6,14,3.36471455287156,16.6352854471284
"1980","try find",2.11187136011306,20,6,14,3.36471455287156,16.6352854471284
"1980","well feel",2.11187136011306,20,6,14,3.36471455287156,16.6352854471284
"1980","youre wrong",2.11187136011306,20,6,14,3.36471455287156,16.6352854471284
"1990","tell now",2.10618801481806,54,16,38,11.4558135801947,42.5441864198053
"1960","one love",2.10600420245127,117,11,106,6.98762298696625,110.012377013034
"1990","love sweet",2.10580899047229,70,20,50,14.8501287150672,55.1498712849328
"1990","come true",2.10017728279283,132,35,97,28.0030998626982,103.996900137302
"1990","ill go",2.10006281410865,66,19,47,14.0015499313491,51.9984500686509
"1960","go away",2.09946502956103,91,9,82,5.43481787875153,85.5651821212485
"1980","good thing",2.09934206946829,43,11,32,7.23413628867385,35.7658637113261
"1980","im way",2.09934206946829,43,11,32,7.23413628867385,35.7658637113261
"1980","incomprehensible",2.09934206946829,43,11,32,7.23413628867385,35.7658637113261
"1980","look good",2.09934206946829,43,11,32,7.23413628867385,35.7658637113261
"1980","night just",2.09934206946829,43,11,32,7.23413628867385,35.7658637113261
"1980","theres need",2.09934206946829,43,11,32,7.23413628867385,35.7658637113261
"1980","weight",2.09934206946829,43,11,32,7.23413628867385,35.7658637113261
"2010","might get",2.09919209092989,52,12,40,8.00606164687973,43.9939383531203
"2010","never go",2.09919209092989,52,12,40,8.00606164687973,43.9939383531203
"1960","let get",2.09572253725715,104,10,94,6.21122043285889,97.7887795671411
"2000","get got",2.09384119664714,37,14,23,9.9561704268611,27.0438295731389
"2010","white",2.09354177392923,315,58,257,48.4982580532137,266.501741946786
"1980","animal",2.09273579085807,29,8,21,4.87883610166376,24.1211638983362
"1980","away now",2.09273579085807,29,8,21,4.87883610166376,24.1211638983362
"1980","cold ice",2.09273579085807,29,8,21,4.87883610166376,24.1211638983362
"1980","dont know say",2.09273579085807,29,8,21,4.87883610166376,24.1211638983362
"1980","hearing",2.09273579085807,29,8,21,4.87883610166376,24.1211638983362
"1980","score",2.09273579085807,29,8,21,4.87883610166376,24.1211638983362
"1980","shes just",2.09273579085807,29,8,21,4.87883610166376,24.1211638983362
"1980","tight dont",2.09273579085807,29,8,21,4.87883610166376,24.1211638983362
"2000","ahh ahh",2.09036392596936,16,7,9,4.3053709953994,11.6946290046006
"2000","back forth",2.09036392596936,16,7,9,4.3053709953994,11.6946290046006
"2000","cant figure",2.09036392596936,16,7,9,4.3053709953994,11.6946290046006
"2000","didnt feel",2.09036392596936,16,7,9,4.3053709953994,11.6946290046006
"2000","digging",2.09036392596936,16,7,9,4.3053709953994,11.6946290046006
"2000","flown",2.09036392596936,16,7,9,4.3053709953994,11.6946290046006
"2000","get line",2.09036392596936,16,7,9,4.3053709953994,11.6946290046006
"2000","gonna shine",2.09036392596936,16,7,9,4.3053709953994,11.6946290046006
"2000","got every",2.09036392596936,16,7,9,4.3053709953994,11.6946290046006
"2000","hear em",2.09036392596936,16,7,9,4.3053709953994,11.6946290046006
"2000","hey got",2.09036392596936,16,7,9,4.3053709953994,11.6946290046006
"2000","hey yo",2.09036392596936,16,7,9,4.3053709953994,11.6946290046006
"2000","inside cant",2.09036392596936,16,7,9,4.3053709953994,11.6946290046006
"2000","itim",2.09036392596936,16,7,9,4.3053709953994,11.6946290046006
"2000","itll take",2.09036392596936,16,7,9,4.3053709953994,11.6946290046006
"2000","just fast",2.09036392596936,16,7,9,4.3053709953994,11.6946290046006
"2000","love kiss",2.09036392596936,16,7,9,4.3053709953994,11.6946290046006
"2000","make dance",2.09036392596936,16,7,9,4.3053709953994,11.6946290046006
"2000","meooh",2.09036392596936,16,7,9,4.3053709953994,11.6946290046006
"2000","mtv",2.09036392596936,16,7,9,4.3053709953994,11.6946290046006
"2000","need em",2.09036392596936,16,7,9,4.3053709953994,11.6946290046006
"2000","one cant",2.09036392596936,16,7,9,4.3053709953994,11.6946290046006
"2000","say little",2.09036392596936,16,7,9,4.3053709953994,11.6946290046006
"2000","spend rest",2.09036392596936,16,7,9,4.3053709953994,11.6946290046006
"2000","time wanna",2.09036392596936,16,7,9,4.3053709953994,11.6946290046006
"2000","tub",2.09036392596936,16,7,9,4.3053709953994,11.6946290046006
"2000","wish id",2.09036392596936,16,7,9,4.3053709953994,11.6946290046006
"2000","wont believe",2.09036392596936,16,7,9,4.3053709953994,11.6946290046006
"2000","youre heart",2.09036392596936,16,7,9,4.3053709953994,11.6946290046006
"1990","dawn",2.08936317981041,107,29,78,22.6994824644599,84.3005175355401
"2000","girl can",2.08133281944602,56,20,36,15.0687984838979,40.9312015161021
"2000","thats right",2.08016891798761,159,51,108,42.7846242667815,116.215375733218
"2000","now cant",2.07797291247007,82,28,54,22.0650263514219,59.9349736485781
"2000","yeah oh yeah",2.07797291247007,82,28,54,22.0650263514219,59.9349736485781
"1980","wanted",2.07575294873509,448,87,361,75.3696059843229,372.630394015677
"2000","money",2.06739645159207,1142,329,813,307.295854796632,834.704145203368
"1970","field",2.06268346694605,41,9,32,5.61076356556702,35.389236434433
"1970","sadness",2.06268346694605,41,9,32,5.61076356556702,35.389236434433
"1970","say got",2.06268346694605,41,9,32,5.61076356556702,35.389236434433
"1970","see cry",2.06268346694605,41,9,32,5.61076356556702,35.389236434433
"1970","think id",2.06268346694605,41,9,32,5.61076356556702,35.389236434433
"1970","willing",2.06268346694605,41,9,32,5.61076356556702,35.389236434433
"1970","youve never",2.06268346694605,41,9,32,5.61076356556702,35.389236434433
"2000","acting like",2.06225057318841,34,13,21,9.14891336522372,24.8510866347763
"2000","know tell",2.06225057318841,34,13,21,9.14891336522372,24.8510866347763
"2000","mothers",2.06225057318841,34,13,21,9.14891336522372,24.8510866347763
"2000","talked",2.06225057318841,34,13,21,9.14891336522372,24.8510866347763
"1980","time baby",2.05601227801436,48,12,36,8.07531492689174,39.9246850731083
"2000","best friend",2.05569889074192,92,31,61,24.7558832235465,67.2441167764535
"2000","coast",2.05569889074192,92,31,61,24.7558832235465,67.2441167764535
"2000","zone",2.05569889074192,92,31,61,24.7558832235465,67.2441167764535
"1960","breaks",2.05431706998151,54,6,48,3.22505676321519,50.7749432367848
"1960","bunch",2.05431706998151,54,6,48,3.22505676321519,50.7749432367848
"2010","day im",2.05398352227517,47,11,36,7.23624802698745,39.7637519730126
"1980","yeah yeah yeah",2.04880180491825,913,170,743,153.599219338587,759.400780661413
"1990","pay",2.04857037648944,322,79,243,68.3105920893092,253.689407910691
"1980","longer",2.04817524379566,98,22,76,16.4871013090706,81.5128986909294
"1980","feelings",2.04787779665158,246,50,196,41.3859890003202,204.61401099968
"1970","time im",2.04621000240347,177,31,146,24.2220768562283,152.777923143772
"1960","turned",2.04478607485931,256,21,235,15.2891579885757,240.710842011424
"1980","fade",2.04365036586239,150,32,118,25.2353591465367,124.764640853463
"1990","belly",2.03868662029924,31,10,21,6.57648557381548,24.4235144261845
"1990","certain",2.03868662029924,31,10,21,6.57648557381548,24.4235144261845
"1990","chills",2.03868662029924,31,10,21,6.57648557381548,24.4235144261845
"1990","longing",2.03868662029924,31,10,21,6.57648557381548,24.4235144261845
"1990","mind cant",2.03868662029924,31,10,21,6.57648557381548,24.4235144261845
"1990","night oh night",2.03868662029924,31,10,21,6.57648557381548,24.4235144261845
"1990","things life",2.03868662029924,31,10,21,6.57648557381548,24.4235144261845
"1990","time take",2.03868662029924,31,10,21,6.57648557381548,24.4235144261845
"1990","will get",2.03868662029924,31,10,21,6.57648557381548,24.4235144261845
"1990","youwell",2.03868662029924,31,10,21,6.57648557381548,24.4235144261845
"2000","bitch im",2.0360876922134,31,12,19,8.34165630358633,22.6583436964137
"2000","im young",2.0360876922134,31,12,19,8.34165630358633,22.6583436964137
"2000","la lala",2.0360876922134,31,12,19,8.34165630358633,22.6583436964137
"2000","around let",2.03578502058075,19,8,11,5.11262805703678,13.8873719429632
"2000","best friends",2.03578502058075,19,8,11,5.11262805703678,13.8873719429632
"2000","better im",2.03578502058075,19,8,11,5.11262805703678,13.8873719429632
"2000","change ways",2.03578502058075,19,8,11,5.11262805703678,13.8873719429632
"2000","cheeks",2.03578502058075,19,8,11,5.11262805703678,13.8873719429632
"2000","comfortable",2.03578502058075,19,8,11,5.11262805703678,13.8873719429632
"2000","delilah",2.03578502058075,19,8,11,5.11262805703678,13.8873719429632
"2000","door im",2.03578502058075,19,8,11,5.11262805703678,13.8873719429632
"2000","feel cause",2.03578502058075,19,8,11,5.11262805703678,13.8873719429632
"2000","find way back",2.03578502058075,19,8,11,5.11262805703678,13.8873719429632
"2000","finna",2.03578502058075,19,8,11,5.11262805703678,13.8873719429632
"2000","friend im",2.03578502058075,19,8,11,5.11262805703678,13.8873719429632
"2000","give got",2.03578502058075,19,8,11,5.11262805703678,13.8873719429632
"2000","globe",2.03578502058075,19,8,11,5.11262805703678,13.8873719429632
"2000","high heels",2.03578502058075,19,8,11,5.11262805703678,13.8873719429632
"2000","hold hands",2.03578502058075,19,8,11,5.11262805703678,13.8873719429632
"2000","huh oh",2.03578502058075,19,8,11,5.11262805703678,13.8873719429632
"2000","light take",2.03578502058075,19,8,11,5.11262805703678,13.8873719429632
"2000","love em",2.03578502058075,19,8,11,5.11262805703678,13.8873719429632
"2000","miss much",2.03578502058075,19,8,11,5.11262805703678,13.8873719429632
"2000","nothin else",2.03578502058075,19,8,11,5.11262805703678,13.8873719429632
"2000","one right",2.03578502058075,19,8,11,5.11262805703678,13.8873719429632
"2000","tell wont",2.03578502058075,19,8,11,5.11262805703678,13.8873719429632
"2000","thing every",2.03578502058075,19,8,11,5.11262805703678,13.8873719429632
"2000","though try",2.03578502058075,19,8,11,5.11262805703678,13.8873719429632
"2000","wanna hurt",2.03578502058075,19,8,11,5.11262805703678,13.8873719429632
"2000","want call",2.03578502058075,19,8,11,5.11262805703678,13.8873719429632
"2000","well will",2.03578502058075,19,8,11,5.11262805703678,13.8873719429632
"2000","without live",2.03578502058075,19,8,11,5.11262805703678,13.8873719429632
"1970","shell",2.0338223235389,203,35,168,27.7801220441489,175.219877955851
"1980","everythings",2.03239526507771,93,21,72,15.6459226708527,77.3540773291473
"1960","climb",2.03189254347977,79,8,71,4.71813859803704,74.281861401963
"1960","fair",2.03189254347977,79,8,71,4.71813859803704,74.281861401963
"1960","ghetto",2.03189254347977,79,8,71,4.71813859803704,74.281861401963
"1960","ill",2.02796386409396,4216,274,3942,251.793320624357,3964.20667937564
"1980","make change",2.02671087106187,53,13,40,8.91649356510963,44.0835064348904
"2010","anything just",2.02076137348623,22,6,16,3.38717992752604,18.612820072474
"2010","care cause",2.02076137348623,22,6,16,3.38717992752604,18.612820072474
"2010","ever known",2.02076137348623,22,6,16,3.38717992752604,18.612820072474
"2010","go lets go",2.02076137348623,22,6,16,3.38717992752604,18.612820072474
"2010","got shit",2.02076137348623,22,6,16,3.38717992752604,18.612820072474
"2010","know real",2.02076137348623,22,6,16,3.38717992752604,18.612820072474
"2010","like damn",2.02076137348623,22,6,16,3.38717992752604,18.612820072474
"2010","like new",2.02076137348623,22,6,16,3.38717992752604,18.612820072474
"2010","look youve",2.02076137348623,22,6,16,3.38717992752604,18.612820072474
"2010","right right right right",2.02076137348623,22,6,16,3.38717992752604,18.612820072474
"2010","time long",2.02076137348623,22,6,16,3.38717992752604,18.612820072474
"2010","wack",2.02076137348623,22,6,16,3.38717992752604,18.612820072474
"2010","want right",2.02076137348623,22,6,16,3.38717992752604,18.612820072474
"2010","wrong wrong",2.02076137348623,22,6,16,3.38717992752604,18.612820072474
"2010","yell",2.02076137348623,22,6,16,3.38717992752604,18.612820072474
"2010","youre taking",2.02076137348623,22,6,16,3.38717992752604,18.612820072474
"2010","figure",2.01979633174556,107,22,85,16.4740114656948,90.5259885343052
"2010","sitting",2.01979633174556,107,22,85,16.4740114656948,90.5259885343052
"1980","dont know dont",2.01866904378143,88,20,68,14.8047440326349,73.1952559673651
"1980","never let go",2.01866904378143,88,20,68,14.8047440326349,73.1952559673651
"1970","better way",2.0175866214816,30,7,23,4.10543675529294,25.8945632447071
"1970","girl yeah",2.0175866214816,30,7,23,4.10543675529294,25.8945632447071
"1970","lets go lets",2.0175866214816,30,7,23,4.10543675529294,25.8945632447071
"1970","please tell",2.0175866214816,30,7,23,4.10543675529294,25.8945632447071
"1970","third",2.0175866214816,30,7,23,4.10543675529294,25.8945632447071
"1970","yes will",2.0175866214816,30,7,23,4.10543675529294,25.8945632447071
"2000","baby baby love",2.01706369507187,28,11,17,7.53439924194894,20.4656007580511
"2000","comes back",2.01706369507187,28,11,17,7.53439924194894,20.4656007580511
"2000","give just one",2.01706369507187,28,11,17,7.53439924194894,20.4656007580511
"2000","love comes",2.01706369507187,28,11,17,7.53439924194894,20.4656007580511
"2000","now well",2.01706369507187,28,11,17,7.53439924194894,20.4656007580511
"2000","one said",2.01706369507187,28,11,17,7.53439924194894,20.4656007580511
"2010","cant fight",2.01572582912226,42,10,32,6.46643440709516,35.5335655929048
"2010","cruise",2.01572582912226,42,10,32,6.46643440709516,35.5335655929048
"2010","gonna lose",2.01572582912226,42,10,32,6.46643440709516,35.5335655929048
"2010","jumped",2.01572582912226,42,10,32,6.46643440709516,35.5335655929048
"2010","wanna touch",2.01572582912226,42,10,32,6.46643440709516,35.5335655929048
"2010","weekend",2.01572582912226,42,10,32,6.46643440709516,35.5335655929048
"1960","pour",2.01554349557153,92,9,83,5.4945411521444,86.5054588478556
"2000","come just",2.01185030039791,22,9,13,5.91988511867417,16.0801148813258
"2000","decisions",2.01185030039791,22,9,13,5.91988511867417,16.0801148813258
"2000","dont wanna hear",2.01185030039791,22,9,13,5.91988511867417,16.0801148813258
"2000","every second",2.01185030039791,22,9,13,5.91988511867417,16.0801148813258
"2000","im sexy",2.01185030039791,22,9,13,5.91988511867417,16.0801148813258
"2000","irresistible",2.01185030039791,22,9,13,5.91988511867417,16.0801148813258
"2000","june",2.01185030039791,22,9,13,5.91988511867417,16.0801148813258
"2000","just friends",2.01185030039791,22,9,13,5.91988511867417,16.0801148813258
"2000","like ya",2.01185030039791,22,9,13,5.91988511867417,16.0801148813258
"2000","love gotta",2.01185030039791,22,9,13,5.91988511867417,16.0801148813258
"2000","nightmare",2.01185030039791,22,9,13,5.91988511867417,16.0801148813258
"2000","say words",2.01185030039791,22,9,13,5.91988511867417,16.0801148813258
"2000","sexy sexy",2.01185030039791,22,9,13,5.91988511867417,16.0801148813258
"2010","taking",2.01054897519078,216,41,175,33.2559483793466,182.744051620653
"1990","beat around",2.00840995360578,20,7,13,4.24289391859063,15.7571060814094
"1990","believe theres",2.00840995360578,20,7,13,4.24289391859063,15.7571060814094
"1990","ever find",2.00840995360578,20,7,13,4.24289391859063,15.7571060814094
"1990","fingers hair",2.00840995360578,20,7,13,4.24289391859063,15.7571060814094
"1990","found found",2.00840995360578,20,7,13,4.24289391859063,15.7571060814094
"1990","gentleman",2.00840995360578,20,7,13,4.24289391859063,15.7571060814094
"1990","girl really",2.00840995360578,20,7,13,4.24289391859063,15.7571060814094
"1990","gotcha",2.00840995360578,20,7,13,4.24289391859063,15.7571060814094
"1990","keep loving",2.00840995360578,20,7,13,4.24289391859063,15.7571060814094
"1990","know come",2.00840995360578,20,7,13,4.24289391859063,15.7571060814094
"1990","let hit",2.00840995360578,20,7,13,4.24289391859063,15.7571060814094
"1990","let work",2.00840995360578,20,7,13,4.24289391859063,15.7571060814094
"1990","life know",2.00840995360578,20,7,13,4.24289391859063,15.7571060814094
"1990","name one",2.00840995360578,20,7,13,4.24289391859063,15.7571060814094
"1990","passes",2.00840995360578,20,7,13,4.24289391859063,15.7571060814094
"1990","real loud",2.00840995360578,20,7,13,4.24289391859063,15.7571060814094
"1990","reminds",2.00840995360578,20,7,13,4.24289391859063,15.7571060814094
"1990","right start",2.00840995360578,20,7,13,4.24289391859063,15.7571060814094
"1990","role",2.00840995360578,20,7,13,4.24289391859063,15.7571060814094
"1990","single word",2.00840995360578,20,7,13,4.24289391859063,15.7571060814094
"1990","torn apart",2.00840995360578,20,7,13,4.24289391859063,15.7571060814094
"1990","toss",2.00840995360578,20,7,13,4.24289391859063,15.7571060814094
"1990","undress",2.00840995360578,20,7,13,4.24289391859063,15.7571060814094
"2000","cause need know",2.00769621329703,25,10,15,6.72714218031156,18.2728578196884
"2000","degrees",2.00769621329703,25,10,15,6.72714218031156,18.2728578196884
"2000","didnt even",2.00769621329703,25,10,15,6.72714218031156,18.2728578196884
"2000","fold",2.00769621329703,25,10,15,6.72714218031156,18.2728578196884
"2000","good things",2.00769621329703,25,10,15,6.72714218031156,18.2728578196884
"2000","need like",2.00769621329703,25,10,15,6.72714218031156,18.2728578196884
"2000","nigga aint",2.00769621329703,25,10,15,6.72714218031156,18.2728578196884
"2000","promise will",2.00769621329703,25,10,15,6.72714218031156,18.2728578196884
"2000","spoke",2.00769621329703,25,10,15,6.72714218031156,18.2728578196884
"2000","take deep",2.00769621329703,25,10,15,6.72714218031156,18.2728578196884
"2000","take one",2.00769621329703,25,10,15,6.72714218031156,18.2728578196884
"2000","way talk",2.00769621329703,25,10,15,6.72714218031156,18.2728578196884
"2000","well always",2.00769621329703,25,10,15,6.72714218031156,18.2728578196884
"1980","touched",2.00735660691117,83,19,64,13.963565394417,69.036434605583
"2010","go back",2.00667705900293,141,28,113,21.7087440809623,119.291255919038
"1970","dee da",2.00566563103064,89,17,72,12.1794623740357,76.8205376259643
"1970","im sure",2.00566563103064,89,17,72,12.1794623740357,76.8205376259643
"1990","still",2.00119242964369,1843,416,1427,390.982674598127,1452.01732540187
"1980","little time",1.99890748706941,78,18,60,13.1223867561991,64.8776132438009
"1980","face",1.99787818262973,869,162,707,146.196847322269,722.803152677731
"1970","men",1.99703510982401,184,32,152,25.18001209913,158.81998790087
"1970","im love",1.99568111164021,223,38,185,30.5170798810108,192.482920118989
"1980","coat",1.99463276342739,34,9,25,5.72001473988165,28.2799852601184
"1980","glow",1.99463276342739,34,9,25,5.72001473988165,28.2799852601184
"1980","hes just",1.99463276342739,34,9,25,5.72001473988165,28.2799852601184
"1980","kicking",1.99463276342739,34,9,25,5.72001473988165,28.2799852601184
"1980","mend",1.99463276342739,34,9,25,5.72001473988165,28.2799852601184
"1980","old man",1.99463276342739,34,9,25,5.72001473988165,28.2799852601184
"1980","rescue",1.99463276342739,34,9,25,5.72001473988165,28.2799852601184
"1980","take arms",1.99463276342739,34,9,25,5.72001473988165,28.2799852601184
"1980","cant cant",1.99389042926273,73,17,56,12.2812081179812,60.7187918820188
"1980","just wont",1.99303579381872,68,16,52,11.4400294797633,56.5599705202367
"1970","know theres",1.98845984274748,83,16,67,11.3583750229771,71.6416249770229
"1970","rings",1.98845984274748,83,16,67,11.3583750229771,71.6416249770229
"2010","aint love",1.98711916529772,37,9,28,5.69662078720288,31.3033792127971
"1980","york",1.98533241126239,177,37,140,29.7777237929133,147.222276207087
"1970","dont call",1.98428182672287,53,11,42,7.25293826768419,45.7470617323158
"1970","gonna go",1.98428182672287,53,11,42,7.25293826768419,45.7470617323158
"1970","heart soul",1.98428182672287,53,11,42,7.25293826768419,45.7470617323158
"1970","need somebody",1.98428182672287,53,11,42,7.25293826768419,45.7470617323158
"1970","tonight baby",1.98428182672287,53,11,42,7.25293826768419,45.7470617323158
"1960","thousand",1.98326366056905,173,15,158,10.3321262969672,162.667873703033
"1990","talk",1.98218685430756,975,225,750,206.841078531293,768.158921468707
"1990","backs",1.98178300800195,35,11,24,7.42506435753361,27.5749356424664
"1990","couldve",1.98178300800195,35,11,24,7.42506435753361,27.5749356424664
"1990","eyes know",1.98178300800195,35,11,24,7.42506435753361,27.5749356424664
"1990","knocks",1.98178300800195,35,11,24,7.42506435753361,27.5749356424664
"1990","ringin",1.98178300800195,35,11,24,7.42506435753361,27.5749356424664
"1990","time make",1.98178300800195,35,11,24,7.42506435753361,27.5749356424664
"1990","time love",1.9804533885948,87,24,63,18.4565885458693,68.5434114541307
"2010","around like",1.97914323029755,27,7,20,4.15699354741832,22.8430064525817
"2010","girl one",1.97914323029755,27,7,20,4.15699354741832,22.8430064525817
"2010","grey",1.97914323029755,27,7,20,4.15699354741832,22.8430064525817
"2010","monster",1.97914323029755,27,7,20,4.15699354741832,22.8430064525817
"2010","stories",1.97914323029755,27,7,20,4.15699354741832,22.8430064525817
"2010","told ya",1.97914323029755,27,7,20,4.15699354741832,22.8430064525817
"2010","young im",1.97914323029755,27,7,20,4.15699354741832,22.8430064525817
"1990","know want",1.97788250326424,253,63,190,53.6726080701715,199.327391929828
"2000","tonight oh",1.97767418811712,50,18,32,13.4542843606231,36.5457156393769
"1960","youre good",1.97747433584875,67,7,60,4.00145931732255,62.9985406826774
"2010","pussy",1.97542365147558,147,29,118,22.6325204248331,124.367479575167
"2010","dropped",1.97247609674839,32,8,24,4.9268071673106,27.0731928326894
"2010","giving love",1.97247609674839,32,8,24,4.9268071673106,27.0731928326894
"2010","ive just",1.97247609674839,32,8,24,4.9268071673106,27.0731928326894
"2010","know yeah",1.97247609674839,32,8,24,4.9268071673106,27.0731928326894
"2010","love bad",1.97247609674839,32,8,24,4.9268071673106,27.0731928326894
"2010","stairs",1.97247609674839,32,8,24,4.9268071673106,27.0731928326894
"2010","thirty",1.97247609674839,32,8,24,4.9268071673106,27.0731928326894
"2010","want tonight",1.97247609674839,32,8,24,4.9268071673106,27.0731928326894
"2010","bringing",1.97134915378117,58,13,45,8.92983799075047,49.0701620092495
"2000","hey hey",1.97003936079536,597,176,421,160.64415526584,436.35584473416
"1980","knew",1.96817561363399,712,134,578,119.783838082227,592.216161917773
"1970","baby get",1.96379362633209,65,13,52,8.89511296980137,56.1048870301986
"1970","bus",1.96379362633209,65,13,52,8.89511296980137,56.1048870301986
"1990","plan",1.96355099323651,112,30,82,23.7602059441075,88.2397940558925
"1980","youre one",1.96101019719449,285,57,228,47.9471823784197,237.05281762158
"2000","bet",1.95980061340228,225,70,155,60.544279622804,164.455720377196
"2000","class",1.95947865816801,76,26,50,20.4505122281471,55.5494877718529
"1980","rules",1.95319278174559,109,24,85,18.33769431315,90.66230568685
"2000","wondering",1.95210386053196,126,41,85,33.9047965887702,92.0952034112297
"1990","mad",1.94905355174328,262,65,197,55.5819103335373,206.418089666463
"1960","kiss",1.94666351369734,809,58,751,48.316128174835,760.683871825165
"1970","place",1.94559275071984,943,144,799,129.047562008041,813.952437991959
"1990","noise",1.94462164380961,79,22,57,16.759430978433,62.240569021567
"1960","can turn",1.94419800510472,55,6,49,3.28478003660807,51.7152199633919
"1960","now get",1.94293239796278,80,8,72,4.77786187142992,75.2221381285701
"1960","words",1.94269398161293,612,45,567,36.5506433164389,575.449356683561
"1990","hooked",1.94262781491045,39,12,27,8.27364314125173,30.7263568587483
"1990","want hear",1.94262781491045,39,12,27,8.27364314125173,30.7263568587483
"1980","common",1.93720549298704,25,7,18,4.20589319108945,20.7941068089106
"1980","got just",1.93720549298704,25,7,18,4.20589319108945,20.7941068089106
"1980","love must",1.93720549298704,25,7,18,4.20589319108945,20.7941068089106
"1980","shown",1.93720549298704,25,7,18,4.20589319108945,20.7941068089106
"1980","theres nothing left",1.93720549298704,25,7,18,4.20589319108945,20.7941068089106
"1980","tonight cause",1.93720549298704,25,7,18,4.20589319108945,20.7941068089106
"1980","true know",1.93720549298704,25,7,18,4.20589319108945,20.7941068089106
"1980","try understand",1.93720549298704,25,7,18,4.20589319108945,20.7941068089106
"1980","whenever youre",1.93720549298704,25,7,18,4.20589319108945,20.7941068089106
"1980","will right",1.93720549298704,25,7,18,4.20589319108945,20.7941068089106
"1990","love need",1.93437872501073,129,34,95,27.3666657749096,101.63333422509
"2000","reason",1.9326804750157,340,103,237,91.4891336522372,248.510866347763
"1990","take look",1.9290538356915,75,21,54,15.9108521947149,59.0891478052851
"1980","like uh",1.92879432590032,39,10,29,6.56119337809954,32.4388066219005
"1970","desire",1.92868945675937,102,19,83,13.958484967996,88.041515032004
"1980","night long",1.92867367303608,242,49,193,40.7130460897459,201.286953910254
"2010","oh dont",1.92840346466523,119,24,95,18.3215641534363,100.678435846564
"2010","doctor",1.92750063806849,91,19,72,14.0106078820395,76.9893921179605
"2000","rocking",1.92742870273452,47,17,30,12.6470272989857,34.3529727010143
"2000","think know",1.92742870273452,47,17,30,12.6470272989857,34.3529727010143
"2000","youre beautiful",1.92742870273452,47,17,30,12.6470272989857,34.3529727010143
"1990","think youre",1.92655899962922,163,42,121,34.5795854365137,128.420414563486
"2000","window",1.92589797607016,184,58,126,49.5117664470931,134.488233552907
"1970","gonna say",1.92452114975244,36,8,28,4.92652410635153,31.0734758936485
"1970","harm",1.92452114975244,36,8,28,4.92652410635153,31.0734758936485
"1960","knowing",1.92162321613188,133,12,121,7.94319536125223,125.056804638748
"1960","na na",1.92144415694889,1366,94,1272,81.5819914546658,1284.41800854533
"2010","one night",1.92130879571038,159,31,128,24.4800731125746,134.519926887425
"1990","baby one",1.91642049784173,43,13,30,9.12222192496986,33.8777780750301
"1990","claim",1.91642049784173,43,13,30,9.12222192496986,33.8777780750301
"1990","love need love",1.91642049784173,43,13,30,9.12222192496986,33.8777780750301
"1990","oh god",1.91642049784173,43,13,30,9.12222192496986,33.8777780750301
"2010","aint good",1.91453284522258,53,12,41,8.16002437085818,44.8399756291418
"2010","bleed",1.91453284522258,53,12,41,8.16002437085818,44.8399756291418
"2010","singing",1.91277575676225,223,42,181,34.3336874471958,188.666312552804
"1990","within",1.91187518443563,104,28,76,22.0630483766713,81.9369516233287
"1980","youd",1.90582380371989,412,80,332,69.3131197891541,342.686880210846
"1970","awayand",1.90487181378574,25,6,19,3.42119729607745,21.5788027039226
"1970","cant see im",1.90487181378574,25,6,19,3.42119729607745,21.5788027039226
"1970","chance take",1.90487181378574,25,6,19,3.42119729607745,21.5788027039226
"1970","gone just",1.90487181378574,25,6,19,3.42119729607745,21.5788027039226
"1970","love shes",1.90487181378574,25,6,19,3.42119729607745,21.5788027039226
"1970","night gonna",1.90487181378574,25,6,19,3.42119729607745,21.5788027039226
"1970","see now",1.90487181378574,25,6,19,3.42119729607745,21.5788027039226
"1970","thrown",1.90487181378574,25,6,19,3.42119729607745,21.5788027039226
"1970","time look",1.90487181378574,25,6,19,3.42119729607745,21.5788027039226
"1970","will right",1.90487181378574,25,6,19,3.42119729607745,21.5788027039226
"1970","yeah tell",1.90487181378574,25,6,19,3.42119729607745,21.5788027039226
"1990","feel feel",1.90398191014202,67,19,48,14.2136946272786,52.7863053727214
"1990","huh uh",1.90398191014202,67,19,48,14.2136946272786,52.7863053727214
"1990","tryin get",1.90398191014202,67,19,48,14.2136946272786,52.7863053727214
"1980","havent",1.90381208449051,125,27,98,21.0294659554472,103.970534044553
"1990","tricks",1.89995237890999,47,14,33,9.97080070868799,37.029199291312
"1990","yeah now",1.89522809142507,63,18,45,13.3651158435605,49.6348841564395
"2010","born",1.89262296305326,300,55,245,46.1888171935369,253.811182806463
"2000","mama",1.89110981667291,460,137,323,123.779416117733,336.220583882267
"1990","date",1.89099611754728,51,15,36,10.8193794924061,40.1806205075939
"1990","yeah hey",1.89099611754728,51,15,36,10.8193794924061,40.1806205075939
"1960","water",1.89076425184551,245,20,225,14.6322019812541,230.367798018746
"1990","breeze",1.88966110612513,59,17,42,12.5165370598424,46.4834629401576
"1990","innocent",1.88966110612513,59,17,42,12.5165370598424,46.4834629401576
"1990","just got",1.88795658761763,55,16,39,11.6679582761242,43.3320417238758
"1990","appear",1.88521383672179,24,8,16,5.09147270230876,18.9085272976912
"1990","cause one",1.88521383672179,24,8,16,5.09147270230876,18.9085272976912
"1990","face face",1.88521383672179,24,8,16,5.09147270230876,18.9085272976912
"1990","fits",1.88521383672179,24,8,16,5.09147270230876,18.9085272976912
"1990","flies",1.88521383672179,24,8,16,5.09147270230876,18.9085272976912
"1990","heart still",1.88521383672179,24,8,16,5.09147270230876,18.9085272976912
"1990","know truth",1.88521383672179,24,8,16,5.09147270230876,18.9085272976912
"1990","menow",1.88521383672179,24,8,16,5.09147270230876,18.9085272976912
"1990","peaceful",1.88521383672179,24,8,16,5.09147270230876,18.9085272976912
"1980","arms around",1.88467792151316,44,11,33,7.40237201631743,36.5976279836826
"1990","thats",1.88389535433881,2727,608,2119,578.518585799833,2148.48141420017
"1960","heart beat",1.88166350684905,68,7,61,4.06118259071543,63.9388174092846
"1960","squeeze",1.88166350684905,68,7,61,4.06118259071543,63.9388174092846
"2000","everything need",1.87852356086885,44,16,28,11.8397702373483,32.1602297626517
"2000","whole lot",1.87852356086885,44,16,28,11.8397702373483,32.1602297626517
"2010","caught",1.87702811844132,330,60,270,50.8076989128906,279.192301087109
"1990","cause love",1.876676729649,121,32,89,25.6695082074733,95.3304917925267
"1990","youll see",1.876676729649,121,32,89,25.6695082074733,95.3304917925267
"1990","shoes",1.87401827710669,172,44,128,36.4888876998794,135.511112300121
"2010","queen",1.87197483460392,148,29,119,22.7864831488115,125.213516851188
"1970","man got",1.8680749751482,42,9,33,5.74761145741011,36.2523885425899
"1970","whether",1.8680749751482,42,9,33,5.74761145741011,36.2523885425899
"2010","cares",1.86731021030657,64,14,50,9.8536143346212,54.1463856653788
"2010","im thinking",1.86731021030657,64,14,50,9.8536143346212,54.1463856653788
"1960","can see",1.86154486851098,450,34,416,26.8754730267933,423.124526973207
"2010","blow mind",1.86150672040664,48,11,37,7.3902107509659,40.6097892490341
"2010","understands",1.86150672040664,48,11,37,7.3902107509659,40.6097892490341
"1990","every night",1.8596561980272,185,47,138,39.2467687469634,145.753231253037
"1970","sand",1.85734413351376,84,16,68,11.4952229148202,72.5047770851798
"1960","baby baby baby baby",1.85640993084687,134,12,122,8.00291863464511,125.997081365355
"1960","children",1.85640993084687,134,12,122,8.00291863464511,125.997081365355
"1980","im living",1.85589448676346,49,12,37,8.24355065453532,40.7564493454647
"1980","love ooh",1.85589448676346,49,12,37,8.24355065453532,40.7564493454647
"1960","talkin bout",1.85471954309177,94,9,85,5.61398769893015,88.3860123010698
"2010","price",1.85289506251285,114,23,91,17.551750533544,96.448249466456
"2000","read",1.85287277533701,188,59,129,50.5881091959429,137.411890804057
"1980","without",1.85165735415941,1367,249,1118,229.978239688771,1137.02176031123
"2010","nothin",1.84311294346092,487,86,401,74.9798465775082,412.020153422492
"1970","yeah got",1.83916993818212,78,15,63,10.6741355637616,67.3258644362384
"1960","nose",1.83853246038247,56,6,50,3.34450331000094,52.6554966899991
"1960","wearing",1.83853246038247,56,6,50,3.34450331000094,52.6554966899991
"1980","love yes",1.83834222888378,54,13,41,9.08472929275321,44.9152707072468
"1980","oh know",1.83834222888378,54,13,41,9.08472929275321,44.9152707072468
"1980","someones",1.83834222888378,54,13,41,9.08472929275321,44.9152707072468
"1970","back baby",1.83514839424812,48,10,38,6.5686988084687,41.4313011915313
"1970","strangers",1.83514839424812,48,10,38,6.5686988084687,41.4313011915313
"1990","im gon",1.83238227678829,134,35,99,28.4273892545572,105.572610745443
"2000","baby go",1.83124920297359,41,15,26,11.032513175711,29.9674868242891
"2000","field",1.83124920297359,41,15,26,11.032513175711,29.9674868242891
"2000","hittin",1.83124920297359,41,15,26,11.032513175711,29.9674868242891
"2000","plane",1.83124920297359,41,15,26,11.032513175711,29.9674868242891
"1980","greatest",1.8292653448053,59,14,45,9.9259079309711,49.0740920690289
"1980","hard find",1.8292653448053,59,14,45,9.9259079309711,49.0740920690289
"1980","tease",1.8292653448053,59,14,45,9.9259079309711,49.0740920690289
"1980","floating",1.82838900332666,30,8,22,5.04707182930734,24.9529281706927
"1980","heard say",1.82838900332666,30,8,22,5.04707182930734,24.9529281706927
"1980","now yeah",1.82838900332666,30,8,22,5.04707182930734,24.9529281706927
"1980","said done",1.82838900332666,30,8,22,5.04707182930734,24.9529281706927
"1980","things will",1.82838900332666,30,8,22,5.04707182930734,24.9529281706927
"1980","played",1.82783197046582,152,32,120,25.5718306018238,126.428169398176
"1980","waste",1.82783197046582,152,32,120,25.5718306018238,126.428169398176
"1980","desert",1.82674291804585,64,15,49,10.767086569189,53.232913430811
"1980","give just",1.82674291804585,64,15,49,10.767086569189,53.232913430811
"1960","cause love",1.82263388956614,121,11,110,7.22651608053775,113.773483919462
"1960","leave alone",1.82263388956614,121,11,110,7.22651608053775,113.773483919462
"1990","ive seen",1.8201171377691,113,30,83,23.9723506400371,89.0276493599629
"1970","just good",1.81823834479622,54,11,43,7.38978615952729,46.6102138404727
"1970","always love",1.81563756597988,66,13,53,9.03196086164446,56.9680391383555
"1970","shines",1.81563756597988,66,13,53,9.03196086164446,56.9680391383555
"2010","can hide",1.81354881059484,43,10,33,6.62039713107362,36.3796028689264
"2010","maybe im",1.81354881059484,43,10,33,6.62039713107362,36.3796028689264
"2010","never make",1.81354881059484,43,10,33,6.62039713107362,36.3796028689264
"2010","right right right",1.81354881059484,43,10,33,6.62039713107362,36.3796028689264
"1970","downtown",1.81298179953379,103,19,84,14.0953328598391,88.9046671401609
"1970","quiet",1.81273257815269,60,12,48,8.21087351058588,51.7891264894141
"2000","can take",1.80877427686153,261,80,181,70.2313643624527,190.768635637547
"1990","babies",1.8047833453198,28,9,19,5.94005148602689,22.0599485139731
"1990","better let",1.8047833453198,28,9,19,5.94005148602689,22.0599485139731
"1990","confusion",1.8047833453198,28,9,19,5.94005148602689,22.0599485139731
"1990","killin",1.8047833453198,28,9,19,5.94005148602689,22.0599485139731
"1990","life can",1.8047833453198,28,9,19,5.94005148602689,22.0599485139731
"1990","love id",1.8047833453198,28,9,19,5.94005148602689,22.0599485139731
"1990","now well",1.8047833453198,28,9,19,5.94005148602689,22.0599485139731
"1990","push push",1.8047833453198,28,9,19,5.94005148602689,22.0599485139731
"1990","stay forever",1.8047833453198,28,9,19,5.94005148602689,22.0599485139731
"1990","thats get",1.8047833453198,28,9,19,5.94005148602689,22.0599485139731
"1990","world around",1.8047833453198,28,9,19,5.94005148602689,22.0599485139731
"2010","already know",1.80308811166969,59,13,46,9.08380071472892,49.9161992852711
"2010","hold close",1.80308811166969,59,13,46,9.08380071472892,49.9161992852711
"2010","know go",1.80308811166969,59,13,46,9.08380071472892,49.9161992852711
"2010","miracle",1.80308811166969,59,13,46,9.08380071472892,49.9161992852711
"1980","never thought",1.80273508519059,105,23,82,17.6647514025757,87.3352485974243
"1980","try",1.80243692071699,1260,230,1030,211.977016830908,1048.02298316909
"2000","story",1.79799899645031,185,58,127,49.7808521343055,135.219147865694
"1980","memory",1.79691683961557,147,31,116,24.730651963606,122.269348036394
"1960","brain",1.79553970878054,108,10,98,6.45011352643039,101.54988647357
"2000","middle",1.79543506754384,289,88,201,77.7657636044016,211.234236395598
"1990","baby cause",1.79429306930694,84,23,61,17.8201544580807,66.1798455419193
"1970","eternity",1.79040146373901,31,7,24,4.24228464713604,26.757715352864
"1970","give chance",1.79040146373901,31,7,24,4.24228464713604,26.757715352864
"1970","know youve got",1.79040146373901,31,7,24,4.24228464713604,26.757715352864
"1970","rains",1.79040146373901,31,7,24,4.24228464713604,26.757715352864
"1970","take love",1.79040146373901,31,7,24,4.24228464713604,26.757715352864
"1970","youll get",1.79040146373901,31,7,24,4.24228464713604,26.757715352864
"1960","another one",1.78922820689465,69,7,62,4.1209058641083,64.8790941358917
"1960","return",1.78922820689465,69,7,62,4.1209058641083,64.8790941358917
"1980","away tears",1.78753313132829,21,6,15,3.53295028051514,17.4670497194849
"1980","away wont",1.78753313132829,21,6,15,3.53295028051514,17.4670497194849
"1980","believe magic",1.78753313132829,21,6,15,3.53295028051514,17.4670497194849
"1980","coming like",1.78753313132829,21,6,15,3.53295028051514,17.4670497194849
"1980","draw",1.78753313132829,21,6,15,3.53295028051514,17.4670497194849
"1980","give just little",1.78753313132829,21,6,15,3.53295028051514,17.4670497194849
"1980","heart hes",1.78753313132829,21,6,15,3.53295028051514,17.4670497194849
"1980","hold just",1.78753313132829,21,6,15,3.53295028051514,17.4670497194849
"1980","huh huh huh",1.78753313132829,21,6,15,3.53295028051514,17.4670497194849
"1980","jackie",1.78753313132829,21,6,15,3.53295028051514,17.4670497194849
"1980","keep lovin",1.78753313132829,21,6,15,3.53295028051514,17.4670497194849
"1980","kitty",1.78753313132829,21,6,15,3.53295028051514,17.4670497194849
"1980","love look",1.78753313132829,21,6,15,3.53295028051514,17.4670497194849
"1980","mind can",1.78753313132829,21,6,15,3.53295028051514,17.4670497194849
"1980","somebody somebody",1.78753313132829,21,6,15,3.53295028051514,17.4670497194849
"1980","tell lie",1.78753313132829,21,6,15,3.53295028051514,17.4670497194849
"1980","tell need",1.78753313132829,21,6,15,3.53295028051514,17.4670497194849
"1980","wonder im",1.78753313132829,21,6,15,3.53295028051514,17.4670497194849
"1980","wont stay",1.78753313132829,21,6,15,3.53295028051514,17.4670497194849
"2000","try tell",1.78598660761884,38,14,24,10.2252561140736,27.7747438859264
"2000","yeahoh",1.78598660761884,38,14,24,10.2252561140736,27.7747438859264
"1960","youi",1.78446151496049,233,19,214,13.9155227005396,219.08447729946
"2010","eat",1.78344323017719,172,33,139,26.4815885242945,145.518411475706
"1980","girls",1.78248904187447,942,174,768,158.47805544025,783.52194455975
"2010","mess",1.78208076171265,207,39,168,31.8702838635405,175.12971613646
"1980","beauty",1.77969792486407,100,22,78,16.8235727643578,83.1764272356422
"1960","clouds",1.77771267206874,95,9,86,5.67371097232302,89.326289027677
"1960","now now",1.77771267206874,95,9,86,5.67371097232302,89.326289027677
"1960","shoot",1.77771267206874,95,9,86,5.67371097232302,89.326289027677
"1970","sleep",1.77765069444545,433,69,364,59.2551371680614,373.744862831939
"1990","tell",1.77760792664655,3445,763,2682,730.838477477236,2714.16152252276
"1990","bad baby",1.77709471002144,17,6,11,3.60645983080204,13.393540169198
"1990","believe oh",1.77709471002144,17,6,11,3.60645983080204,13.393540169198
"1990","bored",1.77709471002144,17,6,11,3.60645983080204,13.393540169198
"1990","bro",1.77709471002144,17,6,11,3.60645983080204,13.393540169198
"1990","call love",1.77709471002144,17,6,11,3.60645983080204,13.393540169198
"1990","can lay",1.77709471002144,17,6,11,3.60645983080204,13.393540169198
"1990","doe",1.77709471002144,17,6,11,3.60645983080204,13.393540169198
"1990","dont turn around",1.77709471002144,17,6,11,3.60645983080204,13.393540169198
"1990","else im",1.77709471002144,17,6,11,3.60645983080204,13.393540169198
"1990","everybody look",1.77709471002144,17,6,11,3.60645983080204,13.393540169198
"1990","hear cry",1.77709471002144,17,6,11,3.60645983080204,13.393540169198
"1990","heart breaking",1.77709471002144,17,6,11,3.60645983080204,13.393540169198
"1990","heaven sent",1.77709471002144,17,6,11,3.60645983080204,13.393540169198
"1990","im givin",1.77709471002144,17,6,11,3.60645983080204,13.393540169198
"1990","megirl",1.77709471002144,17,6,11,3.60645983080204,13.393540169198
"1990","mind girl",1.77709471002144,17,6,11,3.60645983080204,13.393540169198
"1990","mineyou",1.77709471002144,17,6,11,3.60645983080204,13.393540169198
"1990","never win",1.77709471002144,17,6,11,3.60645983080204,13.393540169198
"1990","now give",1.77709471002144,17,6,11,3.60645983080204,13.393540169198
"1990","now whos",1.77709471002144,17,6,11,3.60645983080204,13.393540169198
"1990","plays fool",1.77709471002144,17,6,11,3.60645983080204,13.393540169198
"1990","proper",1.77709471002144,17,6,11,3.60645983080204,13.393540169198
"1990","rappin",1.77709471002144,17,6,11,3.60645983080204,13.393540169198
"1990","somebodys gonna",1.77709471002144,17,6,11,3.60645983080204,13.393540169198
"1990","stares",1.77709471002144,17,6,11,3.60645983080204,13.393540169198
"1990","thats said",1.77709471002144,17,6,11,3.60645983080204,13.393540169198
"1990","touch hand",1.77709471002144,17,6,11,3.60645983080204,13.393540169198
"1990","triple",1.77709471002144,17,6,11,3.60645983080204,13.393540169198
"1990","true just",1.77709471002144,17,6,11,3.60645983080204,13.393540169198
"1990","wanna tell love",1.77709471002144,17,6,11,3.60645983080204,13.393540169198
"1990","yall know",1.77709471002144,17,6,11,3.60645983080204,13.393540169198
"1960","showed",1.77327427849044,82,8,74,4.89730841821566,77.1026915817843
"1960","want baby",1.77327427849044,82,8,74,4.89730841821566,77.1026915817843
"2010","split",1.77258584887989,38,9,29,5.85058351118134,32.1494164888187
"2010","cause got",1.77181932189298,149,29,120,22.94044587279,126.05955412721
"1960","fun",1.7700765261223,423,32,391,25.2629446451857,397.737055354814
"1990","wont",1.76774623880107,2313,517,1796,490.690681685007,1822.30931831499
"1960","da da da da",1.75992228843331,191,16,175,11.4071452180389,179.592854781961
"1980","away far",1.75842527637473,35,9,26,5.88825046752523,29.1117495324748
"1980","babe dont",1.75842527637473,35,9,26,5.88825046752523,29.1117495324748
"1980","can touch",1.75842527637473,35,9,26,5.88825046752523,29.1117495324748
"1980","dont want dont",1.75842527637473,35,9,26,5.88825046752523,29.1117495324748
"1980","dream come",1.75842527637473,35,9,26,5.88825046752523,29.1117495324748
"1980","oh go",1.75842527637473,35,9,26,5.88825046752523,29.1117495324748
"1970","cant live without",1.75687930648326,91,17,74,12.4531581577219,78.5468418422781
"1970","thunder",1.75687930648326,91,17,74,12.4531581577219,78.5468418422781
"1960","id like",1.75599734013898,122,11,111,7.28623935393062,114.713760646069
"1970","near",1.75582350530547,213,36,177,29.1486009625799,183.85139903742
"1990","cant resist",1.75160274310058,32,10,22,6.78863026974501,25.211369730255
"1990","dont know much",1.75160274310058,32,10,22,6.78863026974501,25.211369730255
"1990","guaranteed",1.75160274310058,32,10,22,6.78863026974501,25.211369730255
"1990","home alone",1.75160274310058,32,10,22,6.78863026974501,25.211369730255
"1990","just cause",1.75160274310058,32,10,22,6.78863026974501,25.211369730255
"1990","love youll",1.75160274310058,32,10,22,6.78863026974501,25.211369730255
"1960","free",1.74682527215994,710,51,659,42.4035241089405,667.596475891059
"1970","hey hey",1.74566988023393,597,93,504,81.6981914303295,515.301808569671
"2010","dancing",1.74460886774203,362,65,297,55.7345060802012,306.265493919799
"2000","backs",1.74324559675448,35,13,22,9.41799905243618,25.5820009475638
"2000","ignore",1.74324559675448,35,13,22,9.41799905243618,25.5820009475638
"2000","just see",1.74324559675448,35,13,22,9.41799905243618,25.5820009475638
"2000","mix",1.74324559675448,35,13,22,9.41799905243618,25.5820009475638
"2000","personal",1.74324559675448,35,13,22,9.41799905243618,25.5820009475638
"2010","get feeling",1.74166592356265,33,8,25,5.08076989128906,27.9192301087109
"2010","live like",1.74166592356265,33,8,25,5.08076989128906,27.9192301087109
"2010","said youre",1.74166592356265,33,8,25,5.08076989128906,27.9192301087109
"2010","stole",1.74166592356265,33,8,25,5.08076989128906,27.9192301087109
"2010","suppose",1.74166592356265,33,8,25,5.08076989128906,27.9192301087109
"2010","tell now",1.74092083656637,54,12,42,8.31398709483664,45.6860129051634
"1980","know youre",1.73963282890859,448,86,362,75.3696059843229,372.630394015677
"1980","gonna break",1.7373185346584,90,20,70,15.141215487922,74.858784512078
"1960","hardly",1.73715339871659,57,6,51,3.40422658339381,53.5957734166062
"1960","shows",1.73715339871659,57,6,51,3.40422658339381,53.5957734166062
"1990","asleep",1.73603124976966,72,20,52,15.2744181069263,56.7255818930737
"2010","back want back want",1.7346936924604,23,6,17,3.5411426515045,19.4588573484955
"2010","downs",1.7346936924604,23,6,17,3.5411426515045,19.4588573484955
"2010","drop drop",1.7346936924604,23,6,17,3.5411426515045,19.4588573484955
"2010","gone long",1.7346936924604,23,6,17,3.5411426515045,19.4588573484955
"2010","know heard",1.7346936924604,23,6,17,3.5411426515045,19.4588573484955
"2010","know life",1.7346936924604,23,6,17,3.5411426515045,19.4588573484955
"2010","life cause",1.7346936924604,23,6,17,3.5411426515045,19.4588573484955
"2010","look right",1.7346936924604,23,6,17,3.5411426515045,19.4588573484955
"2010","miles away",1.7346936924604,23,6,17,3.5411426515045,19.4588573484955
"2010","old school",1.7346936924604,23,6,17,3.5411426515045,19.4588573484955
"2010","remember remember remember",1.7346936924604,23,6,17,3.5411426515045,19.4588573484955
"2010","shit aint",1.7346936924604,23,6,17,3.5411426515045,19.4588573484955
"2010","singing song",1.7346936924604,23,6,17,3.5411426515045,19.4588573484955
"2010","sipping",1.7346936924604,23,6,17,3.5411426515045,19.4588573484955
"2010","whips",1.7346936924604,23,6,17,3.5411426515045,19.4588573484955
"2010","yeah cant",1.7346936924604,23,6,17,3.5411426515045,19.4588573484955
"1970","dont know im",1.7343437649677,110,20,90,15.0532681027408,94.9467318972592
"1970","aye aye",1.73183116295457,85,16,69,11.6320708066633,73.3679291933367
"1960","cross",1.73036498075847,136,12,124,8.12236518143086,127.877634818569
"1980","treat",1.72835390529269,321,63,258,54.0036685735885,266.996331426411
"2010","just cant get enough",1.72591658465484,28,7,21,4.31095627139678,23.6890437286032
"2010","left hand",1.72591658465484,28,7,21,4.31095627139678,23.6890437286032
"2010","lit",1.72591658465484,28,7,21,4.31095627139678,23.6890437286032
"2010","magical",1.72591658465484,28,7,21,4.31095627139678,23.6890437286032
"2010","oh lets",1.72591658465484,28,7,21,4.31095627139678,23.6890437286032
"2010","one good",1.72591658465484,28,7,21,4.31095627139678,23.6890437286032
"2010","sake",1.72591658465484,28,7,21,4.31095627139678,23.6890437286032
"2010","take night",1.72591658465484,28,7,21,4.31095627139678,23.6890437286032
"2010","throat",1.72591658465484,28,7,21,4.31095627139678,23.6890437286032
"2010","youre pretty",1.72591658465484,28,7,21,4.31095627139678,23.6890437286032
"2000","feelin",1.72428379125962,494,146,348,132.928329482956,361.071670517044
"1970","baby think",1.72399344897049,37,8,29,5.06337199819462,31.9366280018054
"1970","im still love",1.72399344897049,37,8,29,5.06337199819462,31.9366280018054
"1970","miracles",1.72399344897049,37,8,29,5.06337199819462,31.9366280018054
"2000","puff",1.72355906869773,64,22,42,17.2214839815976,46.7785160184024
"2000","like want",1.7230795611996,51,18,33,13.7233700478356,37.2766299521644
"1980","want say",1.71839999444339,85,19,66,14.3000368497041,70.6999631502959
"1990","chance make",1.71687279065225,36,11,25,7.63720905346314,28.3627909465369
"1990","chicken",1.71687279065225,36,11,25,7.63720905346314,28.3627909465369
"1990","yeah want",1.71687279065225,36,11,25,7.63720905346314,28.3627909465369
"2000","five",1.71629746675245,196,61,135,52.7407946936426,143.259205306357
"1980","baby love baby",1.71334356501197,40,10,30,6.72942910574312,33.2705708942569
"1980","bars",1.71334356501197,40,10,30,6.72942910574312,33.2705708942569
"1980","breath away",1.71334356501197,40,10,30,6.72942910574312,33.2705708942569
"1980","dont dont dont",1.71334356501197,40,10,30,6.72942910574312,33.2705708942569
"1980","ears",1.71334356501197,40,10,30,6.72942910574312,33.2705708942569
"1980","felt like",1.71334356501197,40,10,30,6.72942910574312,33.2705708942569
"1980","ill let",1.71334356501197,40,10,30,6.72942910574312,33.2705708942569
"1980","wanna play",1.71334356501197,40,10,30,6.72942910574312,33.2705708942569
"1980","world just",1.71334356501197,40,10,30,6.72942910574312,33.2705708942569
"1990","thoughts",1.71252838327757,118,31,87,25.0330741196847,92.9669258803153
"1990","can call",1.71153946059416,97,26,71,20.5780355051646,76.4219644948354
"2010","bridge",1.70917417203677,76,16,60,11.7011670223627,64.2988329776373
"1980","earth",1.7057345970675,132,28,104,22.2071160489523,109.792883951048
"1960","rather",1.7055570496488,178,15,163,10.6307426639316,167.369257336068
"2000","give anything",1.70372441548879,32,12,20,8.61074199079879,23.3892580092012
"2000","hey im",1.70372441548879,32,12,20,8.61074199079879,23.3892580092012
"2000","ill ill",1.70372441548879,32,12,20,8.61074199079879,23.3892580092012
"2000","just cause",1.70372441548879,32,12,20,8.61074199079879,23.3892580092012
"2000","lala la",1.70372441548879,32,12,20,8.61074199079879,23.3892580092012
"2000","walk walk",1.70372441548879,32,12,20,8.61074199079879,23.3892580092012
"1970","shes got",1.70204771620259,168,29,139,22.9904458296404,145.00955417036
"1980","take chance",1.70136400096452,80,18,62,13.4588582114862,66.5411417885138
"2000","makin",1.69802573944405,318,96,222,85.569248533563,232.430751466437
"2000","hey hey hey",1.69704921550742,297,90,207,79.9184491021013,217.081550897899
"1990","make feel good",1.69522335000825,40,12,28,8.48578783718126,31.5142121628187
"1990","youif",1.69522335000825,40,12,28,8.48578783718126,31.5142121628187
"2010","cause know",1.6902135445631,214,40,174,32.9480229313897,181.05197706861
"1980","million",1.68940945051309,207,42,165,34.8247956222206,172.175204377779
"2000","wrote",1.68757827828156,94,31,63,25.2940545979715,68.7059454020285
"1980","business",1.68657648672977,75,17,58,12.6176795732683,62.3823204267317
"1970","fly fly",1.6864582750627,43,9,34,5.88445934925321,37.1155406507468
"1970","theres need",1.6864582750627,43,9,34,5.88445934925321,37.1155406507468
"1970","watched",1.6864582750627,43,9,34,5.88445934925321,37.1155406507468
"2000","harder",1.68609872673371,155,49,106,41.7082815179316,113.291718482068
"1990","surely",1.68562179423978,93,25,68,19.7294567214464,73.2705432785536
"1980","ive done",1.68517065370293,45,11,34,7.57060774396101,37.429392256039
"1980","stop stop",1.68517065370293,45,11,34,7.57060774396101,37.429392256039
"1980","take another",1.68517065370293,45,11,34,7.57060774396101,37.429392256039
"1990","dis",1.68318810155348,44,13,31,9.33436662089939,34.6656333791006
"1990","price",1.68308090477715,114,30,84,24.1844953359666,89.8155046640334
"1990","break",1.68268228194048,977,224,753,207.265367923152,769.734632076848
"2010","chillin",1.6814208739663,49,11,38,7.54417347494436,41.4558265250556
"2010","mamas",1.6814208739663,49,11,38,7.54417347494436,41.4558265250556
"2010","something can",1.6814208739663,49,11,38,7.54417347494436,41.4558265250556
"2010","wanna show",1.6814208739663,49,11,38,7.54417347494436,41.4558265250556
"1990","now time",1.67930755031537,52,15,37,11.0315241883356,40.9684758116644
"1990","time think",1.67842817013188,48,14,34,10.1829454046175,37.8170545953825
"1990","youre fine",1.67842817013188,48,14,34,10.1829454046175,37.8170545953825
"1990","anybody",1.67536411821923,131,34,97,27.7909551667686,103.209044833231
"1990","dog",1.67536411821923,131,34,97,27.7909551667686,103.209044833231
"1970","show love",1.67491540414195,67,13,54,9.16880875348756,57.8311912465124
"1980","wed",1.67407658219305,191,39,152,32.1330239799234,158.866976020077
"2010","okay",1.6731507919122,226,42,184,34.7955756191311,191.204424380869
"2010","right im",1.67090518895635,93,19,74,14.3185333299964,78.6814666700036
"1970","hangin",1.67018368992695,98,18,80,13.4110934006236,84.5889065993764
"1980","away oh",1.66901817192327,50,12,38,8.4117863821789,41.5882136178211
"1980","finding",1.66901817192327,50,12,38,8.4117863821789,41.5882136178211
"1980","ill get",1.66901817192327,50,12,38,8.4117863821789,41.5882136178211
"1980","ive tried",1.66901817192327,50,12,38,8.4117863821789,41.5882136178211
"1980","now never",1.66901817192327,50,12,38,8.4117863821789,41.5882136178211
"2000","away pain",1.66840580256229,29,11,18,7.80348492916141,21.1965150708386
"2000","got magic",1.66840580256229,29,11,18,7.80348492916141,21.1965150708386
"2000","hearing",1.66840580256229,29,11,18,7.80348492916141,21.1965150708386
"2000","im girl",1.66840580256229,29,11,18,7.80348492916141,21.1965150708386
"2000","know things",1.66840580256229,29,11,18,7.80348492916141,21.1965150708386
"2000","make things",1.66840580256229,29,11,18,7.80348492916141,21.1965150708386
"2000","mean nothing",1.66840580256229,29,11,18,7.80348492916141,21.1965150708386
"2000","back baby",1.66828808521614,48,17,31,12.9161129861982,35.0838870138018
"2000","come dance",1.66828808521614,48,17,31,12.9161129861982,35.0838870138018
"2000","til get",1.66828808521614,48,17,31,12.9161129861982,35.0838870138018
"1970","keepin",1.66764518211799,49,10,39,6.7055467003118,42.2944532996882
"1980","ground",1.66669423144919,278,55,223,46.7695322849147,231.230467715085
"2000","love love love love",1.66660651286721,162,51,111,43.5918813284189,118.408118671581
"1980","walks",1.66575623922449,65,15,50,10.9353222968326,54.0646777031674
"1970","just call",1.66488947999135,61,12,49,8.34772140242897,52.652278597571
"2010","almost",1.66398796768259,185,35,150,28.4831039360144,156.516896063986
"2010","doubt",1.66398796768259,185,35,150,28.4831039360144,156.516896063986
"1970","read",1.66392659704401,188,32,156,25.7274036665024,162.272596333498
"1980","argue",1.6636870929431,26,7,19,4.37412891873303,21.625871081267
"1980","baby well",1.6636870929431,26,7,19,4.37412891873303,21.625871081267
"1980","ever go",1.6636870929431,26,7,19,4.37412891873303,21.625871081267
"1980","far away far",1.6636870929431,26,7,19,4.37412891873303,21.625871081267
"1980","find im",1.6636870929431,26,7,19,4.37412891873303,21.625871081267
"1980","forever never",1.6636870929431,26,7,19,4.37412891873303,21.625871081267
"1980","give need",1.6636870929431,26,7,19,4.37412891873303,21.625871081267
"1980","helping",1.6636870929431,26,7,19,4.37412891873303,21.625871081267
"1980","make come",1.6636870929431,26,7,19,4.37412891873303,21.625871081267
"1980","mind just",1.6636870929431,26,7,19,4.37412891873303,21.625871081267
"1980","need ill",1.6636870929431,26,7,19,4.37412891873303,21.625871081267
"1980","never forget",1.6636870929431,26,7,19,4.37412891873303,21.625871081267
"1980","sometime",1.6636870929431,26,7,19,4.37412891873303,21.625871081267
"1980","tender love",1.6636870929431,26,7,19,4.37412891873303,21.625871081267
"1980","walked away",1.6636870929431,26,7,19,4.37412891873303,21.625871081267
"1980","woman like",1.6636870929431,26,7,19,4.37412891873303,21.625871081267
"1980","wrong im",1.6636870929431,26,7,19,4.37412891873303,21.625871081267
"2010","love yeah",1.6632033302049,110,22,88,16.9358996376302,93.0641003623698
"2010","tell im",1.6632033302049,110,22,88,16.9358996376302,93.0641003623698
"1970","away like",1.66258151056026,26,6,20,3.55804518792055,22.4419548120795
"1970","babe im",1.66258151056026,26,6,20,3.55804518792055,22.4419548120795
"1970","bye bye bye",1.66258151056026,26,6,20,3.55804518792055,22.4419548120795
"1970","find im",1.66258151056026,26,6,20,3.55804518792055,22.4419548120795
"1970","go will",1.66258151056026,26,6,20,3.55804518792055,22.4419548120795
"1970","now now now",1.66258151056026,26,6,20,3.55804518792055,22.4419548120795
"1970","true oh",1.66258151056026,26,6,20,3.55804518792055,22.4419548120795
"1970","try try try",1.66258151056026,26,6,20,3.55804518792055,22.4419548120795
"1970","will will will",1.66258151056026,26,6,20,3.55804518792055,22.4419548120795
"1980","give one",1.6617197579036,55,13,42,9.25296502039679,45.7470349796032
"1980","yeah love",1.6617197579036,55,13,42,9.25296502039679,45.7470349796032
"1970","doesnt mean",1.66167152997331,55,11,44,7.52663405137039,47.4733659486296
"1970","id give",1.66167152997331,55,11,44,7.52663405137039,47.4733659486296
"1970","just got",1.66167152997331,55,11,44,7.52663405137039,47.4733659486296
"1980","somewhere",1.6615348399048,229,46,183,38.5259816303793,190.474018369621
"1980","quiet",1.66113306629635,60,14,46,10.0941436586147,49.9058563413853
"1960","tell im",1.65693989960559,110,10,100,6.56956007321613,103.430439926784
"1980","old",1.65655849015171,730,136,594,122.812081179812,607.187918820188
"1980","making love",1.6539868563613,101,22,79,16.9918084920014,84.0081915079986
"1990","sleeping",1.6538843552534,110,29,81,23.3359165522485,86.6640834477515
"2000","dont get",1.65158221129172,145,46,99,39.017424645807,105.982575354193
"1990","away tears",1.64956210713157,21,7,14,4.45503861452016,16.5449613854798
"1990","baby baby ooo",1.64956210713157,21,7,14,4.45503861452016,16.5449613854798
"1990","back yeah",1.64956210713157,21,7,14,4.45503861452016,16.5449613854798
"1990","broke heart",1.64956210713157,21,7,14,4.45503861452016,16.5449613854798
"1990","come close",1.64956210713157,21,7,14,4.45503861452016,16.5449613854798
"1990","display",1.64956210713157,21,7,14,4.45503861452016,16.5449613854798
"1990","dont know whats",1.64956210713157,21,7,14,4.45503861452016,16.5449613854798
"1990","ever leave",1.64956210713157,21,7,14,4.45503861452016,16.5449613854798
"1990","form",1.64956210713157,21,7,14,4.45503861452016,16.5449613854798
"1990","give reason",1.64956210713157,21,7,14,4.45503861452016,16.5449613854798
"1990","go wont",1.64956210713157,21,7,14,4.45503861452016,16.5449613854798
"1990","gonna make move",1.64956210713157,21,7,14,4.45503861452016,16.5449613854798
"1990","ill never let go",1.64956210713157,21,7,14,4.45503861452016,16.5449613854798
"1990","im king",1.64956210713157,21,7,14,4.45503861452016,16.5449613854798
"1990","man get",1.64956210713157,21,7,14,4.45503861452016,16.5449613854798
"1990","right come",1.64956210713157,21,7,14,4.45503861452016,16.5449613854798
"1990","shotgun",1.64956210713157,21,7,14,4.45503861452016,16.5449613854798
"1990","together cant",1.64956210713157,21,7,14,4.45503861452016,16.5449613854798
"1990","will catch",1.64956210713157,21,7,14,4.45503861452016,16.5449613854798
"2000","beggin baby",1.64662271609879,14,6,8,3.76719962097447,10.2328003790255
"2000","bout go",1.64662271609879,14,6,8,3.76719962097447,10.2328003790255
"2000","boy aint",1.64662271609879,14,6,8,3.76719962097447,10.2328003790255
"2000","check check",1.64662271609879,14,6,8,3.76719962097447,10.2328003790255
"2000","chokin",1.64662271609879,14,6,8,3.76719962097447,10.2328003790255
"2000","continue",1.64662271609879,14,6,8,3.76719962097447,10.2328003790255
"2000","couldnt hold",1.64662271609879,14,6,8,3.76719962097447,10.2328003790255
"2000","dont plan",1.64662271609879,14,6,8,3.76719962097447,10.2328003790255
"2000","downyou",1.64662271609879,14,6,8,3.76719962097447,10.2328003790255
"2000","east coast",1.64662271609879,14,6,8,3.76719962097447,10.2328003790255
"2000","even got",1.64662271609879,14,6,8,3.76719962097447,10.2328003790255
"2000","feeling inside",1.64662271609879,14,6,8,3.76719962097447,10.2328003790255
"2000","forces",1.64662271609879,14,6,8,3.76719962097447,10.2328003790255
"2000","gear",1.64662271609879,14,6,8,3.76719962097447,10.2328003790255
"2000","give em",1.64662271609879,14,6,8,3.76719962097447,10.2328003790255
"2000","im oh",1.64662271609879,14,6,8,3.76719962097447,10.2328003790255
"2000","im well",1.64662271609879,14,6,8,3.76719962097447,10.2328003790255
"2000","just met",1.64662271609879,14,6,8,3.76719962097447,10.2328003790255
"2000","know right now",1.64662271609879,14,6,8,3.76719962097447,10.2328003790255
"2000","know sometimes",1.64662271609879,14,6,8,3.76719962097447,10.2328003790255
"2000","let go keep",1.64662271609879,14,6,8,3.76719962097447,10.2328003790255
"2000","like good",1.64662271609879,14,6,8,3.76719962097447,10.2328003790255
"2000","make fall love",1.64662271609879,14,6,8,3.76719962097447,10.2328003790255
"2000","need much",1.64662271609879,14,6,8,3.76719962097447,10.2328003790255
"2000","never let go keep",1.64662271609879,14,6,8,3.76719962097447,10.2328003790255
"2000","now go now go",1.64662271609879,14,6,8,3.76719962097447,10.2328003790255
"2000","right want",1.64662271609879,14,6,8,3.76719962097447,10.2328003790255
"2000","see take",1.64662271609879,14,6,8,3.76719962097447,10.2328003790255
"2000","since gone",1.64662271609879,14,6,8,3.76719962097447,10.2328003790255
"2000","struggle",1.64662271609879,14,6,8,3.76719962097447,10.2328003790255
"2000","takes make",1.64662271609879,14,6,8,3.76719962097447,10.2328003790255
"2000","tears cry",1.64662271609879,14,6,8,3.76719962097447,10.2328003790255
"2000","things youre",1.64662271609879,14,6,8,3.76719962097447,10.2328003790255
"2000","wait just",1.64662271609879,14,6,8,3.76719962097447,10.2328003790255
"2000","well well well well",1.64662271609879,14,6,8,3.76719962097447,10.2328003790255
"2000","ya cant",1.64662271609879,14,6,8,3.76719962097447,10.2328003790255
"2000","yo im",1.64662271609879,14,6,8,3.76719962097447,10.2328003790255
"2000","youre gonna go",1.64662271609879,14,6,8,3.76719962097447,10.2328003790255
"2000","youre nothing",1.64662271609879,14,6,8,3.76719962097447,10.2328003790255
"1970","keep",1.64571710090133,2547,371,2176,348.55158052437,2198.44841947563
"1960","sit",1.6401911976507,265,21,244,15.8266674491116,249.173332550888
"1960","know im gonna",1.63990301712736,58,6,52,3.46394985678669,54.5360501432133
"1960","sing song",1.63990301712736,58,6,52,3.46394985678669,54.5360501432133
"2000","argue",1.6387186487406,26,10,16,6.99622786752402,19.003772132476
"2000","girl ive",1.6387186487406,26,10,16,6.99622786752402,19.003772132476
"2000","just something",1.6387186487406,26,10,16,6.99622786752402,19.003772132476
"2000","oh wanna",1.6387186487406,26,10,16,6.99622786752402,19.003772132476
"2000","please dont leave",1.6387186487406,26,10,16,6.99622786752402,19.003772132476
"2000","spanish",1.6387186487406,26,10,16,6.99622786752402,19.003772132476
"2000","tell friends",1.6387186487406,26,10,16,6.99622786752402,19.003772132476
"2000","rule",1.6385097942737,101,33,68,27.1776544084587,73.8223455915413
"2010","test",1.63718378601539,71,15,56,10.9313534024704,60.0686465975296
"2010","yea yea",1.63718378601539,71,15,56,10.9313534024704,60.0686465975296
"2000","just say",1.6358858265868,71,24,47,19.1050837920848,51.8949162079152
"1990","lately",1.63573564859981,85,23,62,18.0322991540102,66.9677008459898
"1990","without love",1.63573564859981,85,23,62,18.0322991540102,66.9677008459898
"1970","shack",1.62933777122672,111,20,91,15.1901159945839,95.8098840054161
"1960","bottle",1.62757055079417,124,11,113,7.40568590071637,116.594314099284
"1960","given",1.62757055079417,124,11,113,7.40568590071637,116.594314099284
"1980","chorus",1.62715546699905,224,45,179,37.6848029921615,186.315197007839
"1980","clear",1.62715546699905,224,45,179,37.6848029921615,186.315197007839
"1970","say dont",1.62684699164486,143,25,118,19.569248533563,123.430751466437
"1980","round round",1.62605023076021,154,32,122,25.908302057111,128.091697942889
"2010","im missing",1.62547131025631,44,10,34,6.77435985505208,37.2256401449479
"2010","pockets",1.62547131025631,44,10,34,6.77435985505208,37.2256401449479
"2000","wouldnt",1.62349269586672,421,125,296,113.285074316447,307.714925683553
"2000","asked",1.61981673792694,118,38,80,31.7521110910705,86.2478889089295
"1960","son",1.61896468937931,208,17,191,12.4224408657178,195.577559134282
"1980","one love",1.61758747725514,117,25,92,19.6835801342986,97.3164198657014
"2000","coming coming",1.61682434119413,23,9,14,6.18897080588663,16.8110291941134
"2000","em know",1.61682434119413,23,9,14,6.18897080588663,16.8110291941134
"2000","hates",1.61682434119413,23,9,14,6.18897080588663,16.8110291941134
"2000","im cause",1.61682434119413,23,9,14,6.18897080588663,16.8110291941134
"2000","joke",1.61682434119413,23,9,14,6.18897080588663,16.8110291941134
"2000","killer",1.61682434119413,23,9,14,6.18897080588663,16.8110291941134
"2000","know best",1.61682434119413,23,9,14,6.18897080588663,16.8110291941134
"2000","make stay",1.61682434119413,23,9,14,6.18897080588663,16.8110291941134
"2000","may seem",1.61682434119413,23,9,14,6.18897080588663,16.8110291941134
"2000","never thought id",1.61682434119413,23,9,14,6.18897080588663,16.8110291941134
"2000","say dont know",1.61682434119413,23,9,14,6.18897080588663,16.8110291941134
"2000","sipping",1.61682434119413,23,9,14,6.18897080588663,16.8110291941134
"2000","walk around",1.61682434119413,23,9,14,6.18897080588663,16.8110291941134
"2000","whoo",1.61421092629505,45,16,29,12.1088559245608,32.8911440754392
"2000","wise",1.61421092629505,45,16,29,12.1088559245608,32.8911440754392
"2000","another chance",1.61252689810389,17,7,10,4.57445668261186,12.4255433173881
"2000","belt",1.61252689810389,17,7,10,4.57445668261186,12.4255433173881
"2000","bitch got",1.61252689810389,17,7,10,4.57445668261186,12.4255433173881
"2000","brag",1.61252689810389,17,7,10,4.57445668261186,12.4255433173881
"2000","cant look",1.61252689810389,17,7,10,4.57445668261186,12.4255433173881
"2000","dont wanna lonely",1.61252689810389,17,7,10,4.57445668261186,12.4255433173881
"2000","everybody loves",1.61252689810389,17,7,10,4.57445668261186,12.4255433173881
"2000","feel thing",1.61252689810389,17,7,10,4.57445668261186,12.4255433173881
"2000","feel touch",1.61252689810389,17,7,10,4.57445668261186,12.4255433173881
"2000","glad found",1.61252689810389,17,7,10,4.57445668261186,12.4255433173881
"2000","im first",1.61252689810389,17,7,10,4.57445668261186,12.4255433173881
"2000","im moving",1.61252689810389,17,7,10,4.57445668261186,12.4255433173881
"2000","love crazy",1.61252689810389,17,7,10,4.57445668261186,12.4255433173881
"2000","nothing lose",1.61252689810389,17,7,10,4.57445668261186,12.4255433173881
"2000","rejoice",1.61252689810389,17,7,10,4.57445668261186,12.4255433173881
"2000","ruin",1.61252689810389,17,7,10,4.57445668261186,12.4255433173881
"2000","socks",1.61252689810389,17,7,10,4.57445668261186,12.4255433173881
"2000","spotlight",1.61252689810389,17,7,10,4.57445668261186,12.4255433173881
"2000","sure dont",1.61252689810389,17,7,10,4.57445668261186,12.4255433173881
"2000","sweater",1.61252689810389,17,7,10,4.57445668261186,12.4255433173881
"2000","wars",1.61252689810389,17,7,10,4.57445668261186,12.4255433173881
"2000","wherever go",1.61252689810389,17,7,10,4.57445668261186,12.4255433173881
"2000","yall know",1.61252689810389,17,7,10,4.57445668261186,12.4255433173881
"2000","yeah man",1.61252689810389,17,7,10,4.57445668261186,12.4255433173881
"1990","dying",1.61195644544535,81,22,59,17.1837203702921,63.8162796297079
"1990","will see",1.61195644544535,81,22,59,17.1837203702921,63.8162796297079
"1980","making",1.60707447954853,367,71,296,61.7425120451931,305.257487954807
"2000","right can",1.60635370985133,58,20,38,15.6069698583228,42.3930301416772
"2000","see see",1.60635370985133,58,20,38,15.6069698583228,42.3930301416772
"2000","without baby",1.60635370985133,58,20,38,15.6069698583228,42.3930301416772
"2000","alright now",1.60615697063762,20,8,12,5.38171374424925,14.6182862557508
"2000","beautiful day",1.60615697063762,20,8,12,5.38171374424925,14.6182862557508
"2000","bring fire",1.60615697063762,20,8,12,5.38171374424925,14.6182862557508
"2000","can kiss",1.60615697063762,20,8,12,5.38171374424925,14.6182862557508
"2000","dont dance",1.60615697063762,20,8,12,5.38171374424925,14.6182862557508
"2000","dont trust",1.60615697063762,20,8,12,5.38171374424925,14.6182862557508
"2000","drew",1.60615697063762,20,8,12,5.38171374424925,14.6182862557508
"2000","fast can",1.60615697063762,20,8,12,5.38171374424925,14.6182862557508
"2000","get move",1.60615697063762,20,8,12,5.38171374424925,14.6182862557508
"2000","girl keep",1.60615697063762,20,8,12,5.38171374424925,14.6182862557508
"2000","good look",1.60615697063762,20,8,12,5.38171374424925,14.6182862557508
"2000","im without",1.60615697063762,20,8,12,5.38171374424925,14.6182862557508
"2000","inside im",1.60615697063762,20,8,12,5.38171374424925,14.6182862557508
"2000","know made",1.60615697063762,20,8,12,5.38171374424925,14.6182862557508
"2000","mmmm",1.60615697063762,20,8,12,5.38171374424925,14.6182862557508
"2000","overnight",1.60615697063762,20,8,12,5.38171374424925,14.6182862557508
"2000","pop pop pop",1.60615697063762,20,8,12,5.38171374424925,14.6182862557508
"2000","take aim",1.60615697063762,20,8,12,5.38171374424925,14.6182862557508
"2000","tshirt",1.60615697063762,20,8,12,5.38171374424925,14.6182862557508
"1960","seem",1.60323357599538,295,23,272,17.6183656508978,277.381634349102
"2010","dont get",1.60076942820904,145,28,117,22.3245949768762,122.675405023124
"1990","god",1.59759914043745,501,118,383,106.284492660695,394.715507339305
"2010","dry",1.59590934917312,88,18,70,13.5487197101042,74.4512802898958
"1970","white",1.59564979941108,315,51,264,43.1070859305758,271.892914069424
"1960","tight",1.59474808866836,354,27,327,21.1420387810774,332.857961218923
"1990","move",1.59311956585675,1129,257,872,239.511361704441,889.488638295559
"1980","covers",1.5883036195522,31,8,23,5.21530755695092,25.7846924430491
"1980","heart never",1.5883036195522,31,8,23,5.21530755695092,25.7846924430491
"1980","lights go",1.5883036195522,31,8,23,5.21530755695092,25.7846924430491
"1980","now weve",1.5883036195522,31,8,23,5.21530755695092,25.7846924430491
"1980","rains",1.5883036195522,31,8,23,5.21530755695092,25.7846924430491
"1980","risk",1.5883036195522,31,8,23,5.21530755695092,25.7846924430491
"1980","though know",1.5883036195522,31,8,23,5.21530755695092,25.7846924430491
"2010","afraid",1.585701455124,239,44,195,36.7970910308511,202.202908969149
"1980","im alone",1.58417610269542,86,19,67,14.4682725773477,71.5317274226523
"1980","time dont",1.58417610269542,86,19,67,14.4682725773477,71.5317274226523
"1970","theres",1.58237634770586,1942,285,1657,265.758605959296,1676.2413940407
"1970","feeling im",1.58204644599088,32,7,25,4.37913253897913,27.6208674610209
"1970","give anything",1.58204644599088,32,7,25,4.37913253897913,27.6208674610209
"1970","losin",1.58204644599088,32,7,25,4.37913253897913,27.6208674610209
"1970","love till",1.58204644599088,32,7,25,4.37913253897913,27.6208674610209
"1970","san",1.58204644599088,32,7,25,4.37913253897913,27.6208674610209
"2000","tonight im",1.57891814106053,98,32,66,26.3703973468213,71.6296026531787
"2010","closed",1.57789322149045,55,12,43,8.4679498188151,46.5320501811849
"2010","got girl",1.57789322149045,55,12,43,8.4679498188151,46.5320501811849
"2010","love way love",1.57789322149045,55,12,43,8.4679498188151,46.5320501811849
"1970","cried",1.57702524777129,163,28,135,22.306206370425,140.693793629575
"2010","never change",1.57439406819744,39,9,30,6.0045462351598,32.9954537648402
"1970","lookin",1.57422544122638,471,74,397,64.4553570580991,406.544642941901
"1990","cant stop loving",1.57130269677412,25,8,17,5.30361739823829,19.6963826017617
"1990","got back",1.57130269677412,25,8,17,5.30361739823829,19.6963826017617
"1990","got just",1.57130269677412,25,8,17,5.30361739823829,19.6963826017617
"1990","im done",1.57130269677412,25,8,17,5.30361739823829,19.6963826017617
"1990","ive thinking",1.57130269677412,25,8,17,5.30361739823829,19.6963826017617
"1990","keep love",1.57130269677412,25,8,17,5.30361739823829,19.6963826017617
"1990","life one",1.57130269677412,25,8,17,5.30361739823829,19.6963826017617
"1990","see one",1.57130269677412,25,8,17,5.30361739823829,19.6963826017617
"1990","sometimes im",1.57130269677412,25,8,17,5.30361739823829,19.6963826017617
"1990","song ill",1.57130269677412,25,8,17,5.30361739823829,19.6963826017617
"1990","take one",1.57130269677412,25,8,17,5.30361739823829,19.6963826017617
"1990","time need",1.57130269677412,25,8,17,5.30361739823829,19.6963826017617
"1990","time now",1.57130269677412,25,8,17,5.30361739823829,19.6963826017617
"1990","true know",1.57130269677412,25,8,17,5.30361739823829,19.6963826017617
"1990","will right",1.57130269677412,25,8,17,5.30361739823829,19.6963826017617
"1990","wont say",1.57130269677412,25,8,17,5.30361739823829,19.6963826017617
"1990","secrets",1.5681037297861,98,26,72,20.7901802010941,77.2098197989059
"2010","baby wanna",1.56573255793186,66,14,52,10.1615397825781,55.8384602174219
"2010","sees",1.56573255793186,66,14,52,10.1615397825781,55.8384602174219
"1960","ago",1.56572581429351,125,11,114,7.46540917410924,117.534590825891
"2000","around world",1.5652517888557,78,26,52,20.9886836025721,57.0113163974279
"2000","doesnt matter",1.5652517888557,78,26,52,20.9886836025721,57.0113163974279
"2000","dumb",1.5652517888557,78,26,52,20.9886836025721,57.0113163974279
"1980","dying",1.56358668119256,81,18,63,13.6270939391298,67.3729060608702
"1990","know youre",1.5616060987599,448,106,342,95.0408237764302,352.95917622357
"2000","come see",1.56099961458452,42,15,27,11.3015988629234,30.6984011370766
"2000","dont hear",1.56099961458452,42,15,27,11.3015988629234,30.6984011370766
"2000","pool",1.56099961458452,42,15,27,11.3015988629234,30.6984011370766
"2000","still want",1.56099961458452,42,15,27,11.3015988629234,30.6984011370766
"2000","weekend",1.56099961458452,42,15,27,11.3015988629234,30.6984011370766
"1980","blind",1.55840012583752,214,43,171,36.0024457157257,177.997554284274
"2010","right",1.55650841835892,3946,636,3310,607.536908818989,3338.46309118101
"2000","still love",1.55601142347818,156,49,107,41.9773672051441,114.022632794856
"1970","car",1.54871764164044,390,62,328,53.3706778188082,336.629322181192
"2010","rich",1.54806757557304,134,26,108,20.6310050131131,113.368994986887
"2000","right just",1.54801125181593,55,19,36,14.7997127966854,40.2002872033146
"1960","love true",1.54663207776305,59,6,53,3.52367313017956,55.4763268698204
"1960","mistakes",1.54663207776305,59,6,53,3.52367313017956,55.4763268698204
"1960","need someone",1.54663207776305,59,6,53,3.52367313017956,55.4763268698204
"1960","reality",1.54663207776305,59,6,53,3.52367313017956,55.4763268698204
"1960","torn",1.54663207776305,59,6,53,3.52367313017956,55.4763268698204
"1960","youre everything",1.54663207776305,59,6,53,3.52367313017956,55.4763268698204
"1960","sign",1.5464171540327,167,14,153,9.97378665660995,157.02621334339
"1980","gonna say",1.54200920851076,36,9,27,6.05648619516881,29.9435138048312
"1980","theres one thing",1.54200920851076,36,9,27,6.05648619516881,29.9435138048312
"1980","well well well",1.54200920851076,36,9,27,6.05648619516881,29.9435138048312
"1970","tie",1.54138054185772,68,13,55,9.30565664533066,58.6943433546693
"2000","aint gonna",1.53859848489425,139,44,95,37.4029105225323,101.597089477468
"1960","name love",1.53840473993281,85,8,77,5.07647823839428,79.9235217616057
"1970","hopes",1.53838430259825,38,8,30,5.20021989003772,32.7997801099623
"1970","light fire",1.53838430259825,38,8,30,5.20021989003772,32.7997801099623
"1970","look way",1.53838430259825,38,8,30,5.20021989003772,32.7997801099623
"1970","reaching",1.53838430259825,38,8,30,5.20021989003772,32.7997801099623
"1970","smart",1.53838430259825,38,8,30,5.20021989003772,32.7997801099623
"1970","swinging",1.53838430259825,38,8,30,5.20021989003772,32.7997801099623
"1970","ya baby",1.53838430259825,38,8,30,5.20021989003772,32.7997801099623
"1970","beside",1.5383296513839,144,25,119,19.7060964254061,124.293903574594
"1970","burning",1.53646105724148,216,36,180,29.5591446381092,186.440855361891
"2010","acting like",1.53026175786921,34,8,26,5.23473261526751,28.7652673847325
"2010","break dawn",1.53026175786921,34,8,26,5.23473261526751,28.7652673847325
"2010","foreign",1.53026175786921,34,8,26,5.23473261526751,28.7652673847325
"2010","hearted",1.53026175786921,34,8,26,5.23473261526751,28.7652673847325
"2010","let put",1.53026175786921,34,8,26,5.23473261526751,28.7652673847325
"2010","look im",1.53026175786921,34,8,26,5.23473261526751,28.7652673847325
"2010","right now im",1.53026175786921,34,8,26,5.23473261526751,28.7652673847325
"2010","shootin",1.53026175786921,34,8,26,5.23473261526751,28.7652673847325
"2010","talking bout",1.53026175786921,34,8,26,5.23473261526751,28.7652673847325
"2010","undone",1.53026175786921,34,8,26,5.23473261526751,28.7652673847325
"1970","dont dont",1.52829508864282,93,17,76,12.7268539414081,80.2731460585919
"1970","south",1.52829198006708,112,20,92,15.326963886427,96.673036113573
"1970","just aint",1.5250771881638,62,12,50,8.48456929427207,53.5154307057279
"1970","turned",1.5238327469386,256,42,214,35.0330603118331,220.966939688167
"1990","forever will",1.52256917027326,29,9,20,6.15219618195642,22.8478038180436
"1990","gave love",1.52256917027326,29,9,20,6.15219618195642,22.8478038180436
"1990","hard see",1.52256917027326,29,9,20,6.15219618195642,22.8478038180436
"1990","harmony",1.52256917027326,29,9,20,6.15219618195642,22.8478038180436
"1990","know things",1.52256917027326,29,9,20,6.15219618195642,22.8478038180436
"1990","love dont know",1.52256917027326,29,9,20,6.15219618195642,22.8478038180436
"1990","one like",1.52256917027326,29,9,20,6.15219618195642,22.8478038180436
"1990","sacrifice",1.52256917027326,29,9,20,6.15219618195642,22.8478038180436
"1990","sharing",1.52256917027326,29,9,20,6.15219618195642,22.8478038180436
"1990","speakers",1.52256917027326,29,9,20,6.15219618195642,22.8478038180436
"1990","theres time",1.52256917027326,29,9,20,6.15219618195642,22.8478038180436
"1990","want cause",1.52256917027326,29,9,20,6.15219618195642,22.8478038180436
"1990","whatever want",1.52256917027326,29,9,20,6.15219618195642,22.8478038180436
"1990","six",1.52224145147503,128,33,95,27.15452107898,100.84547892102
"1960","moon",1.51720810987596,268,21,247,16.0058372692902,251.99416273071
"1970","groovy",1.5171577669087,44,9,35,6.02130724109631,37.9786927589037
"1970","world can",1.5171577669087,44,9,35,6.02130724109631,37.9786927589037
"1970","ya dont",1.5171577669087,44,9,35,6.02130724109631,37.9786927589037
"2000","race",1.51612875669024,65,22,43,17.49056966881,47.50943033119
"1990","realize",1.51511317483806,184,46,138,39.0346240510338,144.965375948966
"2000","never let",1.51458213651471,177,55,122,47.6281666366058,129.371833363394
"1980","dont afraid",1.51456661232366,41,10,31,6.8976648333867,34.1023351666133
"1980","night yeah",1.51456661232366,41,10,31,6.8976648333867,34.1023351666133
"1980","youre feelin",1.51456661232366,41,10,31,6.8976648333867,34.1023351666133
"2010","gone im",1.51315352261102,50,11,39,7.69813619892281,42.3018638010772
"2010","ship",1.51315352261102,50,11,39,7.69813619892281,42.3018638010772
"2010","tonight oh",1.51315352261102,50,11,39,7.69813619892281,42.3018638010772
"1990","turn back",1.51067122790537,61,17,44,12.9408264517014,48.0591735482986
"1970","day life",1.51061048179392,50,10,40,6.8423945921549,43.1576054078451
"1970","ill stay",1.51061048179392,50,10,40,6.8423945921549,43.1576054078451
"1970","man can",1.51061048179392,50,10,40,6.8423945921549,43.1576054078451
"1970","now never",1.51061048179392,50,10,40,6.8423945921549,43.1576054078451
"1970","singing",1.50972405011014,223,37,186,30.5170798810108,192.482920118989
"2010","good good",1.50922091310165,181,34,147,27.8672530401006,153.132746959899
"2000","iii",1.5088518259643,39,14,25,10.494341801286,28.505658198714
"2000","wash away",1.5088518259643,39,14,25,10.494341801286,28.505658198714
"1980","ill tell",1.50753680511565,118,25,93,19.8518158619422,98.1481841380578
"1980","falling love",1.50716738553859,97,21,76,16.3188655814271,80.6811344185729
"1970","cant get",1.5063746311428,330,53,277,45.1598043082223,284.840195691778
"1980","baby make",1.50314759715354,61,14,47,10.2623793862583,50.7376206137417
"1990","dear",1.50236542945075,141,36,105,29.912402126064,111.087597873936
"1980","ah ha",1.50135305615315,22,6,16,3.70118600815871,18.2988139918413
"1980","compromise",1.50135305615315,22,6,16,3.70118600815871,18.2988139918413
"1980","gotta leave",1.50135305615315,22,6,16,3.70118600815871,18.2988139918413
"1980","let slip",1.50135305615315,22,6,16,3.70118600815871,18.2988139918413
"1980","oh please",1.50135305615315,22,6,16,3.70118600815871,18.2988139918413
"1980","see wont",1.50135305615315,22,6,16,3.70118600815871,18.2988139918413
"1980","time lets",1.50135305615315,22,6,16,3.70118600815871,18.2988139918413
"1980","want right",1.50135305615315,22,6,16,3.70118600815871,18.2988139918413
"1980","yes know",1.50135305615315,22,6,16,3.70118600815871,18.2988139918413
"1980","youre giving",1.50135305615315,22,6,16,3.70118600815871,18.2988139918413
"1980","youre taking",1.50135305615315,22,6,16,3.70118600815871,18.2988139918413
"1980","want hold",1.50004729599526,46,11,35,7.73884347160458,38.2611565283954
"1970","oh just",1.49703441914909,87,16,71,11.9057665903495,75.0942334096505
"2010","command",1.49652029634371,29,7,22,4.46491899537523,24.5350810046248
"2010","flashing",1.49652029634371,29,7,22,4.46491899537523,24.5350810046248
"2010","go yeah",1.49652029634371,29,7,22,4.46491899537523,24.5350810046248
"2010","got everything",1.49652029634371,29,7,22,4.46491899537523,24.5350810046248
"2010","like lady",1.49652029634371,29,7,22,4.46491899537523,24.5350810046248
"2010","man aint",1.49652029634371,29,7,22,4.46491899537523,24.5350810046248
"2010","now dont know",1.49652029634371,29,7,22,4.46491899537523,24.5350810046248
"2010","shooting",1.49652029634371,29,7,22,4.46491899537523,24.5350810046248
"2010","sure know",1.49652029634371,29,7,22,4.46491899537523,24.5350810046248
"2010","tell truth",1.49652029634371,29,7,22,4.46491899537523,24.5350810046248
"1980","careful",1.49635519458241,56,13,43,9.42120074804036,46.5787992519596
"1980","meaning byamandah",1.49635519458241,56,13,43,9.42120074804036,46.5787992519596
"1980","meaning byamandah editor",1.49635519458241,56,13,43,9.42120074804036,46.5787992519596
"2010","time life",1.49495106898303,61,13,48,9.39172616268583,51.6082738373142
"1980","north",1.49477684536404,51,12,39,8.58002210982247,42.4199778901775
"1990","cause wont",1.492949110993,33,10,23,7.00077496567454,25.9992250343255
"1990","los",1.492949110993,33,10,23,7.00077496567454,25.9992250343255
"1990","need friend",1.492949110993,33,10,23,7.00077496567454,25.9992250343255
"1990","trying make",1.492949110993,33,10,23,7.00077496567454,25.9992250343255
"1990","youso",1.492949110993,33,10,23,7.00077496567454,25.9992250343255
"1980","oh oh oh",1.49166693523787,1867,334,1533,314.09610351056,1552.90389648944
"2000","paint",1.48988207426758,52,18,34,13.992455735048,38.007544264952
"2000","sheets",1.48988207426758,52,18,34,13.992455735048,38.007544264952
"1990","barely",1.48321571031424,53,15,38,11.2436688842652,41.7563311157348
"1990","destiny",1.48321571031424,53,15,38,11.2436688842652,41.7563311157348
"1990","drive crazy",1.48321571031424,53,15,38,11.2436688842652,41.7563311157348
"1990","good baby",1.48321571031424,53,15,38,11.2436688842652,41.7563311157348
"1990","limit",1.48321571031424,53,15,38,11.2436688842652,41.7563311157348
"2000","outside",1.4815389898668,205,63,142,55.1625658785548,149.837434121445
"1980","every single",1.48137308768499,92,20,72,15.4776869432092,76.5223130567908
"1990","time",1.48130955934914,5176,1134,4042,1098.06094613126,4077.93905386874
"2010","big fat",1.47935707256129,24,6,18,3.69510537548295,20.3048946245171
"2010","disagree",1.47935707256129,24,6,18,3.69510537548295,20.3048946245171
"2010","ever made",1.47935707256129,24,6,18,3.69510537548295,20.3048946245171
"2010","eyes just",1.47935707256129,24,6,18,3.69510537548295,20.3048946245171
"2010","gon make",1.47935707256129,24,6,18,3.69510537548295,20.3048946245171
"2010","got somebody",1.47935707256129,24,6,18,3.69510537548295,20.3048946245171
"2010","hear im",1.47935707256129,24,6,18,3.69510537548295,20.3048946245171
"2010","heart open",1.47935707256129,24,6,18,3.69510537548295,20.3048946245171
"2010","help girl",1.47935707256129,24,6,18,3.69510537548295,20.3048946245171
"2010","many ways",1.47935707256129,24,6,18,3.69510537548295,20.3048946245171
"2010","night well",1.47935707256129,24,6,18,3.69510537548295,20.3048946245171
"2010","smile like",1.47935707256129,24,6,18,3.69510537548295,20.3048946245171
"2000","workin",1.478968107232,102,33,69,27.4467400956712,74.5532599043289
"1980","ive seen",1.47759392607824,113,24,89,19.0106372237243,93.9893627762757
"1990","aint love",1.47642121804923,37,11,26,7.84935374939267,29.1506462506073
"1990","ill never let",1.47642121804923,37,11,26,7.84935374939267,29.1506462506073
"1990","im still love",1.47642121804923,37,11,26,7.84935374939267,29.1506462506073
"1990","need time",1.47642121804923,37,11,26,7.84935374939267,29.1506462506073
"1990","new day",1.47642121804923,37,11,26,7.84935374939267,29.1506462506073
"1990","want feel",1.47642121804923,37,11,26,7.84935374939267,29.1506462506073
"1990","bent",1.46925743929661,41,12,29,8.6979325331108,32.3020674668892
"1990","beyond",1.46925743929661,41,12,29,8.6979325331108,32.3020674668892
"1990","clown",1.46925743929661,41,12,29,8.6979325331108,32.3020674668892
"1990","im alive",1.46925743929661,41,12,29,8.6979325331108,32.3020674668892
"1990","kiss like",1.46925743929661,41,12,29,8.6979325331108,32.3020674668892
"2010","know im",1.46923292888588,580,100,480,89.2983799075046,490.701620092495
"1990","tells",1.46902456865776,45,13,32,9.54651131682892,35.4534886831711
"1990","wise",1.46902456865776,45,13,32,9.54651131682892,35.4534886831711
"1960","like baby",1.46508749986177,86,8,78,5.13620151178716,80.8637984882128
"1960","time dont",1.46508749986177,86,8,78,5.13620151178716,80.8637984882128
"1990","worth",1.46495110014818,272,66,206,57.7033572928326,214.296642707167
"1990","aint nobody",1.45957369734274,82,22,60,17.3958650662216,64.6041349337784
"1990","short",1.459105976952,120,31,89,25.4573635115438,94.5426364884562
"2000","like make",1.45803040769241,36,13,23,9.68708473964864,26.3129152603514
"2000","police",1.45803040769241,36,13,23,9.68708473964864,26.3129152603514
"2000","things said",1.45803040769241,36,13,23,9.68708473964864,26.3129152603514
"1970","earth",1.45741406079457,132,23,109,18.0639217232889,113.936078276711
"1980","youre going",1.45654772756254,87,19,68,14.6365083049913,72.3634916950087
"2000","got man",1.45629705260851,62,21,41,16.6833126071727,45.3166873928273
"1990","warm",1.45327631207622,237,58,179,50.278292935299,186.721707064701
"2010","singin",1.45282076887401,135,26,109,20.7849677370916,114.215032262908
"1970","great",1.45273023109925,145,25,120,19.8429443172492,125.157055682751
"2000","baby know",1.45190563903872,181,56,125,48.7045093854557,132.295490614544
"1960","passed",1.45125809182608,73,7,66,4.3597989576798,68.6402010423202
"2010","saturday night",1.45076736380531,45,10,35,6.92832257903053,38.0716774209695
"1980","dont believe",1.44805784025621,108,23,85,18.1694585855064,89.8305414144936
"1960","guys",1.44664251025722,127,11,116,7.58485572089499,119.415144279105
"2010","one im",1.44614864634369,78,16,62,12.0090924703196,65.9909075296804
"2000","choice",1.44484780509755,72,24,48,19.3741694792973,52.6258305207027
"1960","joy",1.44469138425026,169,14,155,10.0932332033957,158.906766796604
"2000","cause dont",1.44366768097058,188,58,130,50.5881091959429,137.411890804057
"1970","away yeah",1.44339086231434,27,6,21,3.69489307976364,23.3051069202364
"1970","destination",1.44339086231434,27,6,21,3.69489307976364,23.3051069202364
"1970","dudes",1.44339086231434,27,6,21,3.69489307976364,23.3051069202364
"1970","hold baby",1.44339086231434,27,6,21,3.69489307976364,23.3051069202364
"1970","im crying",1.44339086231434,27,6,21,3.69489307976364,23.3051069202364
"1970","intentions",1.44339086231434,27,6,21,3.69489307976364,23.3051069202364
"1970","ride train",1.44339086231434,27,6,21,3.69489307976364,23.3051069202364
"1970","say cause",1.44339086231434,27,6,21,3.69489307976364,23.3051069202364
"1970","say wont",1.44339086231434,27,6,21,3.69489307976364,23.3051069202364
"1970","tell cant",1.44339086231434,27,6,21,3.69489307976364,23.3051069202364
"1970","world see",1.44339086231434,27,6,21,3.69489307976364,23.3051069202364
"1990","hit",1.44100451146356,765,176,589,162.290692386092,602.709307613908
"1960","mountain",1.43978743993086,141,12,129,8.42098154839523,132.579018451605
"1960","means",1.43967248799477,155,13,142,9.25710737589546,145.742892624105
"2010","got feeling",1.43640287608603,95,19,76,14.6264587779533,80.3735412220467
"1980","laughing",1.4328647410953,82,18,64,13.7953296667734,68.2046703332266
"1980","woah",1.4328647410953,82,18,64,13.7953296667734,68.2046703332266
"1990","rock roll",1.43203815244521,99,26,73,21.0023248970236,77.9976751029764
"2000","guess im",1.43200510917962,49,17,32,13.1851986734107,35.8148013265894
"2000","love keep",1.43200510917962,49,17,32,13.1851986734107,35.8148013265894
"2000","piece",1.43179538049245,157,49,108,42.2464528923566,114.753547107643
"1990","known",1.43155248701985,211,52,159,44.7625308411312,166.237469158869
"1960","found",1.42804615251047,723,51,672,43.1799266630479,679.820073336952
"2010","youre alone",1.42732732879786,67,14,53,10.3155025065566,56.6844974934434
"2010","heels",1.42501578759696,56,12,44,8.62191254279355,47.3780874572064
"2010","nothing left",1.42501578759696,56,12,44,8.62191254279355,47.3780874572064
"2010","now ill",1.42501578759696,56,12,44,8.62191254279355,47.3780874572064
"1990","grab",1.42474779737048,146,37,109,30.9731256057116,115.026874394288
"1970","know love",1.4243760257857,318,51,267,43.5176296061051,274.482370393895
"1980","wonder",1.42244211943916,493,93,400,82.9402137282839,410.059786271716
"2010","cause dont",1.42003209294286,188,35,153,28.9449921079498,159.05500789205
"1980","around baby",1.41853844926161,27,7,20,4.5423646463766,22.4576353536234
"1980","bitter",1.41853844926161,27,7,20,4.5423646463766,22.4576353536234
"1980","can anything",1.41853844926161,27,7,20,4.5423646463766,22.4576353536234
"1980","care dont",1.41853844926161,27,7,20,4.5423646463766,22.4576353536234
"1980","enough know",1.41853844926161,27,7,20,4.5423646463766,22.4576353536234
"1980","ever know",1.41853844926161,27,7,20,4.5423646463766,22.4576353536234
"1980","every man",1.41853844926161,27,7,20,4.5423646463766,22.4576353536234
"1980","gonna right",1.41853844926161,27,7,20,4.5423646463766,22.4576353536234
"1980","heart beating",1.41853844926161,27,7,20,4.5423646463766,22.4576353536234
"1980","offer",1.41853844926161,27,7,20,4.5423646463766,22.4576353536234
"1980","please baby",1.41853844926161,27,7,20,4.5423646463766,22.4576353536234
"1980","stories",1.41853844926161,27,7,20,4.5423646463766,22.4576353536234
"1980","swear ill",1.41853844926161,27,7,20,4.5423646463766,22.4576353536234
"1980","whats gonna",1.41853844926161,27,7,20,4.5423646463766,22.4576353536234
"1980","years ago",1.41853844926161,27,7,20,4.5423646463766,22.4576353536234
"1990","black",1.41745899131791,428,101,327,90.7979298578395,337.20207014216
"1970","slowly",1.41726980209331,126,22,104,17.2428343722303,108.75716562777
"1990","away lets",1.41391037754134,18,6,12,3.81860452673157,14.1813954732684
"1990","boulevard",1.41391037754134,18,6,12,3.81860452673157,14.1813954732684
"1990","cracks",1.41391037754134,18,6,12,3.81860452673157,14.1813954732684
"1990","deceive",1.41391037754134,18,6,12,3.81860452673157,14.1813954732684
"1990","feel feel feel",1.41391037754134,18,6,12,3.81860452673157,14.1813954732684
"1990","give wont",1.41391037754134,18,6,12,3.81860452673157,14.1813954732684
"1990","ill never get",1.41391037754134,18,6,12,3.81860452673157,14.1813954732684
"1990","inside youre",1.41391037754134,18,6,12,3.81860452673157,14.1813954732684
"1990","know please",1.41391037754134,18,6,12,3.81860452673157,14.1813954732684
"1990","know still",1.41391037754134,18,6,12,3.81860452673157,14.1813954732684
"1990","know want want",1.41391037754134,18,6,12,3.81860452673157,14.1813954732684
"1990","leave cause",1.41391037754134,18,6,12,3.81860452673157,14.1813954732684
"1990","let mind",1.41391037754134,18,6,12,3.81860452673157,14.1813954732684
"1990","live learn",1.41391037754134,18,6,12,3.81860452673157,14.1813954732684
"1990","love believe",1.41391037754134,18,6,12,3.81860452673157,14.1813954732684
"1990","lover ill",1.41391037754134,18,6,12,3.81860452673157,14.1813954732684
"1990","much long",1.41391037754134,18,6,12,3.81860452673157,14.1813954732684
"1990","playground",1.41391037754134,18,6,12,3.81860452673157,14.1813954732684
"1990","somebody dont",1.41391037754134,18,6,12,3.81860452673157,14.1813954732684
"1990","sooner",1.41391037754134,18,6,12,3.81860452673157,14.1813954732684
"1990","soy",1.41391037754134,18,6,12,3.81860452673157,14.1813954732684
"1990","spots",1.41391037754134,18,6,12,3.81860452673157,14.1813954732684
"1990","stay side",1.41391037754134,18,6,12,3.81860452673157,14.1813954732684
"1990","thats ever",1.41391037754134,18,6,12,3.81860452673157,14.1813954732684
"1990","things need",1.41391037754134,18,6,12,3.81860452673157,14.1813954732684
"1990","time give",1.41391037754134,18,6,12,3.81860452673157,14.1813954732684
"1990","tommy",1.41391037754134,18,6,12,3.81860452673157,14.1813954732684
"1990","veins",1.41391037754134,18,6,12,3.81860452673157,14.1813954732684
"1990","youre going way",1.41391037754134,18,6,12,3.81860452673157,14.1813954732684
"1990","youre running",1.41391037754134,18,6,12,3.81860452673157,14.1813954732684
"1980","heartbeat",1.41054161417704,77,17,60,12.9541510285555,64.0458489714445
"1980","night day",1.41054161417704,77,17,60,12.9541510285555,64.0458489714445
"1970","done",1.41043645137234,605,93,512,82.7929745650742,522.207025434926
"2000","everywhere go",1.40889267065164,33,12,21,8.87982767801125,24.1201723219887
"2000","now lets",1.40889267065164,33,12,21,8.87982767801125,24.1201723219887
"1990","cant",1.40757331637056,5338,1168,4170,1132.42838687184,4205.57161312816
"1960","realize",1.40631501893552,184,15,169,10.9890823042888,173.010917695711
"1990","shoot",1.40256742064762,95,25,70,20.1537461133055,74.8462538866945
"1960","love come",1.40129242005735,114,10,104,6.80845316678763,107.191546833212
"2000","say hey",1.40039102242484,89,29,60,23.9486261619091,65.0513738380909
"1960","cant get",1.39894259490051,330,25,305,19.7086802196484,310.291319780352
"2000","thinks",1.39650290181209,59,20,39,15.8760555455353,43.1239444544647
"1990","nasty",1.39635881782922,112,29,83,23.7602059441075,88.2397940558925
"1960","oh night",1.39415564985007,87,8,79,5.19592478518003,81.80407521482
"1960","see youre",1.39415564985007,87,8,79,5.19592478518003,81.80407521482
"1970","ready",1.39345356348873,571,88,483,78.1401462424089,492.859853757591
"1970","brighter",1.39300810013532,63,12,51,8.62141718611517,54.3785828138848
"2010","coke",1.3915936332555,40,9,31,6.15850895913825,33.8414910408617
"2010","ears",1.3915936332555,40,9,31,6.15850895913825,33.8414910408617
"2010","goes around comes",1.3915936332555,40,9,31,6.15850895913825,33.8414910408617
"1970","boy got",1.39120259873936,33,7,26,4.51598043082223,28.4840195691778
"1970","cant hide",1.39120259873936,33,7,26,4.51598043082223,28.4840195691778
"1970","im beggin",1.39120259873936,33,7,26,4.51598043082223,28.4840195691778
"1970","keep us",1.39120259873936,33,7,26,4.51598043082223,28.4840195691778
"1970","load",1.39120259873936,33,7,26,4.51598043082223,28.4840195691778
"1970","melt",1.39120259873936,33,7,26,4.51598043082223,28.4840195691778
"1970","sets",1.39120259873936,33,7,26,4.51598043082223,28.4840195691778
"1970","way used",1.39120259873936,33,7,26,4.51598043082223,28.4840195691778
"1970","way wanna",1.39120259873936,33,7,26,4.51598043082223,28.4840195691778
"1970","well together",1.39120259873936,33,7,26,4.51598043082223,28.4840195691778
"1970","won",1.39120259873936,33,7,26,4.51598043082223,28.4840195691778
"1990","baby can",1.39091138478874,194,48,146,41.1560710103291,152.843928989671
"1970","youre one",1.38775490651213,285,46,239,39.0016491752829,245.998350824717
"2000","seat",1.38758225724299,79,26,53,21.2577692897845,57.7422307102155
"1970","way back",1.38747501197412,88,16,72,12.0426144821926,75.9573855178074
"1990","take time",1.38518242468744,155,39,116,32.8824278690774,122.117572130923
"1990","difference",1.3850214939128,70,19,51,14.8501287150672,55.1498712849328
"2000","friend",1.37750139110796,649,188,461,174.636611000888,474.363388999112
"2010","house",1.37516325442753,417,73,344,64.2024558990163,352.797544100984
"2000","im losing",1.37442937968482,46,16,30,12.3779416117733,33.6220583882267
"2000","life like",1.37442937968482,46,16,30,12.3779416117733,33.6220583882267
"2000","theres way",1.37442937968482,46,16,30,12.3779416117733,33.6220583882267
"1990","beg",1.3733979635725,91,24,67,19.3051673295874,71.6948326704126
"2010","truth",1.37301248385824,302,54,248,46.4967426414938,255.503257358506
"1960","gonna tell",1.37147079667984,61,6,55,3.64311967696531,57.3568803230347
"1960","looks like",1.37147079667984,61,6,55,3.64311967696531,57.3568803230347
"1960","love get",1.37147079667984,61,6,55,3.64311967696531,57.3568803230347
"1960","named",1.37147079667984,61,6,55,3.64311967696531,57.3568803230347
"1960","oh lord",1.37147079667984,61,6,55,3.64311967696531,57.3568803230347
"1980","cant cant cant",1.37067485200957,32,8,24,5.38354328459449,26.6164567154055
"1980","choke",1.37067485200957,32,8,24,5.38354328459449,26.6164567154055
"1980","dream come true",1.37067485200957,32,8,24,5.38354328459449,26.6164567154055
"1980","heart love",1.37067485200957,32,8,24,5.38354328459449,26.6164567154055
"1980","soldiers",1.37067485200957,32,8,24,5.38354328459449,26.6164567154055
"1980","time cant",1.37067485200957,32,8,24,5.38354328459449,26.6164567154055
"2000","thats",1.36921946159189,2727,761,1966,733.796669028385,1993.20333097162
"1990","dreams",1.3684672174331,640,148,492,135.7726053949,504.2273946051
"1970","broadway",1.36681651868754,39,8,31,5.33706778188082,33.6629322181192
"1970","purple",1.36681651868754,39,8,31,5.33706778188082,33.6629322181192
"1970","thing called",1.36681651868754,39,8,31,5.33706778188082,33.6629322181192
"2000","mean",1.36645564906553,746,215,531,200.737922660497,545.262077339503
"1970","best thing",1.36357832401228,51,10,41,6.97924248399799,44.020757516002
"1980","fight",1.36211361994067,483,91,392,81.2578564518481,401.742143548152
"2000","chocolate",1.36193705665518,30,11,19,8.07257061637387,21.9274293836261
"2000","clap hands",1.36193705665518,30,11,19,8.07257061637387,21.9274293836261
"2000","girl baby",1.36193705665518,30,11,19,8.07257061637387,21.9274293836261
"2000","one know",1.36193705665518,30,11,19,8.07257061637387,21.9274293836261
"2000","really know",1.36193705665518,30,11,19,8.07257061637387,21.9274293836261
"2000","shouldnt",1.36135032540527,96,31,65,25.8322259723964,70.1677740276036
"1960","love wont",1.36031358007409,101,9,92,6.03205061268027,94.9679493873197
"1960","woke",1.36031358007409,101,9,92,6.03205061268027,94.9679493873197
"1970","got make",1.35954943361453,45,9,36,6.15815513293941,38.8418448670606
"1970","tells",1.35954943361453,45,9,36,6.15815513293941,38.8418448670606
"1970","whoo",1.35954943361453,45,9,36,6.15815513293941,38.8418448670606
"2010","let see",1.35893337897949,177,33,144,27.2514021441868,149.748597855813
"2010","time im",1.35893337897949,177,33,144,27.2514021441868,149.748597855813
"2010","livin life",1.35617117625768,51,11,40,7.85209892290127,43.1479010770987
"1970","aint nobody",1.35494061006384,82,15,67,11.221527131134,70.778472868866
"1970","laughing",1.35494061006384,82,15,67,11.221527131134,70.778472868866
"2010","let hold",1.35437463793033,62,13,49,9.54568888666429,52.4543111133357
"2010","now youre",1.35080038559046,183,34,149,28.1751784880575,154.824821511943
"2010","mirror",1.34524039537928,142,27,115,21.8627068049408,120.137293195059
"1990","youre going",1.34457085154795,87,23,64,18.4565885458693,68.5434114541307
"1980","believe just",1.34412145685603,37,9,28,6.22472192281238,30.7752780771876
"1980","never ends",1.34412145685603,37,9,28,6.22472192281238,30.7752780771876
"2010","hair",1.34373295784607,369,65,304,56.8122451480504,312.18775485195
"1980","blows",1.34179026854131,57,13,44,9.58943647568394,47.4105635243161
"1980","go just",1.34179026854131,57,13,44,9.58943647568394,47.4105635243161
"1980","groovin",1.34179026854131,57,13,44,9.58943647568394,47.4105635243161
"1980","love aint",1.34179026854131,57,13,44,9.58943647568394,47.4105635243161
"1980","thats love",1.34179026854131,57,13,44,9.58943647568394,47.4105635243161
"1980","valley",1.34179026854131,57,13,44,9.58943647568394,47.4105635243161
"1960","stronger",1.3416777561987,115,10,105,6.8681764401805,108.131823559819
"2010","real",1.3414922621299,1354,224,1130,208.46552826683,1145.53447173317
"1990","attraction",1.33841900811112,22,7,15,4.6671833104497,17.3328166895503
"1990","can live",1.33841900811112,22,7,15,4.6671833104497,17.3328166895503
"1990","disrespect",1.33841900811112,22,7,15,4.6671833104497,17.3328166895503
"1990","every time touch",1.33841900811112,22,7,15,4.6671833104497,17.3328166895503
"1990","fiend",1.33841900811112,22,7,15,4.6671833104497,17.3328166895503
"1990","gotta leave",1.33841900811112,22,7,15,4.6671833104497,17.3328166895503
"1990","look tell",1.33841900811112,22,7,15,4.6671833104497,17.3328166895503
"1990","love loves",1.33841900811112,22,7,15,4.6671833104497,17.3328166895503
"1990","mad cause",1.33841900811112,22,7,15,4.6671833104497,17.3328166895503
"1990","one step",1.33841900811112,22,7,15,4.6671833104497,17.3328166895503
"1990","riches",1.33841900811112,22,7,15,4.6671833104497,17.3328166895503
"1990","tear roof",1.33841900811112,22,7,15,4.6671833104497,17.3328166895503
"1990","time touch",1.33841900811112,22,7,15,4.6671833104497,17.3328166895503
"1990","tonight night",1.33841900811112,22,7,15,4.6671833104497,17.3328166895503
"1990","turn right",1.33841900811112,22,7,15,4.6671833104497,17.3328166895503
"1990","way hold",1.33841900811112,22,7,15,4.6671833104497,17.3328166895503
"1990","way keep",1.33841900811112,22,7,15,4.6671833104497,17.3328166895503
"1990","yes know",1.33841900811112,22,7,15,4.6671833104497,17.3328166895503
"1990","youdont",1.33841900811112,22,7,15,4.6671833104497,17.3328166895503
"2010","ringin",1.33696763233675,35,8,27,5.38869533924597,29.611304660754
"1980","dont take",1.33534316536733,88,19,69,14.8047440326349,73.1952559673651
"1980","way back",1.33534316536733,88,19,69,14.8047440326349,73.1952559673651
"2000","one else",1.33490102873705,120,38,82,32.2902824654955,87.7097175345045
"1980","give",1.33470444759194,3148,554,2594,529.606070621983,2618.39392937802
"1980","ago",1.33337992954002,125,26,99,21.0294659554472,103.970534044553
"1980","beginning",1.3326049913796,52,12,40,8.74825783746605,43.251742162534
"1980","life ive",1.3326049913796,52,12,40,8.74825783746605,43.251742162534
"1980","never go",1.3326049913796,52,12,40,8.74825783746605,43.251742162534
"1980","shoulders",1.3326049913796,52,12,40,8.74825783746605,43.251742162534
"1990","meant",1.33198937349438,318,76,242,67.4620133055911,250.537986694409
"1980","cant fight",1.33153165697771,42,10,32,7.06590056103027,34.9340994389697
"1980","cruise",1.33153165697771,42,10,32,7.06590056103027,34.9340994389697
"1980","love somebody",1.33153165697771,42,10,32,7.06590056103027,34.9340994389697
"1980","want oh",1.33153165697771,42,10,32,7.06590056103027,34.9340994389697
"1970","lovely",1.3294856017046,127,22,105,17.3796822640734,109.620317735927
"1980","row",1.32859288642776,47,11,36,7.90707919924816,39.0929208007518
"1980","wanna hold",1.32859288642776,47,11,36,7.90707919924816,39.0929208007518
"1980","want ill",1.32859288642776,47,11,36,7.90707919924816,39.0929208007518
"2000","married",1.3276311895114,76,25,51,20.4505122281471,55.5494877718529
"2010","deal",1.32711047802004,96,19,77,14.7804215019318,81.2195784980682
"1960","dont take",1.32555191968444,88,8,80,5.25564805857291,82.7443519414271
"1960","dreamin",1.32555191968444,88,8,80,5.25564805857291,82.7443519414271
"1960","never let go",1.32555191968444,88,8,80,5.25564805857291,82.7443519414271
"2010","storm",1.32466041758318,79,16,63,12.163055194298,66.8369448057019
"2000","love girl",1.32434084693627,151,47,104,40.6319387690818,110.368061230918
"1990","gives",1.32030225906321,58,16,42,12.3043923639128,45.6956076360872
"1990","now come",1.32030225906321,58,16,42,12.3043923639128,45.6956076360872
"1970","now now",1.31895804439299,95,17,78,13.0005497250943,81.9994502749057
"2000","dogs",1.31788053840616,27,10,17,7.26531355473648,19.7346864452635
"2000","dont fight",1.31788053840616,27,10,17,7.26531355473648,19.7346864452635
"2000","every man",1.31788053840616,27,10,17,7.26531355473648,19.7346864452635
"2000","night baby",1.31788053840616,27,10,17,7.26531355473648,19.7346864452635
"2000","now wish",1.31788053840616,27,10,17,7.26531355473648,19.7346864452635
"2000","told ya",1.31788053840616,27,10,17,7.26531355473648,19.7346864452635
"2000","video",1.31788053840616,27,10,17,7.26531355473648,19.7346864452635
"2000","pound",1.31721749686265,43,15,28,11.5706845501359,31.4293154498641
"2000","theres need",1.31721749686265,43,15,28,11.5706845501359,31.4293154498641
"2000","waking",1.31721749686265,43,15,28,11.5706845501359,31.4293154498641
"1990","cat",1.31613497745954,83,22,61,17.6080097621511,65.3919902378489
"1990","yeah just",1.31613497745954,83,22,61,17.6080097621511,65.3919902378489
"1980","breaking",1.31486876103219,152,31,121,25.5718306018238,126.428169398176
"2000","really",1.31129122097031,1880,528,1352,505.881091959429,1374.11890804057
"1980","im gonna make",1.30945732723921,104,22,82,17.4965156749321,86.5034843250679
"1990","baby will",1.30202343732725,54,15,39,11.4558135801947,42.5441864198053
"1990","couldnt see",1.30202343732725,54,15,39,11.4558135801947,42.5441864198053
"1980","born",1.3007075225168,300,58,242,50.4707182930734,249.529281706927
"1960","mother",1.30008753818477,172,14,158,10.2724030235743,161.727596976426
"1960","search",1.30006565364591,75,7,68,4.47924550446555,70.5207544955345
"1970","says",1.29964317991921,361,57,304,49.4020889553584,311.597911044642
"2010","life oh",1.29804875402403,102,20,82,15.7041978458025,86.2958021541975
"1960","man im",1.29777373556887,102,9,93,6.09177388607314,95.9082261139269
"2010","feel love",1.29680833336432,68,14,54,10.469465230535,57.530534769465
"2000","eat",1.29638043765285,172,53,119,46.2827382005435,125.717261799456
"1990","dial",1.2950852099403,26,8,18,5.51576209416782,20.4842379058322
"1990","driving crazy",1.2950852099403,26,8,18,5.51576209416782,20.4842379058322
"1990","get can",1.2950852099403,26,8,18,5.51576209416782,20.4842379058322
"1990","get wrong",1.2950852099403,26,8,18,5.51576209416782,20.4842379058322
"1990","girl youve",1.2950852099403,26,8,18,5.51576209416782,20.4842379058322
"1990","got head",1.2950852099403,26,8,18,5.51576209416782,20.4842379058322
"1990","invisible",1.2950852099403,26,8,18,5.51576209416782,20.4842379058322
"1990","movies",1.2950852099403,26,8,18,5.51576209416782,20.4842379058322
"1990","nails",1.2950852099403,26,8,18,5.51576209416782,20.4842379058322
"1990","ordinary",1.2950852099403,26,8,18,5.51576209416782,20.4842379058322
"1990","rain rain",1.2950852099403,26,8,18,5.51576209416782,20.4842379058322
"1970","make cry",1.29494610975816,70,13,57,9.57935242901686,60.4206475709831
"1980","west",1.29393365934155,212,42,170,35.6659742604385,176.334025739561
"2010","home",1.29238221297464,1475,243,1232,227.095017868223,1247.90498213178
"1970","nice",1.29183134858425,233,38,195,31.8855587994418,201.114441200558
"1960","busy",1.28931958106685,62,6,56,3.70284295035818,58.2971570496418
"1960","gal",1.28931958106685,62,6,56,3.70284295035818,58.2971570496418
"1960","now see",1.28931958106685,62,6,56,3.70284295035818,58.2971570496418
"2010","ashamed",1.28908523851568,30,7,23,4.61888171935369,25.3811182806463
"2010","dont throw",1.28908523851568,30,7,23,4.61888171935369,25.3811182806463
"2010","floating",1.28908523851568,30,7,23,4.61888171935369,25.3811182806463
"2010","hold like",1.28908523851568,30,7,23,4.61888171935369,25.3811182806463
"2010","make want",1.28908523851568,30,7,23,4.61888171935369,25.3811182806463
"2010","take little",1.28908523851568,30,7,23,4.61888171935369,25.3811182806463
"2010","tone",1.28908523851568,30,7,23,4.61888171935369,25.3811182806463
"2010","youre leaving",1.28908523851568,30,7,23,4.61888171935369,25.3811182806463
"2010","want leave",1.28876594842912,46,10,36,7.08228530300899,38.917714696991
"1990","waited",1.2881490128822,79,21,58,16.759430978433,62.240569021567
"1990","say dont",1.28655062457397,143,36,107,30.336691517923,112.663308482077
"1990","attitude",1.286035890461,50,14,36,10.6072347964766,39.3927652035234
"1990","man dont",1.286035890461,50,14,36,10.6072347964766,39.3927652035234
"1990","mine baby",1.286035890461,50,14,36,10.6072347964766,39.3927652035234
"2010","just take",1.28520257334013,85,17,68,13.0868315381688,71.9131684618312
"1980","fears",1.28367598816023,78,17,61,13.1223867561991,64.8776132438009
"1970","sure",1.283143096171,560,86,474,76.6348194321348,483.365180567865
"2010","cause just",1.28188062902756,57,12,45,8.77587526677201,48.224124733228
"2010","signs",1.28188062902756,57,12,45,8.77587526677201,48.224124733228
"2010","youoh",1.28188062902756,57,12,45,8.77587526677201,48.224124733228
"2000","pocket",1.2816244579175,83,27,56,22.3341120386344,60.6658879613656
"2000","givin",1.28069439636453,193,59,134,51.9335376320052,141.066462367995
"1960","walk",1.27923664827676,994,68,926,59.3649337525167,934.635066247483
"2000","can wanna",1.27779331161659,24,9,15,6.45805649309909,17.5419435069009
"2000","cause now",1.27779331161659,24,9,15,6.45805649309909,17.5419435069009
"2000","go night",1.27779331161659,24,9,15,6.45805649309909,17.5419435069009
"2000","heart still",1.27779331161659,24,9,15,6.45805649309909,17.5419435069009
"2000","jay",1.27779331161659,24,9,15,6.45805649309909,17.5419435069009
"2000","known better",1.27779331161659,24,9,15,6.45805649309909,17.5419435069009
"2000","like theres",1.27779331161659,24,9,15,6.45805649309909,17.5419435069009
"2000","tripping",1.27779331161659,24,9,15,6.45805649309909,17.5419435069009
"1960","see",1.27718583190633,5264,334,4930,314.383311140088,4949.61668885991
"2000","dont call",1.27705269111501,53,18,35,14.2615414222605,38.7384585777395
"2000","im lost",1.27705269111501,53,18,35,14.2615414222605,38.7384585777395
"1960","lady",1.27628400694542,530,38,492,31.6533348982232,498.346665101777
"1990","loneliness",1.27292310911761,46,13,33,9.75865601275846,36.2413439872415
"1990","picked",1.27292310911761,46,13,33,9.75865601275846,36.2413439872415
"2010","feel good",1.27287107115025,137,26,111,21.0928931850485,115.907106814951
"2010","just keep",1.27287107115025,137,26,111,21.0928931850485,115.907106814951
"2010","never",1.2726030123592,4753,760,3993,731.784827069603,4021.2151729304
"1990","cant understand",1.27141751250618,30,9,21,6.36434087788595,23.6356591221141
"1990","girl baby",1.27141751250618,30,9,21,6.36434087788595,23.6356591221141
"1990","know youre gonna",1.27141751250618,30,9,21,6.36434087788595,23.6356591221141
"1990","life youre",1.27141751250618,30,9,21,6.36434087788595,23.6356591221141
"1990","one whos",1.27141751250618,30,9,21,6.36434087788595,23.6356591221141
"1990","take way",1.27141751250618,30,9,21,6.36434087788595,23.6356591221141
"1990","thats alright",1.27141751250618,30,9,21,6.36434087788595,23.6356591221141
"1980","stronger",1.26883262446612,115,24,91,19.3471086790115,95.6528913209885
"1970","minds",1.26840984666431,64,12,52,8.75826507795827,55.2417349220417
"1970","never love",1.26840984666431,64,12,52,8.75826507795827,55.2417349220417
"2000","missed",1.26770079397223,73,24,49,19.6432551665097,53.3567448334902
"2000","havin",1.26424182946037,63,21,42,16.9523982943851,46.0476017056149
"1990","make see",1.26348539428338,42,12,30,8.91007722904033,33.0899227709597
"1990","think ill",1.26348539428338,42,12,30,8.91007722904033,33.0899227709597
"1990","toe",1.26348539428338,42,12,30,8.91007722904033,33.0899227709597
"1990","whether",1.26348539428338,42,12,30,8.91007722904033,33.0899227709597
"1990","know youve",1.26068398230632,75,20,55,15.9108521947149,59.0891478052851
"1990","search",1.26068398230632,75,20,55,15.9108521947149,59.0891478052851
"1990","distant",1.26066407836485,34,10,24,7.21291966160408,26.7870803383959
"1990","ill anything",1.26066407836485,34,10,24,7.21291966160408,26.7870803383959
"1990","know feels",1.26066407836485,34,10,24,7.21291966160408,26.7870803383959
"1990","love alive",1.26066407836485,34,10,24,7.21291966160408,26.7870803383959
"1990","love first",1.26066407836485,34,10,24,7.21291966160408,26.7870803383959
"1990","morning light",1.26066407836485,34,10,24,7.21291966160408,26.7870803383959
"1990","need dont",1.26066407836485,34,10,24,7.21291966160408,26.7870803383959
"1990","undone",1.26066407836485,34,10,24,7.21291966160408,26.7870803383959
"2000","made feel",1.26045071921275,40,14,26,10.7634274884985,29.2365725115015
"2000","waist",1.26045071921275,40,14,26,10.7634274884985,29.2365725115015
"1960","im sure",1.25922107871144,89,8,81,5.31537133196578,83.6846286680342
"1990","can hold",1.25885106215585,38,11,27,8.0614984453222,29.9385015546778
"1990","dogg",1.25885106215585,38,11,27,8.0614984453222,29.9385015546778
"1990","gone away",1.25885106215585,38,11,27,8.0614984453222,29.9385015546778
"1990","loser",1.25885106215585,38,11,27,8.0614984453222,29.9385015546778
"1990","see sun",1.25885106215585,38,11,27,8.0614984453222,29.9385015546778
"1990","treasure",1.25885106215585,38,11,27,8.0614984453222,29.9385015546778
"2000","remind",1.25220226654739,162,50,112,43.5918813284189,118.408118671581
"2010","back go",1.25183132762627,25,6,19,3.84906809946141,21.1509319005386
"2010","beef",1.25183132762627,25,6,19,3.84906809946141,21.1509319005386
"2010","careless",1.25183132762627,25,6,19,3.84906809946141,21.1509319005386
"2010","chance take",1.25183132762627,25,6,19,3.84906809946141,21.1509319005386
"2010","fairy",1.25183132762627,25,6,19,3.84906809946141,21.1509319005386
"2010","going way",1.25183132762627,25,6,19,3.84906809946141,21.1509319005386
"2010","hear sound",1.25183132762627,25,6,19,3.84906809946141,21.1509319005386
"2010","hiphop",1.25183132762627,25,6,19,3.84906809946141,21.1509319005386
"2010","life oh oh",1.25183132762627,25,6,19,3.84906809946141,21.1509319005386
"2010","see now",1.25183132762627,25,6,19,3.84906809946141,21.1509319005386
"2010","thousand times",1.25183132762627,25,6,19,3.84906809946141,21.1509319005386
"2010","time cause",1.25183132762627,25,6,19,3.84906809946141,21.1509319005386
"2010","wayne",1.25183132762627,25,6,19,3.84906809946141,21.1509319005386
"2010","know well",1.25165418515805,91,18,73,14.0106078820395,76.9893921179605
"1970","needed",1.24972577102673,227,37,190,31.0644714483832,195.935528551617
"1980","candlelight",1.2493140670168,23,6,17,3.86942173580229,19.1305782641977
"1980","clearly",1.2493140670168,23,6,17,3.86942173580229,19.1305782641977
"1980","even try",1.2493140670168,23,6,17,3.86942173580229,19.1305782641977
"1980","go thats",1.2493140670168,23,6,17,3.86942173580229,19.1305782641977
"1980","goodbyes",1.2493140670168,23,6,17,3.86942173580229,19.1305782641977
"1980","ill remember",1.2493140670168,23,6,17,3.86942173580229,19.1305782641977
"1980","keep warm",1.2493140670168,23,6,17,3.86942173580229,19.1305782641977
"1980","killer",1.2493140670168,23,6,17,3.86942173580229,19.1305782641977
"1980","know youre going",1.2493140670168,23,6,17,3.86942173580229,19.1305782641977
"1980","love time",1.2493140670168,23,6,17,3.86942173580229,19.1305782641977
"1980","por",1.2493140670168,23,6,17,3.86942173580229,19.1305782641977
"1980","right left",1.2493140670168,23,6,17,3.86942173580229,19.1305782641977
"1980","stumble",1.2493140670168,23,6,17,3.86942173580229,19.1305782641977
"1980","tear us",1.2493140670168,23,6,17,3.86942173580229,19.1305782641977
"1980","theres somethin",1.2493140670168,23,6,17,3.86942173580229,19.1305782641977
"1980","thing want",1.2493140670168,23,6,17,3.86942173580229,19.1305782641977
"1980","traveled",1.2493140670168,23,6,17,3.86942173580229,19.1305782641977
"1980","mei",1.2490771824424,169,34,135,28.4318379717647,140.568162028235
"1980","forget",1.24832897930458,491,92,399,82.6037422729968,408.396257727003
"1970","go back",1.24794494778297,141,24,117,19.2955527498768,121.704447250123
"1970","theyll",1.24794494778297,141,24,117,19.2955527498768,121.704447250123
"1970","yeah just",1.24792186937381,83,15,68,11.3583750229771,71.6416249770229
"1970","around now",1.24538331676546,28,6,22,3.83174097160674,24.1682590283933
"1970","find youre",1.24538331676546,28,6,22,3.83174097160674,24.1682590283933
"1970","liar",1.24538331676546,28,6,22,3.83174097160674,24.1682590283933
"1970","see things",1.24538331676546,28,6,22,3.83174097160674,24.1682590283933
"1970","take night",1.24538331676546,28,6,22,3.83174097160674,24.1682590283933
"1970","thing called love",1.24538331676546,28,6,22,3.83174097160674,24.1682590283933
"1970","time girl",1.24538331676546,28,6,22,3.83174097160674,24.1682590283933
"1970","world around",1.24538331676546,28,6,22,3.83174097160674,24.1682590283933
"1970","world love",1.24538331676546,28,6,22,3.83174097160674,24.1682590283933
"1970","youll understand",1.24538331676546,28,6,22,3.83174097160674,24.1682590283933
"1970","human",1.24510554803895,58,11,47,7.93717772689968,50.0628222731003
"1970","right can",1.24510554803895,58,11,47,7.93717772689968,50.0628222731003
"1990","thank",1.24351859397566,244,59,185,51.7633058068057,192.236694193194
"2000","away tears",1.24334731804536,21,8,13,5.65079943146171,15.3492005685383
"2000","button",1.24334731804536,21,8,13,5.65079943146171,15.3492005685383
"2000","give reason",1.24334731804536,21,8,13,5.65079943146171,15.3492005685383
"2000","go slow",1.24334731804536,21,8,13,5.65079943146171,15.3492005685383
"2000","goose",1.24334731804536,21,8,13,5.65079943146171,15.3492005685383
"2000","head im",1.24334731804536,21,8,13,5.65079943146171,15.3492005685383
"2000","high low",1.24334731804536,21,8,13,5.65079943146171,15.3492005685383
"2000","homeboy",1.24334731804536,21,8,13,5.65079943146171,15.3492005685383
"2000","im king",1.24334731804536,21,8,13,5.65079943146171,15.3492005685383
"2000","leave im",1.24334731804536,21,8,13,5.65079943146171,15.3492005685383
"2000","night couldnt",1.24334731804536,21,8,13,5.65079943146171,15.3492005685383
"2000","quickly",1.24334731804536,21,8,13,5.65079943146171,15.3492005685383
"2000","smash",1.24334731804536,21,8,13,5.65079943146171,15.3492005685383
"2000","sneak",1.24334731804536,21,8,13,5.65079943146171,15.3492005685383
"2000","thats much",1.24334731804536,21,8,13,5.65079943146171,15.3492005685383
"2000","three four",1.24334731804536,21,8,13,5.65079943146171,15.3492005685383
"2000","timei",1.24334731804536,21,8,13,5.65079943146171,15.3492005685383
"2000","watching us",1.24334731804536,21,8,13,5.65079943146171,15.3492005685383
"2000","whoa yeah",1.24334731804536,21,8,13,5.65079943146171,15.3492005685383
"2000","turn",1.24264693236117,1733,487,1246,466.325495939197,1266.6745040608
"1990","say youre",1.24184853869946,92,24,68,19.5173120255169,72.4826879744831
"1990","yeahi",1.24184853869946,92,24,68,19.5173120255169,72.4826879744831
"1960","saw",1.23987928189092,425,31,394,25.3823911919714,399.617608808029
"1970","make love",1.23816717824963,254,41,213,34.7593645281469,219.240635471853
"1960","want go",1.23713152457981,103,9,94,6.15149715946602,96.848502840534
"1980","id never",1.23693294421801,68,15,53,11.4400294797633,56.5599705202367
"1980","blues",1.23684628650046,110,23,87,18.5059300407936,91.4940699592064
"1980","tell im",1.23684628650046,110,23,87,18.5059300407936,91.4940699592064
"2000","pretty",1.23203398514043,487,142,345,131.044729672469,355.955270327531
"1970","blind",1.22755245976056,214,35,179,29.285448854423,184.714551145577
"1990","every day",1.22747434969314,209,51,158,44.3382414492721,164.661758550728
"2010","call",1.22719877449805,1553,255,1298,239.104110338543,1313.89588966146
"1970","hall",1.2261132921214,52,10,42,7.11609037584109,44.8839096241589
"2010","dont afraid",1.2233153114314,41,9,32,6.31247168311671,34.6875283168833
"2010","hittin",1.2233153114314,41,9,32,6.31247168311671,34.6875283168833
"2010","kiss like",1.2233153114314,41,9,32,6.31247168311671,34.6875283168833
"2010","lets take",1.2233153114314,41,9,32,6.31247168311671,34.6875283168833
"2010","like bird",1.2233153114314,41,9,32,6.31247168311671,34.6875283168833
"2010","size",1.2233153114314,41,9,32,6.31247168311671,34.6875283168833
"1970","worlds",1.22122710953093,96,17,79,13.1373976169374,82.8626023830626
"2000","great",1.21797195457702,145,45,100,39.017424645807,105.982575354193
"2000","cant explain",1.21741314935554,50,17,33,13.4542843606231,36.5457156393769
"2000","alarm",1.21730954398045,18,7,11,4.84354236982432,13.1564576301757
"2000","babyim",1.21730954398045,18,7,11,4.84354236982432,13.1564576301757
"2000","better time",1.21730954398045,18,7,11,4.84354236982432,13.1564576301757
"2000","bombs",1.21730954398045,18,7,11,4.84354236982432,13.1564576301757
"2000","bring us",1.21730954398045,18,7,11,4.84354236982432,13.1564576301757
"2000","can fill",1.21730954398045,18,7,11,4.84354236982432,13.1564576301757
"2000","cant break",1.21730954398045,18,7,11,4.84354236982432,13.1564576301757
"2000","didnt come",1.21730954398045,18,7,11,4.84354236982432,13.1564576301757
"2000","dont really care",1.21730954398045,18,7,11,4.84354236982432,13.1564576301757
"2000","everything say",1.21730954398045,18,7,11,4.84354236982432,13.1564576301757
"2000","got whole",1.21730954398045,18,7,11,4.84354236982432,13.1564576301757
"2000","hot like",1.21730954398045,18,7,11,4.84354236982432,13.1564576301757
"2000","know just feel",1.21730954398045,18,7,11,4.84354236982432,13.1564576301757
"2000","leave girl",1.21730954398045,18,7,11,4.84354236982432,13.1564576301757
"2000","live learn",1.21730954398045,18,7,11,4.84354236982432,13.1564576301757
"2000","makes difference",1.21730954398045,18,7,11,4.84354236982432,13.1564576301757
"2000","neighbors",1.21730954398045,18,7,11,4.84354236982432,13.1564576301757
"2000","planes",1.21730954398045,18,7,11,4.84354236982432,13.1564576301757
"2000","rare",1.21730954398045,18,7,11,4.84354236982432,13.1564576301757
"2000","say im crazy",1.21730954398045,18,7,11,4.84354236982432,13.1564576301757
"2000","spots",1.21730954398045,18,7,11,4.84354236982432,13.1564576301757
"2000","sticky",1.21730954398045,18,7,11,4.84354236982432,13.1564576301757
"2000","success",1.21730954398045,18,7,11,4.84354236982432,13.1564576301757
"2000","time call",1.21730954398045,18,7,11,4.84354236982432,13.1564576301757
"2000","time give",1.21730954398045,18,7,11,4.84354236982432,13.1564576301757
"2000","wanna lonely",1.21730954398045,18,7,11,4.84354236982432,13.1564576301757
"2000","wanna wake",1.21730954398045,18,7,11,4.84354236982432,13.1564576301757
"2000","world tonight",1.21730954398045,18,7,11,4.84354236982432,13.1564576301757
"2000","ya need",1.21730954398045,18,7,11,4.84354236982432,13.1564576301757
"2000","youd love",1.21730954398045,18,7,11,4.84354236982432,13.1564576301757
"1970","deep heart",1.21668546539143,34,7,27,4.65282832266533,29.3471716773347
"1970","love oh oh",1.21668546539143,34,7,27,4.65282832266533,29.3471716773347
"1980","just let",1.21471846026663,164,33,131,27.5906593335468,136.409340666453
"1970","hot hot",1.21404063547737,77,14,63,10.5372876719185,66.4627123280815
"1970","night day",1.21404063547737,77,14,63,10.5372876719185,66.4627123280815
"1970","wheel",1.21404063547737,77,14,63,10.5372876719185,66.4627123280815
"2010","kiss",1.2131110047217,809,136,673,124.555843698571,684.444156301429
"1970","im thinkin",1.2130556994259,46,9,37,6.29500302478251,39.7049969752175
"1970","loneliness",1.2130556994259,46,9,37,6.29500302478251,39.7049969752175
"1970","passing",1.2130556994259,46,9,37,6.29500302478251,39.7049969752175
"1990","dry",1.21149622619862,88,23,65,18.6687332417988,69.3312667582012
"2010","disappear",1.20997584001961,52,11,41,8.00606164687973,43.9939383531203
"2010","puttin",1.20997584001961,52,11,41,8.00606164687973,43.9939383531203
"2010","rent",1.20997584001961,52,11,41,8.00606164687973,43.9939383531203
"2010","shoulders",1.20997584001961,52,11,41,8.00606164687973,43.9939383531203
"1970","affection",1.20848838543513,40,8,32,5.47391567372392,34.5260843262761
"1970","cause ill",1.20848838543513,40,8,32,5.47391567372392,34.5260843262761
"1970","using",1.20848838543513,40,8,32,5.47391567372392,34.5260843262761
"1970","way just",1.20848838543513,40,8,32,5.47391567372392,34.5260843262761
"1990","know way",1.20768439597188,67,18,49,14.2136946272786,52.7863053727214
"2000","air like",1.20461772797821,15,6,9,4.03628530818693,10.9637146918131
"2000","alone can",1.20461772797821,15,6,9,4.03628530818693,10.9637146918131
"2000","already got",1.20461772797821,15,6,9,4.03628530818693,10.9637146918131
"2000","baby mine",1.20461772797821,15,6,9,4.03628530818693,10.9637146918131
"2000","back thats",1.20461772797821,15,6,9,4.03628530818693,10.9637146918131
"2000","beam",1.20461772797821,15,6,9,4.03628530818693,10.9637146918131
"2000","boy big",1.20461772797821,15,6,9,4.03628530818693,10.9637146918131
"2000","break us",1.20461772797821,15,6,9,4.03628530818693,10.9637146918131
"2000","cali",1.20461772797821,15,6,9,4.03628530818693,10.9637146918131
"2000","can sweet",1.20461772797821,15,6,9,4.03628530818693,10.9637146918131
"2000","crazy like",1.20461772797821,15,6,9,4.03628530818693,10.9637146918131
"2000","curtains",1.20461772797821,15,6,9,4.03628530818693,10.9637146918131
"2000","dozen",1.20461772797821,15,6,9,4.03628530818693,10.9637146918131
"2000","engine",1.20461772797821,15,6,9,4.03628530818693,10.9637146918131
"2000","falling star",1.20461772797821,15,6,9,4.03628530818693,10.9637146918131
"2000","feds",1.20461772797821,15,6,9,4.03628530818693,10.9637146918131
"2000","first saw",1.20461772797821,15,6,9,4.03628530818693,10.9637146918131
"2000","game know",1.20461772797821,15,6,9,4.03628530818693,10.9637146918131
"2000","got hot",1.20461772797821,15,6,9,4.03628530818693,10.9637146918131
"2000","help sing",1.20461772797821,15,6,9,4.03628530818693,10.9637146918131
"2000","im gonna keep",1.20461772797821,15,6,9,4.03628530818693,10.9637146918131
"2000","jobs",1.20461772797821,15,6,9,4.03628530818693,10.9637146918131
"2000","just sit",1.20461772797821,15,6,9,4.03628530818693,10.9637146918131
"2000","leave em",1.20461772797821,15,6,9,4.03628530818693,10.9637146918131
"2000","lets lets lets",1.20461772797821,15,6,9,4.03628530818693,10.9637146918131
"2000","like whole",1.20461772797821,15,6,9,4.03628530818693,10.9637146918131
"2000","love still love",1.20461772797821,15,6,9,4.03628530818693,10.9637146918131
"2000","mattress",1.20461772797821,15,6,9,4.03628530818693,10.9637146918131
"2000","meive",1.20461772797821,15,6,9,4.03628530818693,10.9637146918131
"2000","mend broken heart",1.20461772797821,15,6,9,4.03628530818693,10.9637146918131
"2000","miles just",1.20461772797821,15,6,9,4.03628530818693,10.9637146918131
"2000","moneys",1.20461772797821,15,6,9,4.03628530818693,10.9637146918131
"2000","night everything",1.20461772797821,15,6,9,4.03628530818693,10.9637146918131
"2000","night one",1.20461772797821,15,6,9,4.03628530818693,10.9637146918131
"2000","ohif",1.20461772797821,15,6,9,4.03628530818693,10.9637146918131
"2000","peep",1.20461772797821,15,6,9,4.03628530818693,10.9637146918131
"2000","stay awake",1.20461772797821,15,6,9,4.03628530818693,10.9637146918131
"2000","time theres",1.20461772797821,15,6,9,4.03628530818693,10.9637146918131
"2000","touch love",1.20461772797821,15,6,9,4.03628530818693,10.9637146918131
"2000","wanted say",1.20461772797821,15,6,9,4.03628530818693,10.9637146918131
"2000","wont live",1.20461772797821,15,6,9,4.03628530818693,10.9637146918131
"2000","ya hands",1.20461772797821,15,6,9,4.03628530818693,10.9637146918131
"2000","yeahso",1.20461772797821,15,6,9,4.03628530818693,10.9637146918131
"2000","yes true",1.20461772797821,15,6,9,4.03628530818693,10.9637146918131
"2000","youevery",1.20461772797821,15,6,9,4.03628530818693,10.9637146918131
"2000","youoh oh",1.20461772797821,15,6,9,4.03628530818693,10.9637146918131
"2000","going home",1.20423645536416,37,13,24,9.9561704268611,27.0438295731389
"2000","oni",1.20423645536416,37,13,24,9.9561704268611,27.0438295731389
"2000","stopping",1.20423645536416,37,13,24,9.9561704268611,27.0438295731389
"2000","youre best",1.20423645536416,37,13,24,9.9561704268611,27.0438295731389
"2000","driving",1.20410969545843,121,38,83,32.5593681527079,88.4406318472921
"2000","boots",1.20403983758129,60,20,40,16.1451412327477,43.8548587672523
"1970","takes",1.20296875314508,363,57,306,49.6757847390446,313.324215260955
"2010","bought",1.20074994830245,132,25,107,20.3230795651562,111.676920434844
"1960","theyre",1.19940242559999,472,34,438,28.1893850414365,443.810614958564
"1980","baby youll",1.19934049550837,28,7,21,4.71060037402018,23.2893996259798
"1980","imagination",1.19934049550837,28,7,21,4.71060037402018,23.2893996259798
"1980","leave behind",1.19934049550837,28,7,21,4.71060037402018,23.2893996259798
"1980","like youve",1.19934049550837,28,7,21,4.71060037402018,23.2893996259798
"1980","want wanna",1.19934049550837,28,7,21,4.71060037402018,23.2893996259798
"2010","brought",1.19829914931892,103,20,83,15.858160569781,87.141839430219
"2010","ive never",1.19829914931892,103,20,83,15.858160569781,87.141839430219
"1980","direction",1.19759428241749,58,13,45,9.75767220332752,48.2423277966725
"1980","emotions",1.19759428241749,58,13,45,9.75767220332752,48.2423277966725
"1990","outside",1.19532363773334,205,50,155,43.489662665554,161.510337334446
"1980","oh oh oh oh",1.19250307660877,1291,232,1059,217.192324387859,1073.80767561214
"2000","thousand",1.18913376294016,173,53,120,46.551823887756,126.448176112244
"2000","whatcha",1.18913376294016,173,53,120,46.551823887756,126.448176112244
"1960","sometimes",1.18864345400231,442,32,410,26.3976868396503,415.60231316035
"1980","mine",1.18419570771723,1033,187,846,173.787506655816,859.212493344184
"1960","skin",1.18221961962035,146,12,134,8.71959791535959,137.28040208464
"1970","got something",1.1816108436942,71,13,58,9.71620032085995,61.2837996791401
"1970","written",1.1816108436942,71,13,58,9.71620032085995,61.2837996791401
"1990","silly",1.18138764298811,84,22,62,17.8201544580807,66.1798455419193
"2000","get back",1.17859813840905,215,65,150,57.8534227506794,157.146577249321
"1960","darkness",1.17834852989075,104,9,95,6.21122043285889,97.7887795671411
"2010","like baby",1.17621466927271,86,17,69,13.2407942621472,72.7592057378528
"1990","friends",1.17537516290707,762,174,588,161.654258298303,600.345741701697
"1960","ha ha ha",1.17465317601967,132,11,121,7.88347208785936,124.116527912141
"1980","need friend",1.17389337071332,33,8,25,5.55177901223807,27.4482209877619
"1980","go now",1.17359021264454,100,21,79,16.8235727643578,83.1764272356422
"1980","strength",1.17359021264454,100,21,79,16.8235727643578,83.1764272356422
"1960","broke",1.17287637956076,233,18,215,13.9155227005396,219.08447729946
"1980","said dont",1.17014477644871,48,11,37,8.07531492689174,39.9246850731083
"1980","time think",1.17014477644871,48,11,37,8.07531492689174,39.9246850731083
"1980","want tell",1.17014477644871,48,11,37,8.07531492689174,39.9246850731083
"1980","can",1.16968590593284,8122,1403,6719,1366.41057992114,6755.58942007886
"2000","waitin",1.16523822342962,142,44,98,38.2101675841696,103.78983241583
"1970","four",1.16406885891913,195,32,163,26.6853389094041,168.314661090596
"1980","gone away",1.16361683232768,38,9,29,6.39295765045596,31.607042349544
"1980","laughed",1.16361683232768,38,9,29,6.39295765045596,31.607042349544
"1980","mine oh",1.16361683232768,38,9,29,6.39295765045596,31.607042349544
"1980","need now",1.16361683232768,38,9,29,6.39295765045596,31.607042349544
"1980","wanna lover",1.16361683232768,38,9,29,6.39295765045596,31.607042349544
"1980","low get",1.16338333033976,43,10,33,7.23413628867385,35.7658637113261
"1980","stops",1.16338333033976,43,10,33,7.23413628867385,35.7658637113261
"1970","feels",1.16314669536391,446,69,377,61.0341597620217,384.965840237978
"2000","know id",1.16311423269755,77,25,52,20.7195979153596,56.2804020846404
"1990","felt",1.16192956874699,325,77,248,68.9470261770978,256.052973822902
"2010","cheap",1.16061389104424,36,8,28,5.54265806322443,30.4573419367756
"2010","crash",1.16061389104424,36,8,28,5.54265806322443,30.4573419367756
"2010","james",1.16061389104424,36,8,28,5.54265806322443,30.4573419367756
"2010","love go",1.16061389104424,36,8,28,5.54265806322443,30.4573419367756
"2010","now everybody",1.16061389104424,36,8,28,5.54265806322443,30.4573419367756
"2010","usa",1.16061389104424,36,8,28,5.54265806322443,30.4573419367756
"2010","want im",1.16061389104424,36,8,28,5.54265806322443,30.4573419367756
"1960","call baby",1.15985792972389,77,7,70,4.59869205125129,72.4013079487487
"1990","go cause",1.15811677593899,59,16,43,12.5165370598424,46.4834629401576
"1990","greatest",1.15811677593899,59,16,43,12.5165370598424,46.4834629401576
"1990","yeah dont",1.15811677593899,59,16,43,12.5165370598424,46.4834629401576
"2000","cops",1.15784516482971,47,16,31,12.6470272989857,34.3529727010143
"2000","time youre",1.15784516482971,47,16,31,12.6470272989857,34.3529727010143
"1980","feet",1.15760671456723,347,66,281,58.3777974923215,288.622202507678
"1980","cut",1.15370284388537,236,46,190,39.7036317238844,196.296368276116
"2010","dreaming",1.15167406241338,162,30,132,24.9419612845099,137.05803871549
"1980","walk",1.15016799112247,994,180,814,167.226313277716,826.773686722284
"2010","fight",1.15000805722172,483,83,400,74.3639956815944,408.636004318406
"1990","lead",1.14968784834401,188,46,142,39.8832028347519,148.116797165248
"2000","angry",1.1487197074664,34,12,22,9.14891336522372,24.8510866347763
"2000","come play",1.1487197074664,34,12,22,9.14891336522372,24.8510866347763
"2000","major",1.1487197074664,34,12,22,9.14891336522372,24.8510866347763
"2000","rescue",1.1487197074664,34,12,22,9.14891336522372,24.8510866347763
"2000","slipping",1.1487197074664,34,12,22,9.14891336522372,24.8510866347763
"2000","totally",1.1487197074664,34,12,22,9.14891336522372,24.8510866347763
"2010","heavy",1.14810405416041,58,12,46,8.92983799075047,49.0701620092495
"2010","just turn",1.14810405416041,58,12,46,8.92983799075047,49.0701620092495
"2010","every single",1.14792529846417,92,18,74,14.164570606018,77.835429393982
"2010","paper",1.14792529846417,92,18,74,14.164570606018,77.835429393982
"2010","yeahi",1.14792529846417,92,18,74,14.164570606018,77.835429393982
"2000","go just",1.14383784570223,57,19,38,15.3378841711103,41.6621158288897
"2000","see baby",1.14383784570223,57,19,38,15.3378841711103,41.6621158288897
"2010","take hand",1.14271091938758,121,23,98,18.6294896013932,102.370510398607
"1980","felt",1.140033529992,325,62,263,54.6766114841628,270.323388515837
"2010","like got",1.13884554922386,47,10,37,7.23624802698745,39.7637519730126
"2010","say oh",1.13884554922386,47,10,37,7.23624802698745,39.7637519730126
"2010","stopped",1.13884554922386,47,10,37,7.23624802698745,39.7637519730126
"2010","think know",1.13884554922386,47,10,37,7.23624802698745,39.7637519730126
"1980","good times",1.13850118136091,111,23,88,18.6741657684371,92.3258342315629
"1980","im talking",1.13696685207009,74,16,58,12.4494438456248,61.5505561543752
"1990","hero",1.1350796822222,55,15,40,11.6679582761242,43.3320417238758
"1990","vain",1.1350796822222,55,15,40,11.6679582761242,43.3320417238758
"1990","way youre",1.1350796822222,55,15,40,11.6679582761242,43.3320417238758
"2010","adore",1.13400227059425,75,15,60,11.5472042983842,63.4527957016158
"1960","fly away",1.13316677040474,91,8,83,5.43481787875153,85.5651821212485
"2000","single",1.13136614367165,198,60,138,53.2789660680675,144.721033931932
"1980","can tell",1.13108643089394,264,51,213,44.4142320979046,219.585767902095
"1970","got real",1.12282757360737,59,11,48,8.07402561874278,50.9259743812572
"1960","know aint",1.12138749000767,105,9,96,6.27094370625176,98.7290562937482
"1960","survive",1.12138749000767,105,9,96,6.27094370625176,98.7290562937482
"1960","oh dont",1.11948916835356,119,10,109,7.107069533752,111.892930466248
"1990","everythings",1.11797238021119,93,24,69,19.7294567214464,73.2705432785536
"1990","wet",1.11797238021119,93,24,69,19.7294567214464,73.2705432785536
"1990","just dont",1.11737332632269,184,45,139,39.0346240510338,144.965375948966
"1990","excited",1.11356552274969,51,14,37,10.8193794924061,40.1806205075939
"1990","got want",1.11356552274969,51,14,37,10.8193794924061,40.1806205075939
"1990","just come",1.11356552274969,51,14,37,10.8193794924061,40.1806205075939
"1990","show way",1.11356552274969,51,14,37,10.8193794924061,40.1806205075939
"1980","lived",1.11102981576376,69,15,54,11.6082652074069,57.3917347925931
"1960","soon",1.11085764542036,294,22,272,17.5586423775049,276.441357622495
"1970","youre feeling",1.10988647871992,78,14,64,10.6741355637616,67.3258644362384
"2000","though",1.10720536415351,532,154,378,143.15358559703,388.84641440297
"1990","aint enough",1.10641781308911,19,6,13,4.0307492226611,14.9692507773389
"1990","always get",1.10641781308911,19,6,13,4.0307492226611,14.9692507773389
"1990","away will",1.10641781308911,19,6,13,4.0307492226611,14.9692507773389
"1990","baby im one",1.10641781308911,19,6,13,4.0307492226611,14.9692507773389
"1990","back way",1.10641781308911,19,6,13,4.0307492226611,14.9692507773389
"1990","cant get mind",1.10641781308911,19,6,13,4.0307492226611,14.9692507773389
"1990","chi",1.10641781308911,19,6,13,4.0307492226611,14.9692507773389
"1990","day yeah",1.10641781308911,19,6,13,4.0307492226611,14.9692507773389
"1990","doll",1.10641781308911,19,6,13,4.0307492226611,14.9692507773389
"1990","everything dont",1.10641781308911,19,6,13,4.0307492226611,14.9692507773389
"1990","go time",1.10641781308911,19,6,13,4.0307492226611,14.9692507773389
"1990","gone can",1.10641781308911,19,6,13,4.0307492226611,14.9692507773389
"1990","hated",1.10641781308911,19,6,13,4.0307492226611,14.9692507773389
"1990","incredible",1.10641781308911,19,6,13,4.0307492226611,14.9692507773389
"1990","just believe",1.10641781308911,19,6,13,4.0307492226611,14.9692507773389
"1990","just tryin",1.10641781308911,19,6,13,4.0307492226611,14.9692507773389
"1990","let go baby",1.10641781308911,19,6,13,4.0307492226611,14.9692507773389
"1990","like hold",1.10641781308911,19,6,13,4.0307492226611,14.9692507773389
"1990","like tell",1.10641781308911,19,6,13,4.0307492226611,14.9692507773389
"1990","love answer",1.10641781308911,19,6,13,4.0307492226611,14.9692507773389
"1990","love youve",1.10641781308911,19,6,13,4.0307492226611,14.9692507773389
"1990","mebut",1.10641781308911,19,6,13,4.0307492226611,14.9692507773389
"1990","mind ive",1.10641781308911,19,6,13,4.0307492226611,14.9692507773389
"1990","one days",1.10641781308911,19,6,13,4.0307492226611,14.9692507773389
"1990","one yeah",1.10641781308911,19,6,13,4.0307492226611,14.9692507773389
"1990","play just",1.10641781308911,19,6,13,4.0307492226611,14.9692507773389
"1990","really think",1.10641781308911,19,6,13,4.0307492226611,14.9692507773389
"1990","theres reason",1.10641781308911,19,6,13,4.0307492226611,14.9692507773389
"1990","together oh",1.10641781308911,19,6,13,4.0307492226611,14.9692507773389
"1990","unwind",1.10641781308911,19,6,13,4.0307492226611,14.9692507773389
"1990","vodka",1.10641781308911,19,6,13,4.0307492226611,14.9692507773389
"1990","youre lost",1.10641781308911,19,6,13,4.0307492226611,14.9692507773389
"1990","youthe",1.10641781308911,19,6,13,4.0307492226611,14.9692507773389
"1970","crying",1.10547899008566,216,35,181,29.5591446381092,186.440855361891
"2000","minute",1.10260331745795,251,75,176,67.540507490328,183.459492509672
"2010","feels right",1.10195510183725,31,7,24,4.77284444333215,26.2271555566679
"2010","heart never",1.10195510183725,31,7,24,4.77284444333215,26.2271555566679
"2010","like cant",1.10195510183725,31,7,24,4.77284444333215,26.2271555566679
"2010","months",1.10195510183725,31,7,24,4.77284444333215,26.2271555566679
"2010","yeah think",1.10195510183725,31,7,24,4.77284444333215,26.2271555566679
"2010","yeah uh",1.10195510183725,31,7,24,4.77284444333215,26.2271555566679
"1980","yeah im",1.10091800544255,160,32,128,26.9177164229725,133.082283577028
"2010","pulled",1.09859647194515,64,13,51,9.8536143346212,54.1463856653788
"2010","ray",1.09859647194515,64,13,51,9.8536143346212,54.1463856653788
"2000","time well",1.09836332165002,44,15,29,11.8397702373483,32.1602297626517
"2000","want like",1.09836332165002,44,15,29,11.8397702373483,32.1602297626517
"1970","tell feel",1.09780789855502,53,10,43,7.25293826768419,45.7470617323158
"1970","without cant",1.09780789855502,53,10,43,7.25293826768419,45.7470617323158
"2000","let know",1.09565935361985,297,88,209,79.9184491021013,217.081550897899
"2000","loose",1.09449342821514,115,36,79,30.9448540294332,84.0551459705668
"2000","came life",1.09410110268425,31,11,20,8.34165630358633,22.6583436964137
"2000","love babe",1.09410110268425,31,11,20,8.34165630358633,22.6583436964137
"2000","shoulda",1.09410110268425,31,11,20,8.34165630358633,22.6583436964137
"2000","trade",1.09410110268425,31,11,20,8.34165630358633,22.6583436964137
"1960","mack",1.09368669864092,78,7,71,4.65841532464417,73.3415846753558
"1990","poor",1.09292586220002,72,19,53,15.2744181069263,56.7255818930737
"2000","shot",1.08970229141029,223,67,156,60.0061082483791,162.993891751621
"2000","ya know",1.08806278914283,64,21,43,17.2214839815976,46.7785160184024
"1990","im feeling",1.08692901673169,132,33,99,28.0030998626982,103.996900137302
"1980","im thinking",1.08638756712951,64,14,50,10.767086569189,53.232913430811
"1980","want stay",1.08638756712951,64,14,50,10.767086569189,53.232913430811
"2010","instead",1.08556643277856,110,21,89,16.9358996376302,93.0641003623698
"2000","dont even",1.08524014845478,181,55,126,48.7045093854557,132.295490614544
"1960","live",1.08289056848094,1210,81,1129,72.2651608053775,1137.73483919462
"1990","school",1.08283496818045,202,49,153,42.8532285777654,159.146771422235
"1970","rocking",1.07714091585651,47,9,38,6.4318509166256,40.5681490833744
"1970","sat",1.07714091585651,47,9,38,6.4318509166256,40.5681490833744
"1970","youre beautiful",1.07714091585651,47,9,38,6.4318509166256,40.5681490833744
"1980","cry",1.07679811583139,899,163,736,151.243919151577,747.756080848423
"1990","can hide",1.07676881931231,43,12,31,9.12222192496986,33.8777780750301
"1990","fantasies",1.07676881931231,43,12,31,9.12222192496986,33.8777780750301
"1990","god knows",1.07676881931231,43,12,31,9.12222192496986,33.8777780750301
"1990","hands hands",1.07676881931231,43,12,31,9.12222192496986,33.8777780750301
"1990","incomprehensible",1.07676881931231,43,12,31,9.12222192496986,33.8777780750301
"1990","love yeah yeah",1.07676881931231,43,12,31,9.12222192496986,33.8777780750301
"1990","night just",1.07676881931231,43,12,31,9.12222192496986,33.8777780750301
"1990","way walk",1.07676881931231,43,12,31,9.12222192496986,33.8777780750301
"1970","bop",1.07606548943522,284,45,239,38.8648012834398,245.13519871656
"1970","ohhh",1.07459009938592,72,13,59,9.85304821270305,62.146951787297
"2000","left",1.07373230867645,889,253,636,239.217175931879,649.782824068121
"2000","walkin",1.06977269693729,129,40,89,34.7120536504076,94.2879463495924
"1990","around see",1.06976776226546,23,7,16,4.87932800637923,18.1206719936208
"1990","away dont know",1.06976776226546,23,7,16,4.87932800637923,18.1206719936208
"1990","ever heard",1.06976776226546,23,7,16,4.87932800637923,18.1206719936208
"1990","got em",1.06976776226546,23,7,16,4.87932800637923,18.1206719936208
"1990","image",1.06976776226546,23,7,16,4.87932800637923,18.1206719936208
"1990","kim",1.06976776226546,23,7,16,4.87932800637923,18.1206719936208
"1990","make scream",1.06976776226546,23,7,16,4.87932800637923,18.1206719936208
"1990","miles away",1.06976776226546,23,7,16,4.87932800637923,18.1206719936208
"1990","tear us",1.06976776226546,23,7,16,4.87932800637923,18.1206719936208
"1990","wanna stop",1.06976776226546,23,7,16,4.87932800637923,18.1206719936208
"1990","world im",1.06976776226546,23,7,16,4.87932800637923,18.1206719936208
"2010","stay away",1.06876184069772,42,9,33,6.46643440709516,35.5335655929048
"2010","toe",1.06876184069772,42,9,33,6.46643440709516,35.5335655929048
"1990","sight",1.06841310343242,211,51,160,44.7625308411312,166.237469158869
"1970","fade",1.06698684530655,150,25,125,20.5271837764647,129.472816223535
"1970","say say",1.06698684530655,150,25,125,20.5271837764647,129.472816223535
"1970","days gone",1.06687242898303,29,6,23,3.96858886344984,25.0314111365502
"1970","good dont",1.06687242898303,29,6,23,3.96858886344984,25.0314111365502
"1970","ive always",1.06687242898303,29,6,23,3.96858886344984,25.0314111365502
"1970","july",1.06687242898303,29,6,23,3.96858886344984,25.0314111365502
"1970","make things",1.06687242898303,29,6,23,3.96858886344984,25.0314111365502
"1970","see oh",1.06687242898303,29,6,23,3.96858886344984,25.0314111365502
"1970","senses",1.06687242898303,29,6,23,3.96858886344984,25.0314111365502
"1970","sharing",1.06687242898303,29,6,23,3.96858886344984,25.0314111365502
"1970","steel",1.06687242898303,29,6,23,3.96858886344984,25.0314111365502
"1970","string",1.06687242898303,29,6,23,3.96858886344984,25.0314111365502
"1970","thered",1.06687242898303,29,6,23,3.96858886344984,25.0314111365502
"1960","ocean",1.06621225323053,106,9,97,6.33066697964464,99.6693330203554
"1990","bad bad",1.06424047890663,68,18,50,14.4258393232082,53.5741606767919
"2010","songs",1.06364926711683,187,34,153,28.7910293839713,158.208970616029
"1980","hold close",1.0633619321955,59,13,46,9.9259079309711,49.0740920690289
"1980","wait wait",1.0633619321955,59,13,46,9.9259079309711,49.0740920690289
"1980","youre everything",1.0633619321955,59,13,46,9.9259079309711,49.0740920690289
"1960","get home",1.06315360097202,65,6,59,3.88201277053681,61.1179872294632
"1960","want can",1.06315360097202,65,6,59,3.88201277053681,61.1179872294632
"1990","around cause",1.06273426934903,39,11,28,8.27364314125173,30.7263568587483
"1990","heal",1.06273426934903,39,11,28,8.27364314125173,30.7263568587483
"1990","prince",1.06273426934903,39,11,28,8.27364314125173,30.7263568587483
"1990","rip",1.06273426934903,39,11,28,8.27364314125173,30.7263568587483
"1970","get better",1.06266521904864,41,8,33,5.61076356556702,35.389236434433
"1970","go lets",1.06266521904864,41,8,33,5.61076356556702,35.389236434433
"1970","say can",1.06266521904864,41,8,33,5.61076356556702,35.389236434433
"1970","time time time",1.06266521904864,41,8,33,5.61076356556702,35.389236434433
"1980","somethin",1.06007239210102,293,56,237,49.2930681995683,243.706931800432
"2010","clothes",1.0590922771473,211,38,173,32.4861347594543,178.513865240546
"1970","perfume",1.05742733725574,35,7,28,4.78967621450843,30.2103237854916
"1970","possibly",1.05742733725574,35,7,28,4.78967621450843,30.2103237854916
"1970","whyd",1.05742733725574,35,7,28,4.78967621450843,30.2103237854916
"1970","word say",1.05742733725574,35,7,28,4.78967621450843,30.2103237854916
"1990","glory",1.05508968557538,85,22,63,18.0322991540102,66.9677008459898
"1990","begins",1.05309400740903,27,8,19,5.72790679009735,21.2720932099026
"1990","cause ive got",1.05309400740903,27,8,19,5.72790679009735,21.2720932099026
"1990","destination",1.05309400740903,27,8,19,5.72790679009735,21.2720932099026
"1990","fed",1.05309400740903,27,8,19,5.72790679009735,21.2720932099026
"1990","gonna right",1.05309400740903,27,8,19,5.72790679009735,21.2720932099026
"1990","heart wont",1.05309400740903,27,8,19,5.72790679009735,21.2720932099026
"1990","intentions",1.05309400740903,27,8,19,5.72790679009735,21.2720932099026
"1990","just dont know",1.05309400740903,27,8,19,5.72790679009735,21.2720932099026
"1990","know long",1.05309400740903,27,8,19,5.72790679009735,21.2720932099026
"1990","make one",1.05309400740903,27,8,19,5.72790679009735,21.2720932099026
"1990","miss like",1.05309400740903,27,8,19,5.72790679009735,21.2720932099026
"1990","told ya",1.05309400740903,27,8,19,5.72790679009735,21.2720932099026
"1990","whats wrong",1.05309400740903,27,8,19,5.72790679009735,21.2720932099026
"1990","wire",1.05309400740903,27,8,19,5.72790679009735,21.2720932099026
"1990","years ago",1.05309400740903,27,8,19,5.72790679009735,21.2720932099026
"1990","can touch",1.05290449523614,35,10,25,7.42506435753361,27.5749356424664
"1990","dream come",1.05290449523614,35,10,25,7.42506435753361,27.5749356424664
"1990","just see",1.05290449523614,35,10,25,7.42506435753361,27.5749356424664
"1990","maybe ill",1.05290449523614,35,10,25,7.42506435753361,27.5749356424664
"1990","us can",1.05290449523614,35,10,25,7.42506435753361,27.5749356424664
"1990","whatchu",1.05290449523614,35,10,25,7.42506435753361,27.5749356424664
"1990","youcause",1.05290449523614,35,10,25,7.42506435753361,27.5749356424664
"2010","babe im",1.04959604546495,26,6,20,4.00303082343986,21.9969691765601
"2010","came back",1.04959604546495,26,6,20,4.00303082343986,21.9969691765601
"2010","figured",1.04959604546495,26,6,20,4.00303082343986,21.9969691765601
"2010","forever never",1.04959604546495,26,6,20,4.00303082343986,21.9969691765601
"2010","get can",1.04959604546495,26,6,20,4.00303082343986,21.9969691765601
"2010","let live",1.04959604546495,26,6,20,4.00303082343986,21.9969691765601
"2010","make wish",1.04959604546495,26,6,20,4.00303082343986,21.9969691765601
"2010","mind just",1.04959604546495,26,6,20,4.00303082343986,21.9969691765601
"2010","nature",1.04959604546495,26,6,20,4.00303082343986,21.9969691765601
"1990","hold now",1.0488609580612,31,9,22,6.57648557381548,24.4235144261845
"1990","im giving",1.0488609580612,31,9,22,6.57648557381548,24.4235144261845
"1990","just roll",1.0488609580612,31,9,22,6.57648557381548,24.4235144261845
"1990","know youve got",1.0488609580612,31,9,22,6.57648557381548,24.4235144261845
"1990","lip",1.0488609580612,31,9,22,6.57648557381548,24.4235144261845
"1990","love babe",1.0488609580612,31,9,22,6.57648557381548,24.4235144261845
"1990","now right",1.0488609580612,31,9,22,6.57648557381548,24.4235144261845
"1990","pretending",1.0488609580612,31,9,22,6.57648557381548,24.4235144261845
"2000","hard",1.04693088423576,1241,350,891,333.935337830666,907.064662169334
"1970","sometimes",1.04577495345987,442,68,374,60.4867681946493,381.513231805351
"2000","got something",1.04492565902211,71,23,48,19.1050837920848,51.8949162079152
"1970","spent",1.04332188071258,124,21,103,16.9691385885441,107.030861411456
"1980","one chance",1.04239112079505,54,12,42,9.08472929275321,44.9152707072468
"1980","say youll",1.04239112079505,54,12,42,9.08472929275321,44.9152707072468
"1980","throw away",1.04239112079505,54,12,42,9.08472929275321,44.9152707072468
"1980","shouldnt",1.0408147264954,96,20,76,16.1506298537835,79.8493701462165
"2000","babies",1.04066640972301,28,10,18,7.53439924194894,20.4656007580511
"2000","dance wanna",1.04066640972301,28,10,18,7.53439924194894,20.4656007580511
"2000","de de",1.04066640972301,28,10,18,7.53439924194894,20.4656007580511
"2000","hype",1.04066640972301,28,10,18,7.53439924194894,20.4656007580511
"2000","ill one",1.04066640972301,28,10,18,7.53439924194894,20.4656007580511
"2000","just right",1.04066640972301,28,10,18,7.53439924194894,20.4656007580511
"2000","liar",1.04066640972301,28,10,18,7.53439924194894,20.4656007580511
"2000","like youve",1.04066640972301,28,10,18,7.53439924194894,20.4656007580511
"2000","magical",1.04066640972301,28,10,18,7.53439924194894,20.4656007580511
"2000","maybe youll",1.04066640972301,28,10,18,7.53439924194894,20.4656007580511
"2000","rolls",1.04066640972301,28,10,18,7.53439924194894,20.4656007580511
"2000","slap",1.04066640972301,28,10,18,7.53439924194894,20.4656007580511
"2000","twelve",1.04066640972301,28,10,18,7.53439924194894,20.4656007580511
"2000","used know",1.04066640972301,28,10,18,7.53439924194894,20.4656007580511
"2000","youre pretty",1.04066640972301,28,10,18,7.53439924194894,20.4656007580511
"1970","danger",1.04060625898062,66,12,54,9.03196086164446,56.9680391383555
"1970","huh huh",1.04060625898062,66,12,54,9.03196086164446,56.9680391383555
"1970","make mine",1.04060625898062,66,12,54,9.03196086164446,56.9680391383555
"2000","mornin",1.04012379111046,112,35,77,30.1375969677958,81.8624030322042
"1970","glass",1.03911381236237,98,17,81,13.4110934006236,84.5889065993764
"2000","dont wanna live",1.03898645623503,41,14,27,11.032513175711,29.9674868242891
"2000","get better",1.03898645623503,41,14,27,11.032513175711,29.9674868242891
"2000","wish never",1.03898645623503,41,14,27,11.032513175711,29.9674868242891
"2000","one time",1.03844445584731,199,60,139,53.54805175528,145.45194824472
"1990","upon",1.03699462806542,207,50,157,43.913952057413,163.086047942587
"1990","love tonight",1.03607974451775,64,17,47,13.57726053949,50.42273946051
"1990","want got",1.03607974451775,64,17,47,13.57726053949,50.42273946051
"1990","want stay",1.03607974451775,64,17,47,13.57726053949,50.42273946051
"1990","see",1.03467732755933,5264,1147,4117,1116.72967937305,4147.27032062695
"1990","cant keep",1.033940507641,98,25,73,20.7901802010941,77.2098197989059
"1990","get together",1.033940507641,98,25,73,20.7901802010941,77.2098197989059
"1990","ground",1.03282483593819,278,66,212,58.9762254684098,219.02377453159
"1970","nowhere",1.03164322250124,224,36,188,30.6539277728539,193.346072227146
"1970","reach",1.03164322250124,224,36,188,30.6539277728539,193.346072227146
"1960","monkey",1.03004368494249,79,7,72,4.71813859803704,74.281861401963
"1980","somebody",1.02837241857414,672,123,549,113.054408976484,558.945591023516
"2000","action",1.02824710627166,61,20,41,16.4142269199602,44.5857730800398
"2000","dont play",1.02824710627166,61,20,41,16.4142269199602,44.5857730800398
"2000","lose mind",1.02824710627166,61,20,41,16.4142269199602,44.5857730800398
"1980","bold",1.02800613900718,24,6,18,4.03765746344587,19.9623425365541
"1980","books",1.02800613900718,24,6,18,4.03765746344587,19.9623425365541
"1980","flies",1.02800613900718,24,6,18,4.03765746344587,19.9623425365541
"1980","flowing",1.02800613900718,24,6,18,4.03765746344587,19.9623425365541
"1980","friends say",1.02800613900718,24,6,18,4.03765746344587,19.9623425365541
"1980","huh know",1.02800613900718,24,6,18,4.03765746344587,19.9623425365541
"1980","menow",1.02800613900718,24,6,18,4.03765746344587,19.9623425365541
"1980","new world",1.02800613900718,24,6,18,4.03765746344587,19.9623425365541
"1980","now gonna",1.02800613900718,24,6,18,4.03765746344587,19.9623425365541
"1980","oh aint",1.02800613900718,24,6,18,4.03765746344587,19.9623425365541
"1980","rely",1.02800613900718,24,6,18,4.03765746344587,19.9623425365541
"1980","rides",1.02800613900718,24,6,18,4.03765746344587,19.9623425365541
"1980","sayi",1.02800613900718,24,6,18,4.03765746344587,19.9623425365541
"1980","start fire",1.02800613900718,24,6,18,4.03765746344587,19.9623425365541
"1980","together can",1.02800613900718,24,6,18,4.03765746344587,19.9623425365541
"1980","upset",1.02800613900718,24,6,18,4.03765746344587,19.9623425365541
"1980","youre trying",1.02800613900718,24,6,18,4.03765746344587,19.9623425365541
"1960","everywhere",1.0280028641353,237,18,219,14.1544157941111,222.845584205889
"1960","warm",1.0280028641353,237,18,219,14.1544157941111,222.845584205889
"2010","flying",1.02539925772119,76,15,61,11.7011670223627,64.2988329776373
"2010","said im",1.02539925772119,76,15,61,11.7011670223627,64.2988329776373
"1990","taking",1.02447301727721,216,52,164,45.8232543207788,170.176745679221
"1990","one two",1.02372230887432,111,28,83,23.548061248178,87.451938751822
"2000","confess",1.0234338619441,51,17,34,13.7233700478356,37.2766299521644
"2000","september",1.0234338619441,51,17,34,13.7233700478356,37.2766299521644
"2010","back want",1.02332469812975,59,12,47,9.08380071472892,49.9161992852711
"2010","jean",1.02332469812975,59,12,47,9.08380071472892,49.9161992852711
"2010","need one",1.02332469812975,59,12,47,9.08380071472892,49.9161992852711
"1980","know youve",1.02182518293119,75,16,59,12.6176795732683,62.3823204267317
"1980","search",1.02182518293119,75,16,59,12.6176795732683,62.3823204267317
"2010","grab",1.02152792314283,146,27,119,22.4785577008546,123.521442299145
"1980","bar",1.01980695642681,172,34,138,28.9365451546954,143.063454845305
"1970","window",1.01661983584454,184,30,154,25.18001209913,158.81998790087
"1960","death",1.01558816722333,93,8,85,5.55426442553728,87.4457355744627
"1970","go crazy",1.0113418655483,79,14,65,10.8109834556047,68.1890165443953
"1970","storm",1.0113418655483,79,14,65,10.8109834556047,68.1890165443953
"2000","fears",1.01108642918893,78,25,53,20.9886836025721,57.0113163974279
"1970","dog",1.01078646294511,131,22,109,17.9270738314458,113.072926168554
"1990","get just",1.00854718584505,60,16,44,12.7286817557719,47.2713182442281
"1970","get just",1.00831935216068,60,11,49,8.21087351058588,51.7891264894141
"1970","people say",1.00831935216068,60,11,49,8.21087351058588,51.7891264894141
"1970","sight",1.00576488173025,211,34,177,28.8749051788937,182.125094821106
"1980","can put",1.00397289908673,29,7,22,4.87883610166376,24.1211638983362
"1980","darkest",1.00397289908673,29,7,22,4.87883610166376,24.1211638983362
"1980","days gone",1.00397289908673,29,7,22,4.87883610166376,24.1211638983362
"1980","sacrifice",1.00397289908673,29,7,22,4.87883610166376,24.1211638983362
"1980","sharing",1.00397289908673,29,7,22,4.87883610166376,24.1211638983362
"1980","tell wanna",1.00397289908673,29,7,22,4.87883610166376,24.1211638983362
"1980","toast",1.00397289908673,29,7,22,4.87883610166376,24.1211638983362
"1980","tonight im gonna",1.00397289908673,29,7,22,4.87883610166376,24.1211638983362
"1990","dont even",1.00315404089352,181,44,137,38.3981899632452,142.601810036755
"1960","goes",1.00284453520863,712,49,663,42.5229706557262,669.477029344274
"2000","doin",1.00247763661406,348,102,246,93.6418191499369,254.358180850063
"2000","face",1.00236694717146,869,247,622,233.83546218763,635.16453781237
"2010","said dont",1.00042938405535,48,10,38,7.3902107509659,40.6097892490341
"2010","works",1.00042938405535,48,10,38,7.3902107509659,40.6097892490341
"2010","dont think can",1.00014121132645,37,8,29,5.69662078720288,31.3033792127971
"2010","fish",1.00014121132645,37,8,29,5.69662078720288,31.3033792127971
"2010","life will",1.00014121132645,37,8,29,5.69662078720288,31.3033792127971
"2010","lightning",1.00014121132645,37,8,29,5.69662078720288,31.3033792127971
"2010","like fool",1.00014121132645,37,8,29,5.69662078720288,31.3033792127971
"2010","michael",1.00014121132645,37,8,29,5.69662078720288,31.3033792127971
"2010","now think",1.00014121132645,37,8,29,5.69662078720288,31.3033792127971
"2010","planet",1.00014121132645,37,8,29,5.69662078720288,31.3033792127971
"2010","wanna let",1.00014121132645,37,8,29,5.69662078720288,31.3033792127971
"2010","woop",1.00014121132645,37,8,29,5.69662078720288,31.3033792127971
"1980","away know",0.999453743534705,39,9,30,6.56119337809954,32.4388066219005
"1980","holiday",0.999453743534705,39,9,30,6.56119337809954,32.4388066219005
"1980","just trying",0.999453743534705,39,9,30,6.56119337809954,32.4388066219005
"1980","know hes",0.999453743534705,39,9,30,6.56119337809954,32.4388066219005
"1980","now let",0.999453743534705,39,9,30,6.56119337809954,32.4388066219005
"2010","whenever",0.999192096574175,182,33,149,28.021215764079,153.978784235921
"1970","look back",0.998517554912007,92,16,76,12.590006049565,79.409993950435
"1970","nobody else",0.998517554912007,92,16,76,12.590006049565,79.409993950435
"1970","whatcha gonna",0.998517554912007,92,16,76,12.590006049565,79.409993950435
"2010","leaving",0.996757553352417,200,36,164,30.7925447956913,169.207455204309
"1980","cause really",0.996517896909362,34,8,26,5.72001473988165,28.2799852601184
"1980","good youre",0.996517896909362,34,8,26,5.72001473988165,28.2799852601184
"1980","love alive",0.996517896909362,34,8,26,5.72001473988165,28.2799852601184
"1980","slipping",0.996517896909362,34,8,26,5.72001473988165,28.2799852601184
"1980","take control",0.996517896909362,34,8,26,5.72001473988165,28.2799852601184
"1980","tell gonna",0.996517896909362,34,8,26,5.72001473988165,28.2799852601184
"1980","wasting time",0.996517896909362,34,8,26,5.72001473988165,28.2799852601184
"1960","dont hurt",0.994163939763335,66,6,60,3.94173604392968,62.0582639560703
"1960","huh huh",0.994163939763335,66,6,60,3.94173604392968,62.0582639560703
"1980","day night",0.993179319505741,70,15,55,11.7765009350505,58.2234990649496
"1980","hoping",0.993179319505741,70,15,55,11.7765009350505,58.2234990649496
"1990","baby tell",0.992823525897746,77,20,57,16.3351415865739,60.6648584134261
"1990","figure",0.990896873490993,107,27,80,22.6994824644599,84.3005175355401
"1970","met",0.98984866443481,313,49,264,42.8333901468896,270.16660985311
"2000","away one",0.988837094058558,25,9,16,6.72714218031156,18.2728578196884
"2000","denied",0.988837094058558,25,9,16,6.72714218031156,18.2728578196884
"2000","glasses",0.988837094058558,25,9,16,6.72714218031156,18.2728578196884
"2000","head cant",0.988837094058558,25,9,16,6.72714218031156,18.2728578196884
"2000","hear song",0.988837094058558,25,9,16,6.72714218031156,18.2728578196884
"2000","im standing",0.988837094058558,25,9,16,6.72714218031156,18.2728578196884
"2000","knows im",0.988837094058558,25,9,16,6.72714218031156,18.2728578196884
"2000","life one",0.988837094058558,25,9,16,6.72714218031156,18.2728578196884
"2000","sometimes im",0.988837094058558,25,9,16,6.72714218031156,18.2728578196884
"2000","thousand times",0.988837094058558,25,9,16,6.72714218031156,18.2728578196884
"2000","thousand years",0.988837094058558,25,9,16,6.72714218031156,18.2728578196884
"2000","thrown",0.988837094058558,25,9,16,6.72714218031156,18.2728578196884
"2000","youre really",0.988837094058558,25,9,16,6.72714218031156,18.2728578196884
"1990","sounds",0.988117287937866,120,30,90,25.4573635115438,94.5426364884562
"2000","go wrong",0.985978738154669,68,22,46,18.2978267304474,49.7021732695526
"1990","lie",0.985592992594299,517,119,398,109.678807795568,407.321192204432
"1980","dont go",0.985578376350999,167,33,134,28.0953665164775,138.904633483522
"1980","ill give",0.983199190229557,178,35,143,29.9459595205569,148.054040479443
"2010","time know",0.982801967848335,65,13,52,10.0075770585997,54.9924229414003
"2000","awayi",0.979739329084005,38,13,25,10.2252561140736,27.7747438859264
"2000","can stand",0.979739329084005,38,13,25,10.2252561140736,27.7747438859264
"2000","em like",0.979739329084005,38,13,25,10.2252561140736,27.7747438859264
"2010","along",0.978823172990397,401,69,332,61.739052315361,339.260947684639
"1970","bunch",0.978280237945567,54,10,44,7.38978615952729,46.6102138404727
"1970","yes yes",0.978280237945567,54,10,44,7.38978615952729,46.6102138404727
"1980","dont come",0.976749209143196,86,18,68,14.4682725773477,71.5317274226523
"1980","best",0.975928043376278,908,164,744,152.758040700369,755.241959299631
"2010","dont take",0.975282617578305,88,17,71,13.5487197101042,74.4512802898958
"2010","sister",0.975282617578305,88,17,71,13.5487197101042,74.4512802898958
"2000","sense",0.974377563661614,116,36,80,31.2139397166456,84.7860602833544
"1980","ooh ooh ooh ooh",0.974304816861252,129,26,103,21.7024088660216,107.297591133978
"1960","gotta keep",0.968862210333465,80,7,73,4.77786187142992,75.2221381285701
"2000","everything will",0.968471504907326,58,19,39,15.6069698583228,42.3930301416772
"1970","havent",0.968179967933644,125,21,104,17.1059864803872,107.894013519613
"2000","way know",0.963231870065036,48,16,32,12.9161129861982,35.0838870138018
"1970","closer",0.963217156525584,232,37,195,31.7487109075987,200.251289092401
"1990","like one",0.961984445786254,73,19,54,15.4865628028558,57.5134371971442
"1960","dont believe",0.961079871288823,108,9,99,6.45011352643039,101.54988647357
"1960","will love",0.959858293287261,94,8,86,5.61398769893015,88.3860123010698
"1960","trust",0.95975257828373,239,18,221,14.2738623408969,224.726137659103
"1960","ooo",0.958933451943603,180,14,166,10.7501892107173,169.249810789283
"1960","fall love",0.956434845021788,254,19,235,15.16971144179,238.83028855821
"2010","wrote",0.956205773453691,94,18,76,14.4724960539749,79.5275039460251
"1990","many things",0.955937592217813,52,14,38,11.0315241883356,40.9684758116644
"1990","yeah youre",0.955937592217813,52,14,38,11.0315241883356,40.9684758116644
"2010","straight",0.954987885159969,255,45,210,39.2604946145064,215.739505385494
"1970","even know",0.954531496194755,99,17,82,13.5479412924667,85.4520587075333
"1980","livin",0.954233350616606,351,66,285,59.0507404028959,291.949259597104
"2000","life life",0.953223675318414,75,24,51,20.1814265409347,54.8185734590653
"1970","youre like",0.951307384998234,48,9,39,6.5686988084687,41.4313011915313
"1980","talking",0.951257277097405,323,61,262,54.3401400288757,268.659859971124
"2010","ever gonna",0.950032354777569,71,14,57,10.9313534024704,60.0686465975296
"2010","heads",0.950032354777569,71,14,57,10.9313534024704,60.0686465975296
"2000","didnt know",0.948139863573465,144,44,100,38.7483389585946,105.251661041405
"2010","swallow",0.94811345886119,54,11,43,8.31398709483664,45.6860129051634
"1980","though",0.946866421378218,532,98,434,89.5014071063835,442.498592893617
"2000","even know",0.945929849730483,99,31,68,26.6394830340338,72.3605169659662
"2000","fat",0.945929849730483,99,31,68,26.6394830340338,72.3605169659662
"2010","pieces",0.94018900453735,100,19,81,15.3962723978456,84.6037276021544
"2000","anything just",0.939261780434423,22,8,14,5.91988511867417,16.0801148813258
"2000","better go",0.939261780434423,22,8,14,5.91988511867417,16.0801148813258
"2000","buddy",0.939261780434423,22,8,14,5.91988511867417,16.0801148813258
"2000","call ill",0.939261780434423,22,8,14,5.91988511867417,16.0801148813258
"2000","cant lie",0.939261780434423,22,8,14,5.91988511867417,16.0801148813258
"2000","care cause",0.939261780434423,22,8,14,5.91988511867417,16.0801148813258
"2000","give know",0.939261780434423,22,8,14,5.91988511867417,16.0801148813258
"2000","just wanted",0.939261780434423,22,8,14,5.91988511867417,16.0801148813258
"2000","like really",0.939261780434423,22,8,14,5.91988511867417,16.0801148813258
"2000","mad cause",0.939261780434423,22,8,14,5.91988511867417,16.0801148813258
"2000","man thats",0.939261780434423,22,8,14,5.91988511867417,16.0801148813258
"2000","tell way",0.939261780434423,22,8,14,5.91988511867417,16.0801148813258
"2000","u s",0.939261780434423,22,8,14,5.91988511867417,16.0801148813258
"2000","victim",0.939261780434423,22,8,14,5.91988511867417,16.0801148813258
"2000","wished",0.939261780434423,22,8,14,5.91988511867417,16.0801148813258
"2000","yell",0.939261780434423,22,8,14,5.91988511867417,16.0801148813258
"1980","babys",0.938711339767351,60,13,47,10.0941436586147,49.9058563413853
"1980","people say",0.938711339767351,60,13,47,10.0941436586147,49.9058563413853
"1980","see love",0.938711339767351,60,13,47,10.0941436586147,49.9058563413853
"1980","stayed",0.938711339767351,60,13,47,10.0941436586147,49.9058563413853
"1980","youre mine",0.938711339767351,60,13,47,10.0941436586147,49.9058563413853
"2010","ahead",0.938514059220658,165,30,135,25.4038494564453,139.596150543555
"1990","thinkin bout",0.937009138553346,86,22,64,18.2444438499397,67.7555561500603
"1970","baby baby",0.936741698176725,786,117,669,107.562442988675,678.437557011325
"2010","scared",0.934685229857546,195,35,160,30.022731175799,164.977268824201
"2010","boy youre",0.933655105153283,32,7,25,4.9268071673106,27.0731928326894
"2010","can start",0.933655105153283,32,7,25,4.9268071673106,27.0731928326894
"2010","cmon cmon",0.933655105153283,32,7,25,4.9268071673106,27.0731928326894
"2010","come girl",0.933655105153283,32,7,25,4.9268071673106,27.0731928326894
"2010","energy",0.933655105153283,32,7,25,4.9268071673106,27.0731928326894
"2010","eyes im",0.933655105153283,32,7,25,4.9268071673106,27.0731928326894
"2010","hottest",0.933655105153283,32,7,25,4.9268071673106,27.0731928326894
"2010","im fire",0.933655105153283,32,7,25,4.9268071673106,27.0731928326894
"2010","month",0.933655105153283,32,7,25,4.9268071673106,27.0731928326894
"2010","now say",0.933655105153283,32,7,25,4.9268071673106,27.0731928326894
"2010","save life",0.933655105153283,32,7,25,4.9268071673106,27.0731928326894
"2010","trap",0.933655105153283,32,7,25,4.9268071673106,27.0731928326894
"1970","now dont",0.932489056280097,172,28,144,23.5378373970128,148.462162602987
"1990","gotta",0.931969514759587,1926,426,1500,408.590684360278,1517.40931563972
"1970","played",0.931639765115493,152,25,127,20.8008795601509,131.199120439849
"1990","gots",0.931263107473359,48,13,35,10.1829454046175,37.8170545953825
"1990","situation",0.931263107473359,48,13,35,10.1829454046175,37.8170545953825
"1990","well get",0.931263107473359,48,13,35,10.1829454046175,37.8170545953825
"1960","say",0.929869074970686,4757,300,4457,284.103611529901,4472.8963884701
"1980","first time",0.928899567092154,135,27,108,22.711823231883,112.288176768117
"1980","im love",0.928766166945715,223,43,180,37.5165672645179,185.483432735482
"1970","dont hear",0.928672066756882,42,8,34,5.74761145741011,36.2523885425899
"1960","soft",0.928204965423437,67,6,61,4.00145931732255,62.9985406826774
"2010","got lot",0.92720016167639,43,9,34,6.62039713107362,36.3796028689264
"2010","mess around",0.92720016167639,43,9,34,6.62039713107362,36.3796028689264
"2010","thing dont",0.92720016167639,43,9,34,6.62039713107362,36.3796028689264
"2010","watched",0.92720016167639,43,9,34,6.62039713107362,36.3796028689264
"1970","park",0.925580815776177,119,20,99,16.2848991293287,102.715100870671
"1990","ago",0.92524347612077,125,31,94,26.5180869911915,98.4819130088085
"1990","whenever",0.924770350173848,182,44,138,38.6103346591748,143.389665340825
"1980","can hear",0.921847332480291,108,22,86,18.1694585855064,89.8305414144936
"1990","though",0.921571056621563,532,122,410,112.860978234511,419.139021765489
"2000","gotta say",0.920655152625321,35,12,23,9.41799905243618,25.5820009475638
"2000","growin",0.920655152625321,35,12,23,9.41799905243618,25.5820009475638
"2000","high like",0.920655152625321,35,12,23,9.41799905243618,25.5820009475638
"2000","might just",0.920655152625321,35,12,23,9.41799905243618,25.5820009475638
"2000","tryin make",0.920655152625321,35,12,23,9.41799905243618,25.5820009475638
"1960","left",0.918891957788423,889,60,829,53.0939900462649,835.906009953735
"2000","knows",0.918246440210879,496,143,353,133.466500857381,362.533499142619
"2000","promise",0.917110560716726,385,112,273,103.597989576798,281.402010423202
"1980","eyes can",0.913392197608605,55,12,43,9.25296502039679,45.7470349796032
"1980","somebody love",0.913392197608605,55,12,43,9.25296502039679,45.7470349796032
"1970","called love",0.912462338725494,36,7,29,4.92652410635153,31.0734758936485
"1970","love ever",0.912462338725494,36,7,29,4.92652410635153,31.0734758936485
"1970","one us",0.912462338725494,36,7,29,4.92652410635153,31.0734758936485
"1970","theres place",0.912462338725494,36,7,29,4.92652410635153,31.0734758936485
"1980","lying",0.911554748152742,92,19,73,15.4776869432092,76.5223130567908
"2000","slippin",0.908742564569607,55,18,37,14.7997127966854,40.2002872033146
"1990","get money",0.908063745777763,44,12,32,9.33436662089939,34.6656333791006
"1990","im talkin",0.908063745777763,44,12,32,9.33436662089939,34.6656333791006
"1990","often",0.908063745777763,44,12,32,9.33436662089939,34.6656333791006
"2010","heavens",0.907201816475382,60,12,48,9.23776343870738,50.7622365612926
"1990","show",0.906869982659948,1443,321,1122,306.124796226314,1136.87520377369
"1970","became",0.906366289076344,30,6,24,4.10543675529294,25.8945632447071
"1970","cant turn",0.906366289076344,30,6,24,4.10543675529294,25.8945632447071
"1970","ended",0.906366289076344,30,6,24,4.10543675529294,25.8945632447071
"1970","flat",0.906366289076344,30,6,24,4.10543675529294,25.8945632447071
"1970","fooling",0.906366289076344,30,6,24,4.10543675529294,25.8945632447071
"1970","just much",0.906366289076344,30,6,24,4.10543675529294,25.8945632447071
"1970","lookin good",0.906366289076344,30,6,24,4.10543675529294,25.8945632447071
"1970","one loves",0.906366289076344,30,6,24,4.10543675529294,25.8945632447071
"1970","ooh dont",0.906366289076344,30,6,24,4.10543675529294,25.8945632447071
"1970","rubber",0.906366289076344,30,6,24,4.10543675529294,25.8945632447071
"1970","somebody tell",0.906366289076344,30,6,24,4.10543675529294,25.8945632447071
"1970","stands",0.906366289076344,30,6,24,4.10543675529294,25.8945632447071
"1970","two us",0.906366289076344,30,6,24,4.10543675529294,25.8945632447071
"1970","used say",0.906366289076344,30,6,24,4.10543675529294,25.8945632447071
"1970","wanna make love",0.906366289076344,30,6,24,4.10543675529294,25.8945632447071
"1990","nine",0.90482033866128,82,21,61,17.3958650662216,64.6041349337784
"2000","realized",0.903029878185983,45,15,30,12.1088559245608,32.8911440754392
"2000","wait minute",0.903029878185983,45,15,30,12.1088559245608,32.8911440754392
"1960","get get",0.902676968864908,546,38,508,32.6089072725092,513.391092727491
"1970","knockin",0.901295414288658,61,11,50,8.34772140242897,52.652278597571
"1990","want can",0.901073475057562,65,17,48,13.7894052354196,51.2105947645804
"1980","calling",0.896038858174101,218,42,176,36.6753886263,181.3246113737
"2000","dangerous",0.895557318804722,72,23,49,19.3741694792973,52.6258305207027
"2000","tell baby",0.895557318804722,72,23,49,19.3741694792973,52.6258305207027
"2010","phone",0.893642600505141,311,54,257,47.8824071572999,263.1175928427
"2000","absolutely",0.892993303809421,19,7,12,5.11262805703678,13.8873719429632
"2000","always like",0.892993303809421,19,7,12,5.11262805703678,13.8873719429632
"2000","baby yeah yeah",0.892993303809421,19,7,12,5.11262805703678,13.8873719429632
"2000","can tell way",0.892993303809421,19,7,12,5.11262805703678,13.8873719429632
"2000","convinced",0.892993303809421,19,7,12,5.11262805703678,13.8873719429632
"2000","dropping",0.892993303809421,19,7,12,5.11262805703678,13.8873719429632
"2000","get put",0.892993303809421,19,7,12,5.11262805703678,13.8873719429632
"2000","go well",0.892993303809421,19,7,12,5.11262805703678,13.8873719429632
"2000","know give",0.892993303809421,19,7,12,5.11262805703678,13.8873719429632
"2000","like im gonna",0.892993303809421,19,7,12,5.11262805703678,13.8873719429632
"2000","like tell",0.892993303809421,19,7,12,5.11262805703678,13.8873719429632
"2000","lovin im",0.892993303809421,19,7,12,5.11262805703678,13.8873719429632
"2000","monica",0.892993303809421,19,7,12,5.11262805703678,13.8873719429632
"2000","noticed",0.892993303809421,19,7,12,5.11262805703678,13.8873719429632
"2000","oh oh baby",0.892993303809421,19,7,12,5.11262805703678,13.8873719429632
"2000","present",0.892993303809421,19,7,12,5.11262805703678,13.8873719429632
"2000","say like",0.892993303809421,19,7,12,5.11262805703678,13.8873719429632
"2000","shes fine",0.892993303809421,19,7,12,5.11262805703678,13.8873719429632
"2000","things aint",0.892993303809421,19,7,12,5.11262805703678,13.8873719429632
"2000","vodka",0.892993303809421,19,7,12,5.11262805703678,13.8873719429632
"2000","wanna let go",0.892993303809421,19,7,12,5.11262805703678,13.8873719429632
"2000","years old",0.892993303809421,19,7,12,5.11262805703678,13.8873719429632
"2000","youi know",0.892993303809421,19,7,12,5.11262805703678,13.8873719429632
"1980","man can",0.889848962432034,50,11,39,8.4117863821789,41.5882136178211
"1990","affection",0.886773568273256,40,11,29,8.48578783718126,31.5142121628187
"1990","can baby",0.886773568273256,40,11,29,8.48578783718126,31.5142121628187
"1990","love theres",0.886773568273256,40,11,29,8.48578783718126,31.5142121628187
"1990","still cant",0.886773568273256,40,11,29,8.48578783718126,31.5142121628187
"1990","waist",0.886773568273256,40,11,29,8.48578783718126,31.5142121628187
"1980","cant get",0.883312776690708,330,62,268,55.5177901223807,274.482209877619
"1980","almost",0.883174739478518,185,36,149,31.1236096140619,153.876390385938
"1980","every night",0.883174739478518,185,36,149,31.1236096140619,153.876390385938
"1980","just say",0.883122062914405,71,15,56,11.944736662694,59.055263337306
"1980","want one",0.883122062914405,71,15,56,11.944736662694,59.055263337306
"1970","diamonds",0.882140639057695,193,31,162,26.4116431257179,166.588356874282
"2000","want",0.882108320121233,6214,1705,4509,1672.09846033824,4541.90153966176
"1980","memories",0.881161761343204,163,32,131,27.4224236059032,135.577576394097
"1980","truth",0.879851782800307,302,57,245,50.8071897483605,251.192810251639
"1970","get head",0.878727885043172,74,13,61,10.1267439963892,63.8732560036107
"1980","forgot",0.878533658920531,87,18,69,14.6365083049913,72.3634916950087
"1980","gonna find",0.878533658920531,87,18,69,14.6365083049913,72.3634916950087
"1980","make right",0.878533658920531,87,18,69,14.6365083049913,72.3634916950087
"1960","better",0.877457564927013,1655,108,1547,98.8420174652064,1556.15798253479
"2010","way dont",0.874700928560276,66,13,53,10.1615397825781,55.8384602174219
"2010","make smile",0.872981192989396,49,10,39,7.54417347494436,41.4558265250556
"2010","wide",0.872897171580977,166,30,136,25.5578121804237,140.442187819576
"1970","falls",0.87163813865953,87,15,72,11.9057665903495,75.0942334096505
"1970","wanna rock",0.87163813865953,87,15,72,11.9057665903495,75.0942334096505
"1990","store",0.8711011783976,61,16,45,12.9408264517014,48.0591735482986
"2010","daydream",0.870460418283187,27,6,21,4.15699354741832,22.8430064525817
"2010","expect",0.870460418283187,27,6,21,4.15699354741832,22.8430064525817
"2010","girl dont know",0.870460418283187,27,6,21,4.15699354741832,22.8430064525817
"2010","heart beating",0.870460418283187,27,6,21,4.15699354741832,22.8430064525817
"2010","hoo hoo hoo",0.870460418283187,27,6,21,4.15699354741832,22.8430064525817
"2010","im alright",0.870460418283187,27,6,21,4.15699354741832,22.8430064525817
"2010","just stay",0.870460418283187,27,6,21,4.15699354741832,22.8430064525817
"2010","keep dancin",0.870460418283187,27,6,21,4.15699354741832,22.8430064525817
"2010","offer",0.870460418283187,27,6,21,4.15699354741832,22.8430064525817
"2010","till see",0.870460418283187,27,6,21,4.15699354741832,22.8430064525817
"2010","wire",0.870460418283187,27,6,21,4.15699354741832,22.8430064525817
"2010","world see",0.870460418283187,27,6,21,4.15699354741832,22.8430064525817
"1960","belong",0.868992968456914,302,22,280,18.0364285646479,283.963571435352
"1980","body baby",0.868659267329201,45,10,35,7.57060774396101,37.429392256039
"1980","come easy",0.868659267329201,45,10,35,7.57060774396101,37.429392256039
"1980","love still",0.868659267329201,45,10,35,7.57060774396101,37.429392256039
"1980","owe",0.868659267329201,45,10,35,7.57060774396101,37.429392256039
"1980","serious",0.868659267329201,45,10,35,7.57060774396101,37.429392256039
"1980","take higher",0.868659267329201,45,10,35,7.57060774396101,37.429392256039
"1980","whoo",0.868659267329201,45,10,35,7.57060774396101,37.429392256039
"1980","worries",0.868659267329201,45,10,35,7.57060774396101,37.429392256039
"1990","cheap",0.86801562488483,36,10,26,7.63720905346314,28.3627909465369
"1990","due",0.86801562488483,36,10,26,7.63720905346314,28.3627909465369
"1990","follow follow",0.86801562488483,36,10,26,7.63720905346314,28.3627909465369
"1990","got best",0.86801562488483,36,10,26,7.63720905346314,28.3627909465369
"1990","got give",0.86801562488483,36,10,26,7.63720905346314,28.3627909465369
"1990","granted",0.86801562488483,36,10,26,7.63720905346314,28.3627909465369
"1990","harm",0.86801562488483,36,10,26,7.63720905346314,28.3627909465369
"1990","knowi",0.86801562488483,36,10,26,7.63720905346314,28.3627909465369
"1990","love ever",0.86801562488483,36,10,26,7.63720905346314,28.3627909465369
"1990","neither",0.86801562488483,36,10,26,7.63720905346314,28.3627909465369
"1990","skinny",0.86801562488483,36,10,26,7.63720905346314,28.3627909465369
"1970","closed",0.867171882483848,55,10,45,7.52663405137039,47.4733659486296
"1970","love gonna",0.867171882483848,55,10,45,7.52663405137039,47.4733659486296
"1960","know ive",0.865182490379234,68,6,62,4.06118259071543,63.9388174092846
"1960","shinin",0.865182490379234,68,6,62,4.06118259071543,63.9388174092846
"1960","love let",0.86268275921329,110,9,101,6.56956007321613,103.430439926784
"2000","come girl",0.861779534348863,32,11,21,8.61074199079879,23.3892580092012
"2000","like go",0.861779534348863,32,11,21,8.61074199079879,23.3892580092012
"2000","pages",0.861779534348863,32,11,21,8.61074199079879,23.3892580092012
"2000","say now",0.861779534348863,32,11,21,8.61074199079879,23.3892580092012
"2000","thirty",0.861779534348863,32,11,21,8.61074199079879,23.3892580092012
"2000","yeah oh yeah oh",0.861779534348863,32,11,21,8.61074199079879,23.3892580092012
"2000","youre thinkin",0.861779534348863,32,11,21,8.61074199079879,23.3892580092012
"1980","play",0.860775182388799,1125,201,924,189.265193599025,935.734806400975
"1990","leavin",0.859693187381843,91,23,68,19.3051673295874,71.6948326704126
"2000","gimme",0.857548955679501,386,112,274,103.86707526401,282.13292473599
"1990","motherfucker",0.856368316212847,104,26,78,22.0630483766713,81.9369516233287
"2010","say ooh",0.854587086018383,38,8,30,5.85058351118134,32.1494164888187
"2010","think need",0.854587086018383,38,8,30,5.85058351118134,32.1494164888187
"2010","time go",0.854587086018383,38,8,30,5.85058351118134,32.1494164888187
"1960","hmm",0.854293218923398,96,8,88,5.7334342457159,90.2665657542841
"1980","gonna give",0.853975728142435,98,20,78,16.4871013090706,81.5128986909294
"1960","smiling",0.853630057737424,82,7,75,4.89730841821566,77.1026915817843
"1990","thinking",0.853595742617269,452,104,348,95.8894025601483,356.110597439852
"1990","baby time",0.852717502455384,32,9,23,6.78863026974501,25.211369730255
"1990","sleeps",0.852717502455384,32,9,23,6.78863026974501,25.211369730255
"1990","time cant",0.852717502455384,32,9,23,6.78863026974501,25.211369730255
"1990","whats mind",0.852717502455384,32,9,23,6.78863026974501,25.211369730255
"1990","yeah oh yeah oh",0.852717502455384,32,9,23,6.78863026974501,25.211369730255
"2000","againoh",0.851862207744397,16,6,10,4.3053709953994,11.6946290046006
"2000","anger",0.851862207744397,16,6,10,4.3053709953994,11.6946290046006
"2000","away much",0.851862207744397,16,6,10,4.3053709953994,11.6946290046006
"2000","backwards",0.851862207744397,16,6,10,4.3053709953994,11.6946290046006
"2000","basement",0.851862207744397,16,6,10,4.3053709953994,11.6946290046006
"2000","boy just",0.851862207744397,16,6,10,4.3053709953994,11.6946290046006
"2000","can ever",0.851862207744397,16,6,10,4.3053709953994,11.6946290046006
"2000","ever told",0.851862207744397,16,6,10,4.3053709953994,11.6946290046006
"2000","everything ill",0.851862207744397,16,6,10,4.3053709953994,11.6946290046006
"2000","eyes like",0.851862207744397,16,6,10,4.3053709953994,11.6946290046006
"2000","get paid",0.851862207744397,16,6,10,4.3053709953994,11.6946290046006
"2000","go ive",0.851862207744397,16,6,10,4.3053709953994,11.6946290046006
"2000","gonei",0.851862207744397,16,6,10,4.3053709953994,11.6946290046006
"2000","hey hey baby",0.851862207744397,16,6,10,4.3053709953994,11.6946290046006
"2000","im gonna miss",0.851862207744397,16,6,10,4.3053709953994,11.6946290046006
"2000","ima make",0.851862207744397,16,6,10,4.3053709953994,11.6946290046006
"2000","just cant take",0.851862207744397,16,6,10,4.3053709953994,11.6946290046006
"2000","just walk away",0.851862207744397,16,6,10,4.3053709953994,11.6946290046006
"2000","knew youd",0.851862207744397,16,6,10,4.3053709953994,11.6946290046006
"2000","know means",0.851862207744397,16,6,10,4.3053709953994,11.6946290046006
"2000","let nobody",0.851862207744397,16,6,10,4.3053709953994,11.6946290046006
"2000","make body",0.851862207744397,16,6,10,4.3053709953994,11.6946290046006
"2000","methe",0.851862207744397,16,6,10,4.3053709953994,11.6946290046006
"2000","need money",0.851862207744397,16,6,10,4.3053709953994,11.6946290046006
"2000","oh think",0.851862207744397,16,6,10,4.3053709953994,11.6946290046006
"2000","para",0.851862207744397,16,6,10,4.3053709953994,11.6946290046006
"2000","pause",0.851862207744397,16,6,10,4.3053709953994,11.6946290046006
"2000","say thats",0.851862207744397,16,6,10,4.3053709953994,11.6946290046006
"2000","say whatcha",0.851862207744397,16,6,10,4.3053709953994,11.6946290046006
"2000","see look",0.851862207744397,16,6,10,4.3053709953994,11.6946290046006
"2000","see wonder",0.851862207744397,16,6,10,4.3053709953994,11.6946290046006
"2000","sidewalk",0.851862207744397,16,6,10,4.3053709953994,11.6946290046006
"2000","think wanna",0.851862207744397,16,6,10,4.3053709953994,11.6946290046006
"2000","trying keep",0.851862207744397,16,6,10,4.3053709953994,11.6946290046006
"2000","two two",0.851862207744397,16,6,10,4.3053709953994,11.6946290046006
"2000","well feelin",0.851862207744397,16,6,10,4.3053709953994,11.6946290046006
"2000","words can",0.851862207744397,16,6,10,4.3053709953994,11.6946290046006
"2000","youi dont",0.851862207744397,16,6,10,4.3053709953994,11.6946290046006
"1980","fall apart",0.850682000482262,40,9,31,6.72942910574312,33.2705708942569
"1980","get mind",0.850682000482262,40,9,31,6.72942910574312,33.2705708942569
"1970","runnin",0.850057991982647,241,38,203,32.9803419341866,208.019658065813
"2000","advice",0.849068388260776,52,17,35,13.992455735048,38.007544264952
"2000","bread",0.849068388260776,52,17,35,13.992455735048,38.007544264952
"2000","hills",0.849068388260776,52,17,35,13.992455735048,38.007544264952
"2000","plenty",0.849068388260776,52,17,35,13.992455735048,38.007544264952
"2000","rent",0.849068388260776,52,17,35,13.992455735048,38.007544264952
"1990","anymore dont",0.847611675004126,20,6,14,4.24289391859063,15.7571060814094
"1990","boy want",0.847611675004126,20,6,14,4.24289391859063,15.7571060814094
"1990","can one",0.847611675004126,20,6,14,4.24289391859063,15.7571060814094
"1990","clubs",0.847611675004126,20,6,14,4.24289391859063,15.7571060814094
"1990","cuz im",0.847611675004126,20,6,14,4.24289391859063,15.7571060814094
"1990","get night",0.847611675004126,20,6,14,4.24289391859063,15.7571060814094
"1990","girlfriends",0.847611675004126,20,6,14,4.24289391859063,15.7571060814094
"1990","hand take",0.847611675004126,20,6,14,4.24289391859063,15.7571060814094
"1990","hey boy",0.847611675004126,20,6,14,4.24289391859063,15.7571060814094
"1990","inside im",0.847611675004126,20,6,14,4.24289391859063,15.7571060814094
"1990","just try",0.847611675004126,20,6,14,4.24289391859063,15.7571060814094
"1990","light shine",0.847611675004126,20,6,14,4.24289391859063,15.7571060814094
"1990","much can",0.847611675004126,20,6,14,4.24289391859063,15.7571060814094
"1990","never fall love",0.847611675004126,20,6,14,4.24289391859063,15.7571060814094
"1990","ooh like",0.847611675004126,20,6,14,4.24289391859063,15.7571060814094
"1990","rain let",0.847611675004126,20,6,14,4.24289391859063,15.7571060814094
"1990","take like",0.847611675004126,20,6,14,4.24289391859063,15.7571060814094
"1990","think every",0.847611675004126,20,6,14,4.24289391859063,15.7571060814094
"1990","think youll",0.847611675004126,20,6,14,4.24289391859063,15.7571060814094
"1990","time let",0.847611675004126,20,6,14,4.24289391859063,15.7571060814094
"1990","try find",0.847611675004126,20,6,14,4.24289391859063,15.7571060814094
"1960","bye",0.846774084294218,183,14,169,10.9293590308959,172.070640969104
"1980","can give",0.845679696089047,82,17,65,13.7953296667734,68.2046703332266
"2000","cant fight",0.842827886306918,42,14,28,11.3015988629234,30.6984011370766
"2000","never really",0.842827886306918,42,14,28,11.3015988629234,30.6984011370766
"2000","think ill",0.842827886306918,42,14,28,11.3015988629234,30.6984011370766
"2000","wanna kiss",0.842827886306918,42,14,28,11.3015988629234,30.6984011370766
"1990","day now",0.842323596188914,28,8,20,5.94005148602689,22.0599485139731
"1990","frustrated",0.842323596188914,28,8,20,5.94005148602689,22.0599485139731
"1990","gonna try",0.842323596188914,28,8,20,5.94005148602689,22.0599485139731
"1990","ill come",0.842323596188914,28,8,20,5.94005148602689,22.0599485139731
"1990","imagination",0.842323596188914,28,8,20,5.94005148602689,22.0599485139731
"1990","just cant get enough",0.842323596188914,28,8,20,5.94005148602689,22.0599485139731
"1990","know place",0.842323596188914,28,8,20,5.94005148602689,22.0599485139731
"1990","leave behind",0.842323596188914,28,8,20,5.94005148602689,22.0599485139731
"1990","lettin",0.842323596188914,28,8,20,5.94005148602689,22.0599485139731
"1990","love really",0.842323596188914,28,8,20,5.94005148602689,22.0599485139731
"1990","make make make",0.842323596188914,28,8,20,5.94005148602689,22.0599485139731
"1990","right yeah",0.842323596188914,28,8,20,5.94005148602689,22.0599485139731
"1990","shouldve known",0.842323596188914,28,8,20,5.94005148602689,22.0599485139731
"1990","uh huh uh",0.841540452388577,57,15,42,12.0922476679833,44.9077523320167
"1960","da da da",0.841139829055357,303,22,281,18.0961518380408,284.903848161959
"1990","fell love",0.840684066387024,74,19,55,15.6987074987853,58.3012925012147
"1970","cant stand",0.840409468830785,107,18,89,14.6427244272115,92.3572755727885
"1970","dawn",0.840409468830785,107,18,89,14.6427244272115,92.3572755727885
"1970","brothers",0.839754029206648,68,12,56,9.30565664533066,58.6943433546693
"1970","look around",0.839754029206648,68,12,56,9.30565664533066,58.6943433546693
"1970","gonna",0.839488219351253,4550,644,3906,622.657907886096,3927.3420921139
"1990","baby love way",0.839214085065938,24,7,17,5.09147270230876,18.9085272976912
"1990","baby ooo",0.839214085065938,24,7,17,5.09147270230876,18.9085272976912
"1990","bold",0.839214085065938,24,7,17,5.09147270230876,18.9085272976912
"1990","brave",0.839214085065938,24,7,17,5.09147270230876,18.9085272976912
"1990","bubble",0.839214085065938,24,7,17,5.09147270230876,18.9085272976912
"1990","comin home",0.839214085065938,24,7,17,5.09147270230876,18.9085272976912
"1990","ever loved",0.839214085065938,24,7,17,5.09147270230876,18.9085272976912
"1990","ever made",0.839214085065938,24,7,17,5.09147270230876,18.9085272976912
"1990","feel body",0.839214085065938,24,7,17,5.09147270230876,18.9085272976912
"1990","hear im",0.839214085065938,24,7,17,5.09147270230876,18.9085272976912
"1990","im fool",0.839214085065938,24,7,17,5.09147270230876,18.9085272976912
"1990","just follow",0.839214085065938,24,7,17,5.09147270230876,18.9085272976912
"1990","love makes",0.839214085065938,24,7,17,5.09147270230876,18.9085272976912
"1990","rang",0.839214085065938,24,7,17,5.09147270230876,18.9085272976912
"1990","see time",0.839214085065938,24,7,17,5.09147270230876,18.9085272976912
"1990","stormy",0.839214085065938,24,7,17,5.09147270230876,18.9085272976912
"1990","thought love",0.839214085065938,24,7,17,5.09147270230876,18.9085272976912
"1990","wanna right",0.839214085065938,24,7,17,5.09147270230876,18.9085272976912
"1990","youits",0.839214085065938,24,7,17,5.09147270230876,18.9085272976912
"2000","worse",0.838113181976074,69,22,47,18.5669124176599,50.4330875823401
"1980","ive gotta",0.837252463266371,35,8,27,5.88825046752523,29.1117495324748
"1980","love better",0.837252463266371,35,8,27,5.88825046752523,29.1117495324748
"1980","love let love",0.837252463266371,35,8,27,5.88825046752523,29.1117495324748
"1980","oh thats",0.837252463266371,35,8,27,5.88825046752523,29.1117495324748
"1980","romantic",0.837252463266371,35,8,27,5.88825046752523,29.1117495324748
"1980","try get",0.837252463266371,35,8,27,5.88825046752523,29.1117495324748
"1980","youll ever",0.837252463266371,35,8,27,5.88825046752523,29.1117495324748
"1970","mind im",0.835091844963474,49,9,40,6.7055467003118,42.2944532996882
"1980","hold dont",0.834509085961634,25,6,19,4.20589319108945,20.7941068089106
"1980","life got",0.834509085961634,25,6,19,4.20589319108945,20.7941068089106
"1980","life one",0.834509085961634,25,6,19,4.20589319108945,20.7941068089106
"1980","night gonna",0.834509085961634,25,6,19,4.20589319108945,20.7941068089106
"1980","oh one",0.834509085961634,25,6,19,4.20589319108945,20.7941068089106
"1980","oh wow",0.834509085961634,25,6,19,4.20589319108945,20.7941068089106
"1980","said youd",0.834509085961634,25,6,19,4.20589319108945,20.7941068089106
"1980","things cant",0.834509085961634,25,6,19,4.20589319108945,20.7941068089106
"1980","time cause",0.834509085961634,25,6,19,4.20589319108945,20.7941068089106
"1980","time now",0.834509085961634,25,6,19,4.20589319108945,20.7941068089106
"1980","unkind",0.834509085961634,25,6,19,4.20589319108945,20.7941068089106
"1980","want life",0.834509085961634,25,6,19,4.20589319108945,20.7941068089106
"1980","whispered",0.834509085961634,25,6,19,4.20589319108945,20.7941068089106
"1980","yeahand",0.834509085961634,25,6,19,4.20589319108945,20.7941068089106
"1970","will find",0.831963298522005,94,16,78,12.8637018332512,81.1362981667488
"1980","became",0.830566533148177,30,7,23,5.04707182930734,24.9529281706927
"1980","crashing",0.830566533148177,30,7,23,5.04707182930734,24.9529281706927
"1980","left right",0.830566533148177,30,7,23,5.04707182930734,24.9529281706927
"1980","one loves",0.830566533148177,30,7,23,5.04707182930734,24.9529281706927
"1980","really know",0.830566533148177,30,7,23,5.04707182930734,24.9529281706927
"1980","roll come",0.830566533148177,30,7,23,5.04707182930734,24.9529281706927
"1980","thati",0.830566533148177,30,7,23,5.04707182930734,24.9529281706927
"1980","together now",0.830566533148177,30,7,23,5.04707182930734,24.9529281706927
"1980","youre leaving",0.830566533148177,30,7,23,5.04707182930734,24.9529281706927
"1970","dying",0.830462803652543,81,14,67,11.0846792392909,69.9153207607091
"1970","walk",0.830352323293297,994,146,848,136.026804492039,857.973195507961
"1980","sounds",0.825688504081882,120,24,96,20.1882873172294,99.8117126827707
"1980","wow",0.825688504081882,120,24,96,20.1882873172294,99.8117126827707
"2010","ice",0.824521014899641,215,38,177,33.1019856553681,181.898014344632
"1970","will",0.82363261107426,3611,513,3098,494.157737445427,3116.84226255457
"1970","first",0.823518370918478,706,105,601,96.6146116412271,609.385388358773
"1990","dont let go",0.823431073281583,100,25,75,21.2144695929532,78.7855304070468
"1990","know wanna",0.823431073281583,100,25,75,21.2144695929532,78.7855304070468
"1980","knockin",0.82328227328779,61,13,48,10.2623793862583,50.7376206137417
"1980","worry",0.819483480010259,292,55,237,49.1248324719247,242.875167528075
"1990","secret",0.81898319743504,179,43,136,37.9739005713862,141.026099428614
"2000","force",0.815023267373781,76,24,52,20.4505122281471,55.5494877718529
"2000","said im",0.815023267373781,76,24,52,20.4505122281471,55.5494877718529
"1980","baby tell",0.813025115380105,77,16,61,12.9541510285555,64.0458489714445
"1990","tonight baby",0.812483407591072,53,14,39,11.2436688842652,41.7563311157348
"2010","wanna make",0.809906876283344,161,29,132,24.7879985605315,136.212001439469
"1990","missing",0.808891588460259,188,45,143,39.8832028347519,148.116797165248
"1990","youre looking",0.808764006645994,70,18,52,14.8501287150672,55.1498712849328
"1970","since",0.808713394777929,497,75,422,68.0134022460197,428.98659775398
"1980","will never",0.808208829077488,253,48,205,42.5636390938252,210.436360906175
"1970","baby oh",0.806654317108198,154,25,129,21.0745753438371,132.925424656163
"1960","ring",0.805413079541844,274,20,254,16.3641769096475,257.635823090353
"1960","cant help",0.805378445844463,199,15,184,11.8849314051819,187.115068594818
"1960","news",0.805006653719217,69,6,63,4.1209058641083,64.8790941358917
"1960","beating",0.804372729317733,97,8,89,5.79315751910877,91.2068424808912
"2000","dont know say",0.803176854925663,29,10,19,7.80348492916141,21.1965150708386
"2000","im gonna show",0.803176854925663,29,10,19,7.80348492916141,21.1965150708386
"2000","love see",0.803176854925663,29,10,19,7.80348492916141,21.1965150708386
"2000","man aint",0.803176854925663,29,10,19,7.80348492916141,21.1965150708386
"2000","see like",0.803176854925663,29,10,19,7.80348492916141,21.1965150708386
"2000","sharp",0.803176854925663,29,10,19,7.80348492916141,21.1965150708386
"2000","surprised",0.803176854925663,29,10,19,7.80348492916141,21.1965150708386
"2000","teardrops",0.803176854925663,29,10,19,7.80348492916141,21.1965150708386
"2000","thought youd",0.803176854925663,29,10,19,7.80348492916141,21.1965150708386
"2000","time feel",0.803176854925663,29,10,19,7.80348492916141,21.1965150708386
"2000","times ive",0.803176854925663,29,10,19,7.80348492916141,21.1965150708386
"2000","tonighti",0.803176854925663,29,10,19,7.80348492916141,21.1965150708386
"2000","want cause",0.803176854925663,29,10,19,7.80348492916141,21.1965150708386
"2000","way cause",0.803176854925663,29,10,19,7.80348492916141,21.1965150708386
"1990","anyway",0.802121479335304,122,30,92,25.8816529034029,96.1183470965971
"1970","one two three",0.801485789554546,62,11,51,8.48456929427207,53.5154307057279
"1960","bell",0.79945852198495,83,7,76,4.95703169160854,78.0429683083915
"1960","spin",0.79945852198495,83,7,76,4.95703169160854,78.0429683083915
"2010","around comes",0.79795467458656,44,9,35,6.77435985505208,37.2256401449479
"1970","back back",0.797840468541619,101,17,84,13.8216370761529,87.1783629238471
"1990","beside",0.796142990275131,144,35,109,30.5488362138526,113.451163786147
"1990","cant hear",0.794169972733573,83,21,62,17.6080097621511,65.3919902378489
"1960","years",0.791752413712745,412,29,383,24.6059886378641,387.394011362136
"1970","lifetime",0.789525661907741,75,13,62,10.2635918882323,64.7364081117677
"2000","motherfuckin",0.789459070530265,49,16,33,13.1851986734107,35.8148013265894
"2000","regret",0.789459070530265,49,16,33,13.1851986734107,35.8148013265894
"1990","little",0.786519387232794,2553,560,1993,541.605408708094,2011.39459129191
"1990","know love",0.78620641185303,318,74,244,67.4620133055911,250.537986694409
"2010","coffee",0.782866278965931,33,7,26,5.08076989128906,27.9192301087109
"2010","famous",0.782866278965931,33,7,26,5.08076989128906,27.9192301087109
"2010","system",0.782866278965931,33,7,26,5.08076989128906,27.9192301087109
"2010","thats wanna",0.782866278965931,33,7,26,5.08076989128906,27.9192301087109
"2010","wanna fuck",0.782866278965931,33,7,26,5.08076989128906,27.9192301087109
"2010","youso",0.782866278965931,33,7,26,5.08076989128906,27.9192301087109
"2000","forgotten",0.782625894427852,39,13,26,10.494341801286,28.505658198714
"2000","worried",0.782625894427852,39,13,26,10.494341801286,28.505658198714
"2000","got need",0.780921822462902,66,21,45,17.7596553560225,48.2403446439775
"2000","make em",0.780921822462902,66,21,45,17.7596553560225,48.2403446439775
"1970","now think",0.780913829053296,37,7,30,5.06337199819462,31.9366280018054
"1970","really care",0.780913829053296,37,7,30,5.06337199819462,31.9366280018054
"1970","shiny",0.780913829053296,37,7,30,5.06337199819462,31.9366280018054
"1970","turn away",0.780913829053296,37,7,30,5.06337199819462,31.9366280018054
"1990","clear",0.78080304937995,224,53,171,47.5204118882151,176.479588111785
"1980","set free",0.780611044871529,72,15,57,12.1129723903376,59.8870276096624
"1990","iti",0.776966442208741,66,17,49,14.0015499313491,51.9984500686509
"1990","open eyes",0.776966442208741,66,17,49,14.0015499313491,51.9984500686509
"1960","almost",0.776545653323828,185,14,171,11.0488055776817,173.951194422318
"2000","pain",0.775628473935381,524,150,374,141.00090009933,382.99909990067
"1970","somewhere",0.772275202175468,229,36,193,31.3381672320694,197.661832767931
"2010","dont understand",0.767782708275583,108,20,88,16.6279741896733,91.3720258103267
"1980","just come",0.766895307968189,51,11,40,8.58002210982247,42.4199778901775
"2010","night",0.766560543128712,3598,573,3025,553.957880874486,3044.04211912551
"1990","hoes",0.76418226228475,269,63,206,57.066923205044,211.933076794956
"1970","gotta go",0.76414599003354,56,10,46,7.66348194321348,48.3365180567865
"1970","nothing nothing",0.76414599003354,56,10,46,7.66348194321348,48.3365180567865
"2000","peace",0.763025559936988,167,50,117,44.9373097644812,122.062690235519
"1970","another man",0.762538594081902,31,6,25,4.24228464713604,26.757715352864
"1970","ba ba ba",0.762538594081902,31,6,25,4.24228464713604,26.757715352864
"1970","chills",0.762538594081902,31,6,25,4.24228464713604,26.757715352864
"1970","come can",0.762538594081902,31,6,25,4.24228464713604,26.757715352864
"1970","drinkin",0.762538594081902,31,6,25,4.24228464713604,26.757715352864
"1970","fine youre",0.762538594081902,31,6,25,4.24228464713604,26.757715352864
"1970","gonna know",0.762538594081902,31,6,25,4.24228464713604,26.757715352864
"1970","listen baby",0.762538594081902,31,6,25,4.24228464713604,26.757715352864
"1970","love youi",0.762538594081902,31,6,25,4.24228464713604,26.757715352864
"1970","surrounded",0.762538594081902,31,6,25,4.24228464713604,26.757715352864
"1970","though know",0.762538594081902,31,6,25,4.24228464713604,26.757715352864
"1970","time take",0.762538594081902,31,6,25,4.24228464713604,26.757715352864
"1970","want fly",0.762538594081902,31,6,25,4.24228464713604,26.757715352864
"1990","ill love",0.761434970357118,79,20,59,16.759430978433,62.240569021567
"1990","never thought",0.76106719127417,105,26,79,22.2751930726008,82.7248069273992
"1980","songs",0.75954368040429,187,36,151,31.4600810693491,155.539918930651
"2000","jet",0.759229467968721,73,23,50,19.6432551665097,53.3567448334902
"2000","oh cant",0.759229467968721,73,23,50,19.6432551665097,53.3567448334902
"2000","time get",0.759229467968721,73,23,50,19.6432551665097,53.3567448334902
"1960","im going",0.757063928337808,156,12,144,9.31683064928833,146.683169350712
"1980","went",0.756290392669259,378,70,308,63.5931050492725,314.406894950728
"2010","shore",0.756001513729498,50,10,40,7.69813619892281,42.3018638010772
"2000","american",0.755131518132456,125,38,87,33.6357109015578,91.3642890984422
"2000","im feeling",0.754244095781099,132,40,92,35.519310712045,96.480689287955
"2010","begging",0.753837770137064,73,14,59,11.2392788504273,61.7607211495727
"2010","exactly",0.753837770137064,73,14,59,11.2392788504273,61.7607211495727
"2000","faithful",0.751544271881317,56,18,38,15.0687984838979,40.9312015161021
"2000","gotta go",0.751544271881317,56,18,38,15.0687984838979,40.9312015161021
"2000","pictures",0.751544271881317,56,18,38,15.0687984838979,40.9312015161021
"1990","seems",0.750702179345344,477,109,368,101.193019958387,375.806980041613
"1970","questions",0.748888166184018,69,12,57,9.44250453717376,59.5574954628262
"1970","riding",0.748888166184018,69,12,57,9.44250453717376,59.5574954628262
"1970","stood",0.748888166184018,69,12,57,9.44250453717376,59.5574954628262
"1970","youve gone",0.748888166184018,69,12,57,9.44250453717376,59.5574954628262
"1980","girl want",0.748490761289228,67,14,53,11.2717937521197,55.7282062478803
"1980","know way",0.748490761289228,67,14,53,11.2717937521197,55.7282062478803
"2010","im sorry",0.747967176702633,144,26,118,22.1706322528977,121.829367747102
"1960","understand",0.747043056605895,585,40,545,34.9381149348313,550.061885065169
"1990","busy",0.745314920140802,62,16,46,13.152971147631,48.847028852369
"1990","hurting",0.745314920140802,62,16,46,13.152971147631,48.847028852369
"1990","sorrow",0.745314920140802,62,16,46,13.152971147631,48.847028852369
"2000","always one",0.744941037133788,26,9,17,6.99622786752402,19.003772132476
"2000","away cause",0.744941037133788,26,9,17,6.99622786752402,19.003772132476
"2000","baby never",0.744941037133788,26,9,17,6.99622786752402,19.003772132476
"2000","crazy love",0.744941037133788,26,9,17,6.99622786752402,19.003772132476
"2000","everybody just",0.744941037133788,26,9,17,6.99622786752402,19.003772132476
"2000","go see",0.744941037133788,26,9,17,6.99622786752402,19.003772132476
"2000","hard believe",0.744941037133788,26,9,17,6.99622786752402,19.003772132476
"2000","nails",0.744941037133788,26,9,17,6.99622786752402,19.003772132476
"2000","now bring",0.744941037133788,26,9,17,6.99622786752402,19.003772132476
"2000","real slow",0.744941037133788,26,9,17,6.99622786752402,19.003772132476
"2000","witness",0.744941037133788,26,9,17,6.99622786752402,19.003772132476
"2000","find love",0.742945565078889,80,25,55,21.526854976997,58.473145023003
"1970","move move",0.74233876719889,115,19,96,15.7375075619563,99.2624924380437
"1990","whats",0.741171412180229,847,190,657,179.686557452313,667.313442547687
"1980","loneliness",0.740686543842493,46,10,36,7.73884347160458,38.2611565283954
"1980","nothing else",0.740686543842493,46,10,36,7.73884347160458,38.2611565283954
"2010","ill love",0.737680685480592,79,15,64,12.163055194298,66.8369448057019
"1990","freedom",0.737019809203475,114,28,86,24.1844953359666,89.8155046640334
"1990","hear say",0.737019809203475,114,28,86,24.1844953359666,89.8155046640334
"1990","nothing can",0.737019809203475,114,28,86,24.1844953359666,89.8155046640334
"1990","sit",0.73681248541123,265,62,203,56.2183444213259,208.781655578674
"2000","meet",0.735350343596579,381,110,271,102.521646827948,278.478353172052
"2000","horse",0.72992734941168,46,15,31,12.3779416117733,33.6220583882267
"2000","meand",0.72992734941168,46,15,31,12.3779416117733,33.6220583882267
"2000","nothing else",0.72992734941168,46,15,31,12.3779416117733,33.6220583882267
"2000","put hand",0.72992734941168,46,15,31,12.3779416117733,33.6220583882267
"2000","see got",0.72992734941168,46,15,31,12.3779416117733,33.6220583882267
"2000","fell",0.729837615857765,224,66,158,60.2751939355916,163.724806064408
"1990","go want",0.729786848671372,41,11,30,8.6979325331108,32.3020674668892
"1990","shes one",0.729786848671372,41,11,30,8.6979325331108,32.3020674668892
"1990","yeah wanna",0.729786848671372,41,11,30,8.6979325331108,32.3020674668892
"1990","business",0.728721477445122,75,19,56,15.9108521947149,59.0891478052851
"1990","know whats",0.728721477445122,75,19,56,15.9108521947149,59.0891478052851
"1990","lifetime",0.728721477445122,75,19,56,15.9108521947149,59.0891478052851
"1990","plus",0.728256222563817,101,25,76,21.4266142888827,79.5733857111173
"1970","ill get",0.728062354275258,50,9,41,6.8423945921549,43.1576054078451
"1970","knowin",0.728062354275258,50,9,41,6.8423945921549,43.1576054078451
"1970","long ago",0.728062354275258,50,9,41,6.8423945921549,43.1576054078451
"1970","opened",0.728062354275258,50,9,41,6.8423945921549,43.1576054078451
"1970","whats going",0.728062354275258,50,9,41,6.8423945921549,43.1576054078451
"1980","whenever",0.726974895274525,182,35,147,30.6189024311312,151.381097568869
"1970","fingers",0.725551054808456,102,17,85,13.958484967996,88.041515032004
"1970","workin",0.725551054808456,102,17,85,13.958484967996,88.041515032004
"1970","take",0.724925975723046,4302,608,3694,588.719630709007,3713.28036929099
"2010","spinning",0.724731919372303,85,16,69,13.0868315381688,71.9131684618312
"1980","soon",0.724696553952464,294,55,239,49.4613039272119,244.538696072788
"2010","long way",0.724182690570143,56,11,45,8.62191254279355,47.3780874572064
"2010","see know",0.724182690570143,56,11,45,8.62191254279355,47.3780874572064
"2010","beat goes",0.723074323171843,39,8,31,6.0045462351598,32.9954537648402
"2010","bother",0.723074323171843,39,8,31,6.0045462351598,32.9954537648402
"2010","make believe",0.723074323171843,39,8,31,6.0045462351598,32.9954537648402
"2010","now let",0.723074323171843,39,8,31,6.0045462351598,32.9954537648402
"2010","yea yea yea",0.723074323171843,39,8,31,6.0045462351598,32.9954537648402
"2000","granted",0.722423902548773,36,12,24,9.68708473964864,26.3129152603514
"2000","packed",0.722423902548773,36,12,24,9.68708473964864,26.3129152603514
"2000","records",0.722423902548773,36,12,24,9.68708473964864,26.3129152603514
"2000","tonight ill",0.722423902548773,36,12,24,9.68708473964864,26.3129152603514
"2000","wait till",0.722423902548773,36,12,24,9.68708473964864,26.3129152603514
"1980","answer",0.721175754582955,171,33,138,28.7683094270518,142.231690572948
"1960","piece",0.720672448972524,157,12,145,9.37655392268121,147.623446077319
"1960","shame",0.720672448972524,157,12,145,9.37655392268121,147.623446077319
"1970","feet",0.71892190232187,347,53,294,47.486218469555,299.513781530445
"1970","ha ha",0.717612974227805,237,37,200,32.4329503668142,204.567049633186
"2000","feels",0.717579634376628,446,128,318,120.012216496758,325.987783503242
"1980","give away",0.716734534124578,62,13,49,10.4306151139018,51.5693848860982
"1980","doggone",0.716432370547649,41,9,32,6.8976648333867,34.1023351666133
"1980","mind cause",0.716432370547649,41,9,32,6.8976648333867,34.1023351666133
"1980","pity",0.716432370547649,41,9,32,6.8976648333867,34.1023351666133
"1980","say got",0.716432370547649,41,9,32,6.8976648333867,34.1023351666133
"2010","go away",0.71437418715873,91,17,74,14.0106078820395,76.9893921179605
"1990","huh uh huh",0.713839436508728,58,15,43,12.3043923639128,45.6956076360872
"1960","sittin",0.713766595590122,172,13,159,10.2724030235743,161.727596976426
"1990","livin",0.713587267550722,351,81,270,74.4627882712656,276.537211728734
"1970","brings",0.712747021434678,89,15,74,12.1794623740357,76.8205376259643
"2010","deck",0.712507893798482,28,6,22,4.31095627139678,23.6890437286032
"2010","ever say",0.712507893798482,28,6,22,4.31095627139678,23.6890437286032
"2010","hype",0.712507893798482,28,6,22,4.31095627139678,23.6890437286032
"2010","ill good",0.712507893798482,28,6,22,4.31095627139678,23.6890437286032
"2010","just right",0.712507893798482,28,6,22,4.31095627139678,23.6890437286032
"2010","like youve",0.712507893798482,28,6,22,4.31095627139678,23.6890437286032
"2010","open wide",0.712507893798482,28,6,22,4.31095627139678,23.6890437286032
"2010","right yeah",0.712507893798482,28,6,22,4.31095627139678,23.6890437286032
"2010","superstar",0.712507893798482,28,6,22,4.31095627139678,23.6890437286032
"2010","used know",0.712507893798482,28,6,22,4.31095627139678,23.6890437286032
"2000","taken",0.7111048976801,108,33,75,29.0612542189459,78.9387457810541
"1970","just want",0.71042613167752,244,38,206,33.3908856097159,210.609114390284
"1970","hill",0.708634901046653,63,11,52,8.62141718611517,54.3785828138848
"1970","state",0.708634901046653,63,11,52,8.62141718611517,54.3785828138848
"2000","theres something",0.707222281068722,122,37,85,32.8284538399204,89.1715461600796
"1970","way can",0.705915445220403,76,13,63,10.4004397800754,65.5995602199246
"1990","bless",0.704506105691482,37,10,27,7.84935374939267,29.1506462506073
"1990","every move",0.704506105691482,37,10,27,7.84935374939267,29.1506462506073
"1990","forever forever",0.704506105691482,37,10,27,7.84935374939267,29.1506462506073
"1990","get got",0.704506105691482,37,10,27,7.84935374939267,29.1506462506073
"1990","never ends",0.704506105691482,37,10,27,7.84935374939267,29.1506462506073
"2000","never get",0.703817506443554,70,22,48,18.8359981048724,51.1640018951276
"2000","wont give",0.703817506443554,70,22,48,18.8359981048724,51.1640018951276
"1980","cause dont",0.701568388719943,188,36,152,31.6283167969926,156.371683203007
"1990","earth",0.700742852304739,132,32,100,28.0030998626982,103.996900137302
"2000","take",0.700178847489099,4302,1182,3120,1157.60662638801,3144.39337361199
"1980","miscellaneous",0.699942217142787,89,18,71,14.9729797602784,74.0270202397216
"1980","self",0.699942217142787,89,18,71,14.9729797602784,74.0270202397216
"1980","skies",0.699942217142787,89,18,71,14.9729797602784,74.0270202397216
"1970","gonna love",0.6997554847645,109,18,91,14.9164202108977,94.0835797891023
"2010","bullet",0.699656468614815,62,12,50,9.54568888666429,52.4543111133357
"1970","walkin",0.699366792210048,129,21,108,17.6533780477596,111.34662195224
"1960","someone else",0.697719281059349,85,7,78,5.07647823839428,79.9235217616057
"1960","spinning",0.697719281059349,85,7,78,5.07647823839428,79.9235217616057
"1960","without love",0.697719281059349,85,7,78,5.07647823839428,79.9235217616057
"1990","cause ive",0.69603311826855,71,18,53,15.0622734109967,55.9377265890033
"1990","happiness",0.69603311826855,71,18,53,15.0622734109967,55.9377265890033
"1990","heads",0.69603311826855,71,18,53,15.0622734109967,55.9377265890033
"1980","theres place",0.694927413863351,36,8,28,6.05648619516881,29.9435138048312
"2010","baby got",0.694667623021067,109,20,89,16.7819369136517,92.2180630863483
"1970","baddest",0.693737505987059,44,8,36,6.02130724109631,37.9786927589037
"1970","cant stay",0.693737505987059,44,8,36,6.02130724109631,37.9786927589037
"1970","im talkin",0.693737505987059,44,8,36,6.02130724109631,37.9786927589037
"1970","meoh",0.693737505987059,44,8,36,6.02130724109631,37.9786927589037
"1970","touching",0.693737505987059,44,8,36,6.02130724109631,37.9786927589037
"1970","went away",0.693737505987059,44,8,36,6.02130724109631,37.9786927589037
"2000","make change",0.693389639329194,53,17,36,14.2615414222605,38.7384585777395
"2000","makes wanna",0.693389639329194,53,17,36,14.2615414222605,38.7384585777395
"1960","anytime",0.69285553751288,71,6,65,4.24035241089405,66.759647589106
"1960","happiness",0.69285553751288,71,6,65,4.24035241089405,66.759647589106
"1960","say name",0.69285553751288,71,6,65,4.24035241089405,66.759647589106
"2000","roses",0.68897022002916,77,24,53,20.7195979153596,56.2804020846404
"1980","reason",0.688923370458671,340,63,277,57.2001473988165,282.799852601183
"2010","hoo",0.687876045973123,157,28,129,24.1721476646176,132.827852335382
"2000","free soul",0.687214689842412,23,8,15,6.18897080588663,16.8110291941134
"2000","love deep love",0.687214689842412,23,8,15,6.18897080588663,16.8110291941134
"2000","now put",0.687214689842412,23,8,15,6.18897080588663,16.8110291941134
"2000","oh oh im",0.687214689842412,23,8,15,6.18897080588663,16.8110291941134
"2000","old school",0.687214689842412,23,8,15,6.18897080588663,16.8110291941134
"2000","song just",0.687214689842412,23,8,15,6.18897080588663,16.8110291941134
"2000","stumble",0.687214689842412,23,8,15,6.18897080588663,16.8110291941134
"2000","swingin",0.687214689842412,23,8,15,6.18897080588663,16.8110291941134
"2000","tried hard",0.687214689842412,23,8,15,6.18897080588663,16.8110291941134
"2000","uncle",0.687214689842412,23,8,15,6.18897080588663,16.8110291941134
"2000","way goes",0.687214689842412,23,8,15,6.18897080588663,16.8110291941134
"1980","dreams come",0.685436988924677,57,12,45,9.58943647568394,47.4105635243161
"1980","see baby",0.685436988924677,57,12,45,9.58943647568394,47.4105635243161
"1980","youoh",0.685436988924677,57,12,45,9.58943647568394,47.4105635243161
"2010","cant stop",0.684620443509713,236,41,195,36.3352028589157,199.664797141084
"2000","treat",0.68416243636346,321,93,228,86.3765055952004,234.6234944048
"1980","means",0.683390719898401,155,30,125,26.0765377847546,128.923462215245
"1970","smokin",0.682871580996213,96,16,80,13.1373976169374,82.8626023830626
"1990","bunch",0.682578806699462,54,14,40,11.4558135801947,42.5441864198053
"1990","ever since",0.682578806699462,54,14,40,11.4558135801947,42.5441864198053
"1990","one chance",0.682578806699462,54,14,40,11.4558135801947,42.5441864198053
"1990","real real",0.682578806699462,54,14,40,11.4558135801947,42.5441864198053
"1990","boy got",0.681047809333329,33,9,24,7.00077496567454,25.9992250343255
"1990","feel fine",0.681047809333329,33,9,24,7.00077496567454,25.9992250343255
"1990","like need",0.681047809333329,33,9,24,7.00077496567454,25.9992250343255
"1990","now take",0.681047809333329,33,9,24,7.00077496567454,25.9992250343255
"2010","course",0.680401362356548,45,9,36,6.92832257903053,38.0716774209695
"2010","day every",0.680401362356548,45,9,36,6.92832257903053,38.0716774209695
"2010","thank god",0.680401362356548,45,9,36,6.92832257903053,38.0716774209695
"2010","wait minute",0.680401362356548,45,9,36,6.92832257903053,38.0716774209695
"2010","wanna one",0.680401362356548,45,9,36,6.92832257903053,38.0716774209695
"2010","im gonna",0.679474202855104,1035,169,866,159.351419317702,875.648580682298
"1980","live life",0.67816973366647,122,24,98,20.5247587725165,101.475241227483
"2000","sand",0.678157580935011,84,26,58,22.6031977258468,61.3968022741532
"1960","shell",0.677538875458894,203,15,188,12.1238244987534,190.876175501247
"1980","cause wanna",0.677465088359236,31,7,24,5.21530755695092,25.7846924430491
"1980","crazy crazy",0.677465088359236,31,7,24,5.21530755695092,25.7846924430491
"1980","credit",0.677465088359236,31,7,24,5.21530755695092,25.7846924430491
"1980","day oh",0.677465088359236,31,7,24,5.21530755695092,25.7846924430491
"1980","explode",0.677465088359236,31,7,24,5.21530755695092,25.7846924430491
"1980","smiled",0.677465088359236,31,7,24,5.21530755695092,25.7846924430491
"1980","till end",0.677465088359236,31,7,24,5.21530755695092,25.7846924430491
"1980","will get",0.677465088359236,31,7,24,5.21530755695092,25.7846924430491
"1980","youll get",0.677465088359236,31,7,24,5.21530755695092,25.7846924430491
"1980","youve given",0.677465088359236,31,7,24,5.21530755695092,25.7846924430491
"1960","let",0.672940460667977,4927,308,4619,294.25656800669,4632.74343199331
"1990","just way",0.672035291150123,106,26,80,22.4873377685304,83.5126622314696
"2000","can hide",0.670489532411463,43,14,29,11.5706845501359,31.4293154498641
"2000","get lost",0.670489532411463,43,14,29,11.5706845501359,31.4293154498641
"2000","god knows",0.670489532411463,43,14,29,11.5706845501359,31.4293154498641
"2000","got lot",0.670489532411463,43,14,29,11.5706845501359,31.4293154498641
"2000","gotta know",0.670489532411463,43,14,29,11.5706845501359,31.4293154498641
"2000","let burn",0.670489532411463,43,14,29,11.5706845501359,31.4293154498641
"2000","look good",0.670489532411463,43,14,29,11.5706845501359,31.4293154498641
"2000","tuesday",0.670489532411463,43,14,29,11.5706845501359,31.4293154498641
"1970","touched",0.670228995678007,83,14,69,11.3583750229771,71.6416249770229
"1990","one time",0.669995717855786,199,47,152,42.2167944899768,156.783205510023
"1970","blows",0.668885599626945,57,10,47,7.80032983505658,49.1996701649434
"1970","im telling",0.668885599626945,57,10,47,7.80032983505658,49.1996701649434
"2000","wait",0.66841923053639,758,214,544,203.966950907046,554.033049092954
"1980","beat just",0.666302495689798,26,6,20,4.37412891873303,21.625871081267
"1980","falling apart",0.666302495689798,26,6,20,4.37412891873303,21.625871081267
"1980","gonna need",0.666302495689798,26,6,20,4.37412891873303,21.625871081267
"1980","hold tight dont",0.666302495689798,26,6,20,4.37412891873303,21.625871081267
"1980","hurts bad",0.666302495689798,26,6,20,4.37412891873303,21.625871081267
"1980","hypnotize",0.666302495689798,26,6,20,4.37412891873303,21.625871081267
"1980","really dont",0.665704772907119,84,17,67,14.1318011220605,69.8681988779394
"1970","someday",0.665352974113818,143,23,120,19.569248533563,123.430751466437
"2000","want get",0.665219758037292,98,30,68,26.3703973468213,71.6296026531787
"1970","think love",0.664125300588113,70,12,58,9.57935242901686,60.4206475709831
"1970","youyou",0.664125300588113,70,12,58,9.57935242901686,60.4206475709831
"1990","runs",0.662666950947955,93,23,70,19.7294567214464,73.2705432785536
"2000","always feel",0.662221910669717,33,11,22,8.87982767801125,24.1201723219887
"2000","can hardly",0.662221910669717,33,11,22,8.87982767801125,24.1201723219887
"2000","come give",0.662221910669717,33,11,22,8.87982767801125,24.1201723219887
"2000","flex",0.662221910669717,33,11,22,8.87982767801125,24.1201723219887
"2000","like will",0.662221910669717,33,11,22,8.87982767801125,24.1201723219887
"2000","press",0.662221910669717,33,11,22,8.87982767801125,24.1201723219887
"2000","red light",0.662221910669717,33,11,22,8.87982767801125,24.1201723219887
"2000","remain",0.662221910669717,33,11,22,8.87982767801125,24.1201723219887
"2000","said ill",0.662221910669717,33,11,22,8.87982767801125,24.1201723219887
"2000","wanna run",0.662221910669717,33,11,22,8.87982767801125,24.1201723219887
"2000","wont forget",0.662221910669717,33,11,22,8.87982767801125,24.1201723219887
"1970","away just",0.661983700516981,38,7,31,5.20021989003772,32.7997801099623
"1970","dont turn",0.661983700516981,38,7,31,5.20021989003772,32.7997801099623
"1970","driver",0.661983700516981,38,7,31,5.20021989003772,32.7997801099623
"1970","time go",0.661983700516981,38,7,31,5.20021989003772,32.7997801099623
"2010","check",0.661154817998625,261,45,216,40.1842709583771,220.815729041623
"1990","especially",0.660151129531605,29,8,21,6.15219618195642,22.8478038180436
"1990","hand ill",0.660151129531605,29,8,21,6.15219618195642,22.8478038180436
"1990","motherfuckers",0.660151129531605,29,8,21,6.15219618195642,22.8478038180436
"1990","running back",0.660151129531605,29,8,21,6.15219618195642,22.8478038180436
"1990","see oh",0.660151129531605,29,8,21,6.15219618195642,22.8478038180436
"1990","sit back",0.660151129531605,29,8,21,6.15219618195642,22.8478038180436
"1990","thought youd",0.660151129531605,29,8,21,6.15219618195642,22.8478038180436
"1990","many times",0.658744858625266,80,20,60,16.9715756743625,63.0284243256375
"1990","way im",0.658744858625266,80,20,60,16.9715756743625,63.0284243256375
"1960","beside",0.657631902342364,144,11,133,8.60015136857385,135.399848631426
"1970","ive never",0.65718343839098,103,17,86,14.0953328598391,88.9046671401609
"1990","lies",0.655890483746946,289,67,222,61.3098171236346,227.690182876365
"1990","feel good",0.655847899997234,137,33,104,29.0638233423458,107.936176657654
"1980","leaving",0.655199307260455,200,38,162,33.6471455287156,166.352854471284
"1980","one want",0.654728663619603,52,11,41,8.74825783746605,43.251742162534
"1990","party",0.65399043062467,694,156,538,147.228418975095,546.771581024905
"2010","baby yeah",0.653873961554564,80,15,65,12.3170179182765,67.6829820817235
"1990","move move",0.653035870417794,115,28,87,24.3966400318961,90.6033599681039
"1980","feel im",0.652000457745185,68,14,54,11.4400294797633,56.5599705202367
"1980","like oh",0.652000457745185,68,14,54,11.4400294797633,56.5599705202367
"1990","forward",0.651584164275191,50,13,37,10.6072347964766,39.3927652035234
"1990","gone im",0.651584164275191,50,13,37,10.6072347964766,39.3927652035234
"1980","ooh baby",0.650353761258399,150,29,121,25.2353591465367,124.764640853463
"1960","make better",0.650043769092385,86,7,79,5.13620151178716,80.8637984882128
"1970","ones",0.649704178085193,218,34,184,29.8328404217953,188.167159578205
"2010","dressed",0.649024377012016,51,10,41,7.85209892290127,43.1479010770987
"2000","back im",0.648839259773493,67,21,46,18.028741043235,48.971258956765
"2000","dont ask",0.648839259773493,67,21,46,18.028741043235,48.971258956765
"2000","tell youre",0.648839259773493,67,21,46,18.028741043235,48.971258956765
"2010","cheek",0.648404166682161,34,7,27,5.23473261526751,28.7652673847325
"2010","nowi",0.648404166682161,34,7,27,5.23473261526751,28.7652673847325
"2010","oh oh yeah",0.648404166682161,34,7,27,5.23473261526751,28.7652673847325
"2010","path",0.648404166682161,34,7,27,5.23473261526751,28.7652673847325
"2010","vacation",0.648404166682161,34,7,27,5.23473261526751,28.7652673847325
"1980","fast",0.648147031849899,341,63,278,57.3683831264601,283.63161687354
"1990","touch",0.647691387300412,942,210,732,199.840303565619,742.159696434381
"2000","known",0.645276956208411,211,62,149,56.7770800018295,154.22291999817
"1970","say love",0.644877976571354,184,29,155,25.18001209913,158.81998790087
"2010","go way",0.644730537322063,86,16,70,13.2407942621472,72.7592057378528
"1990","know im",0.643035138080593,580,131,449,123.043923639128,456.956076360872
"1990","aint one",0.6430179452305,25,7,18,5.30361739823829,19.6963826017617
"1990","away one",0.6430179452305,25,7,18,5.30361739823829,19.6963826017617
"1990","baby oh baby",0.6430179452305,25,7,18,5.30361739823829,19.6963826017617
"1990","babybaby",0.6430179452305,25,7,18,5.30361739823829,19.6963826017617
"1990","beef",0.6430179452305,25,7,18,5.30361739823829,19.6963826017617
"1990","bumpin",0.6430179452305,25,7,18,5.30361739823829,19.6963826017617
"1990","confidence",0.6430179452305,25,7,18,5.30361739823829,19.6963826017617
"1990","ever feel",0.6430179452305,25,7,18,5.30361739823829,19.6963826017617
"1990","feel let",0.6430179452305,25,7,18,5.30361739823829,19.6963826017617
"1990","frame",0.6430179452305,25,7,18,5.30361739823829,19.6963826017617
"1990","ive made",0.6430179452305,25,7,18,5.30361739823829,19.6963826017617
"1990","make fall",0.6430179452305,25,7,18,5.30361739823829,19.6963826017617
"1990","ooo baby baby",0.6430179452305,25,7,18,5.30361739823829,19.6963826017617
"1990","patient",0.6430179452305,25,7,18,5.30361739823829,19.6963826017617
"1990","shown",0.6430179452305,25,7,18,5.30361739823829,19.6963826017617
"1990","something good",0.6430179452305,25,7,18,5.30361739823829,19.6963826017617
"1990","thats thats",0.6430179452305,25,7,18,5.30361739823829,19.6963826017617
"1990","try understand",0.6430179452305,25,7,18,5.30361739823829,19.6963826017617
"1990","well always",0.6430179452305,25,7,18,5.30361739823829,19.6963826017617
"1990","whenever youre",0.6430179452305,25,7,18,5.30361739823829,19.6963826017617
"1970","love dont",0.641571548085498,280,43,237,38.3174097160674,241.682590283933
"1970","drank",0.640192107183933,90,15,75,12.3163102658788,77.6836897341212
"1970","let show",0.640192107183933,90,15,75,12.3163102658788,77.6836897341212
"1990","scream",0.635763083885495,155,37,118,32.8824278690774,122.117572130923
"1970","go home",0.634910023989619,110,18,92,15.0532681027408,94.9467318972592
"1970","eyes im",0.634204923332156,32,6,26,4.37913253897913,27.6208674610209
"1970","heart youre",0.634204923332156,32,6,26,4.37913253897913,27.6208674610209
"1970","indeed",0.634204923332156,32,6,26,4.37913253897913,27.6208674610209
"1970","jones",0.634204923332156,32,6,26,4.37913253897913,27.6208674610209
"1970","just close",0.634204923332156,32,6,26,4.37913253897913,27.6208674610209
"1970","lisa",0.634204923332156,32,6,26,4.37913253897913,27.6208674610209
"1970","oh theres",0.634204923332156,32,6,26,4.37913253897913,27.6208674610209
"1970","start new",0.634204923332156,32,6,26,4.37913253897913,27.6208674610209
"1970","tracks",0.634204923332156,32,6,26,4.37913253897913,27.6208674610209
"1970","winds",0.634204923332156,32,6,26,4.37913253897913,27.6208674610209
"1990","alright baby",0.631742697141692,21,6,15,4.45503861452016,16.5449613854798
"1990","aquarius",0.631742697141692,21,6,15,4.45503861452016,16.5449613854798
"1990","damned",0.631742697141692,21,6,15,4.45503861452016,16.5449613854798
"1990","dont stay",0.631742697141692,21,6,15,4.45503861452016,16.5449613854798
"1990","falter",0.631742697141692,21,6,15,4.45503861452016,16.5449613854798
"1990","head im",0.631742697141692,21,6,15,4.45503861452016,16.5449613854798
"1990","high low",0.631742697141692,21,6,15,4.45503861452016,16.5449613854798
"1990","homeboy",0.631742697141692,21,6,15,4.45503861452016,16.5449613854798
"1990","just day",0.631742697141692,21,6,15,4.45503861452016,16.5449613854798
"1990","know everything",0.631742697141692,21,6,15,4.45503861452016,16.5449613854798
"1990","leave dont",0.631742697141692,21,6,15,4.45503861452016,16.5449613854798
"1990","like drum",0.631742697141692,21,6,15,4.45503861452016,16.5449613854798
"1990","look face",0.631742697141692,21,6,15,4.45503861452016,16.5449613854798
"1990","minei",0.631742697141692,21,6,15,4.45503861452016,16.5449613854798
"1990","music play",0.631742697141692,21,6,15,4.45503861452016,16.5449613854798
"1990","prayed",0.631742697141692,21,6,15,4.45503861452016,16.5449613854798
"1990","show can",0.631742697141692,21,6,15,4.45503861452016,16.5449613854798
"1990","till get",0.631742697141692,21,6,15,4.45503861452016,16.5449613854798
"1990","time aint",0.631742697141692,21,6,15,4.45503861452016,16.5449613854798
"1990","will one",0.631742697141692,21,6,15,4.45503861452016,16.5449613854798
"1990","wrong can",0.631742697141692,21,6,15,4.45503861452016,16.5449613854798
"1990","youre living",0.631742697141692,21,6,15,4.45503861452016,16.5449613854798
"1960","sent",0.630886606948146,130,10,120,7.76402554107361,122.235974458926
"1990","rock body",0.630750884670438,63,16,47,13.3651158435605,49.6348841564395
"2010","lot",0.630700526416316,410,69,341,63.1247168311671,346.875283168833
"2000","anymore dont",0.630225359606377,20,7,13,5.38171374424925,14.6182862557508
"2000","booth",0.630225359606377,20,7,13,5.38171374424925,14.6182862557508
"2000","boy want",0.630225359606377,20,7,13,5.38171374424925,14.6182862557508
"2000","brooklyn",0.630225359606377,20,7,13,5.38171374424925,14.6182862557508
"2000","finally see",0.630225359606377,20,7,13,5.38171374424925,14.6182862557508
"2000","friday saturday",0.630225359606377,20,7,13,5.38171374424925,14.6182862557508
"2000","go far",0.630225359606377,20,7,13,5.38171374424925,14.6182862557508
"2000","home dont",0.630225359606377,20,7,13,5.38171374424925,14.6182862557508
"2000","im wondering",0.630225359606377,20,7,13,5.38171374424925,14.6182862557508
"2000","know theyre",0.630225359606377,20,7,13,5.38171374424925,14.6182862557508
"2000","let die",0.630225359606377,20,7,13,5.38171374424925,14.6182862557508
"2000","let hang",0.630225359606377,20,7,13,5.38171374424925,14.6182862557508
"2000","mama dont",0.630225359606377,20,7,13,5.38171374424925,14.6182862557508
"2000","nuff",0.630225359606377,20,7,13,5.38171374424925,14.6182862557508
"2000","suicide",0.630225359606377,20,7,13,5.38171374424925,14.6182862557508
"2000","thursday friday",0.630225359606377,20,7,13,5.38171374424925,14.6182862557508
"2000","thursday friday saturday",0.630225359606377,20,7,13,5.38171374424925,14.6182862557508
"2000","wednesday thursday friday",0.630225359606377,20,7,13,5.38171374424925,14.6182862557508
"2000","wednesday thursday friday saturday",0.630225359606377,20,7,13,5.38171374424925,14.6182862557508
"1990","crib",0.62989159175514,89,22,67,18.8808779377283,70.1191220622717
"1970","dressed",0.629815521904986,51,9,42,6.97924248399799,44.020757516002
"1970","hes got",0.629815521904986,51,9,42,6.97924248399799,44.020757516002
"1970","mystery",0.629815521904986,51,9,42,6.97924248399799,44.020757516002
"2000","make love",0.628909488629265,254,74,180,68.3477645519654,185.652235448035
"1960","nobody",0.626962481927508,718,48,670,42.8813102960835,675.118689703917
"2010","begin",0.62567603948048,110,20,90,16.9358996376302,93.0641003623698
"2010","cant sleep",0.625495635146903,57,11,46,8.77587526677201,48.224124733228
"2010","love aint",0.625495635146903,57,11,46,8.77587526677201,48.224124733228
"1980","middle night",0.624794836526724,47,10,37,7.90707919924816,39.0929208007518
"1980","shelter",0.624794836526724,47,10,37,7.90707919924816,39.0929208007518
"1980","time youre",0.624794836526724,47,10,37,7.90707919924816,39.0929208007518
"1980","comes",0.624178216968302,702,126,576,118.101480805792,583.898519194208
"2000","gave",0.623438714478633,466,133,333,125.393930241007,340.606069758993
"1970","know wont",0.62250055704489,64,11,53,8.75826507795827,55.2417349220417
"1990","circles",0.620924269349732,46,12,34,9.75865601275846,36.2413439872415
"1990","tune",0.620924269349732,46,12,34,9.75865601275846,36.2413439872415
"1980","know baby",0.618746491956319,63,13,50,10.5988508415454,52.4011491584546
"2010","mad",0.617850504340863,262,45,217,40.3382336823556,221.661766317644
"2000","none",0.615642454742547,95,29,66,25.5631402851839,69.4368597148161
"1970","fact",0.615457998972305,117,19,98,16.0112033456425,100.988796654358
"2000","just one",0.615253225668248,215,63,152,57.8534227506794,157.146577249321
"1980","realize",0.614693669120273,184,35,149,30.9553738864183,153.044626113582
"1970","well well",0.614624718925155,97,16,81,13.2742455087805,83.7257544912195
"1990","sad",0.613802988226741,326,75,251,69.1591708730273,256.840829126973
"2000","man im",0.613455173935976,102,31,71,27.4467400956712,74.5532599043289
"2000","never find",0.613455173935976,102,31,71,27.4467400956712,74.5532599043289
"2000","seems like",0.613455173935976,102,31,71,27.4467400956712,74.5532599043289
"2000","fake",0.613347078178482,116,35,81,31.2139397166456,84.7860602833544
"1980","anyone",0.613074286856358,134,26,108,22.5435875042394,111.456412495761
"1980","safe",0.613074286856358,134,26,108,22.5435875042394,111.456412495761
"2000","rules",0.612780414177914,109,33,76,29.3303399061584,79.6696600938416
"2000","never will",0.611267450530326,57,18,39,15.3378841711103,41.6621158288897
"2000","pressure",0.611166841085974,40,13,27,10.7634274884985,29.2365725115015
"1980","tell love",0.6101005634561,112,22,90,18.8424014960807,93.1575985039193
"1980","behind",0.60869984231463,342,63,279,57.5366188541037,284.463381145896
"2010","floor",0.607857298281274,648,107,541,99.7678451380397,548.23215486196
"2010","chevy",0.607642401650498,63,12,51,9.69965161064275,53.3003483893573
"1990","gonna give",0.607196749693165,98,24,74,20.7901802010941,77.2098197989059
"1980","rockin",0.605906428678385,173,33,140,29.104780882339,143.895219117661
"2010","grip",0.604801210983598,40,8,32,6.15850895913825,33.8414910408617
"2010","peter",0.604801210983598,40,8,32,6.15850895913825,33.8414910408617
"2010","rest life",0.604801210983598,40,8,32,6.15850895913825,33.8414910408617
"1960","girl let",0.604429050899284,87,7,80,5.19592478518003,81.80407521482
"2000","always will",0.602019918790647,30,10,20,8.07257061637387,21.9274293836261
"2000","became",0.602019918790647,30,10,20,8.07257061637387,21.9274293836261
"2000","cause make",0.602019918790647,30,10,20,8.07257061637387,21.9274293836261
"2000","cell",0.602019918790647,30,10,20,8.07257061637387,21.9274293836261
"2000","fore",0.602019918790647,30,10,20,8.07257061637387,21.9274293836261
"2000","harlem",0.602019918790647,30,10,20,8.07257061637387,21.9274293836261
"2000","ive learned",0.602019918790647,30,10,20,8.07257061637387,21.9274293836261
"2000","night cause",0.602019918790647,30,10,20,8.07257061637387,21.9274293836261
"2000","one whos",0.602019918790647,30,10,20,8.07257061637387,21.9274293836261
"2000","please tell",0.602019918790647,30,10,20,8.07257061637387,21.9274293836261
"2000","pretty little",0.602019918790647,30,10,20,8.07257061637387,21.9274293836261
"2000","reminisce",0.602019918790647,30,10,20,8.07257061637387,21.9274293836261
"2000","rubber",0.602019918790647,30,10,20,8.07257061637387,21.9274293836261
"2000","wanna make love",0.602019918790647,30,10,20,8.07257061637387,21.9274293836261
"1970","dont leave",0.59836408426099,124,20,104,16.9691385885441,107.030861411456
"1990","screamin",0.598169774701699,59,15,44,12.5165370598424,46.4834629401576
"1980","meaning",0.597845223301081,162,31,131,27.2541878782596,134.74581212174
"1980","dreams come true",0.595907591703452,42,9,33,7.06590056103027,34.9340994389697
"1980","never want",0.595907591703452,42,9,33,7.06590056103027,34.9340994389697
"1980","still want",0.595907591703452,42,9,33,7.06590056103027,34.9340994389697
"1960","yesterday",0.594600927487692,131,10,121,7.82374881446649,123.176251185534
"2000","want stay",0.594356452063121,64,20,44,17.2214839815976,46.7785160184024
"2010","addicted",0.594026920570895,69,13,56,10.6234279545135,58.3765720454865
"2010","another one",0.594026920570895,69,13,56,10.6234279545135,58.3765720454865
"1990","trip",0.593810871146525,129,31,98,27.3666657749096,101.63333422509
"1980","sound",0.593574579391348,405,74,331,68.1354696956491,336.864530304351
"1970","im glad",0.592654379231302,104,17,87,14.2321807516822,89.7678192483178
"2000","come get",0.592127669916344,194,57,137,52.2026233192177,141.797376680782
"1970","can change",0.591691874944613,45,8,37,6.15815513293941,38.8418448670606
"1970","cards",0.591691874944613,45,8,37,6.15815513293941,38.8418448670606
"1970","get next",0.591691874944613,45,8,37,6.15815513293941,38.8418448670606
"1970","wait minute",0.591691874944613,45,8,37,6.15815513293941,38.8418448670606
"1970","will take",0.591691874944613,45,8,37,6.15815513293941,38.8418448670606
"1990","never really",0.590693821494057,42,11,31,8.91007722904033,33.0899227709597
"1990","yeah get",0.590693821494057,42,11,31,8.91007722904033,33.0899227709597
"1970","movin",0.589196422351017,192,30,162,26.2747952338748,165.725204766125
"1960","diamond",0.588374940924734,146,11,135,8.71959791535959,137.28040208464
"1990","say goodbye",0.588222352285735,178,42,136,37.7617558754566,140.238244124543
"1980","knife",0.58568910594702,58,12,46,9.75767220332752,48.2423277966725
"1980","will ever",0.58568910594702,58,12,46,9.75767220332752,48.2423277966725
"1970","early",0.585274501768476,71,12,59,9.71620032085995,61.2837996791401
"1970","fancy",0.585274501768476,71,12,59,9.71620032085995,61.2837996791401
"1970","yeah thats",0.585274501768476,71,12,59,9.71620032085995,61.2837996791401
"2000","stand",0.584128797531903,804,226,578,216.34489251882,587.65510748118
"1970","heavy",0.581092092439698,58,10,48,7.93717772689968,50.0628222731003
"1970","will ever",0.581092092439698,58,10,48,7.93717772689968,50.0628222731003
"1970","younger",0.581092092439698,58,10,48,7.93717772689968,50.0628222731003
"1970","sugar",0.580072008632657,254,39,215,34.7593645281469,219.240635471853
"1960","ive got",0.578364336100202,579,39,540,34.579775294474,544.420224705526
"1990","yeah oh",0.578017681202587,214,50,164,45.3989649289198,168.60103507108
"2000","say oh",0.577870457310247,47,15,32,12.6470272989857,34.3529727010143
"1980","nowhere",0.576997303284957,224,42,182,37.6848029921615,186.315197007839
"1960","run",0.576956411706718,1088,71,1017,64.9789214514469,1023.02107854855
"1980","dawn",0.576117968430895,107,21,86,18.0012228578628,88.9987771421372
"2000","youre feeling",0.574680504880808,78,24,54,20.9886836025721,57.0113163974279
"1960","fire",0.574539841101586,674,45,629,40.253486266797,633.746513733203
"2000","againand",0.5743598537332,17,6,11,4.57445668261186,12.4255433173881
"2000","bad baby",0.5743598537332,17,6,11,4.57445668261186,12.4255433173881
"2000","best baby",0.5743598537332,17,6,11,4.57445668261186,12.4255433173881
"2000","better know",0.5743598537332,17,6,11,4.57445668261186,12.4255433173881
"2000","bud",0.5743598537332,17,6,11,4.57445668261186,12.4255433173881
"2000","butter",0.5743598537332,17,6,11,4.57445668261186,12.4255433173881
"2000","caddy",0.5743598537332,17,6,11,4.57445668261186,12.4255433173881
"2000","can barely",0.5743598537332,17,6,11,4.57445668261186,12.4255433173881
"2000","cause cant wait",0.5743598537332,17,6,11,4.57445668261186,12.4255433173881
"2000","created",0.5743598537332,17,6,11,4.57445668261186,12.4255433173881
"2000","ever think",0.5743598537332,17,6,11,4.57445668261186,12.4255433173881
"2000","found im",0.5743598537332,17,6,11,4.57445668261186,12.4255433173881
"2000","girls around",0.5743598537332,17,6,11,4.57445668261186,12.4255433173881
"2000","goand",0.5743598537332,17,6,11,4.57445668261186,12.4255433173881
"2000","got oh",0.5743598537332,17,6,11,4.57445668261186,12.4255433173881
"2000","heart breaking",0.5743598537332,17,6,11,4.57445668261186,12.4255433173881
"2000","hustle",0.5743598537332,17,6,11,4.57445668261186,12.4255433173881
"2000","im stuck",0.5743598537332,17,6,11,4.57445668261186,12.4255433173881
"2000","inner",0.5743598537332,17,6,11,4.57445668261186,12.4255433173881
"2000","just good time",0.5743598537332,17,6,11,4.57445668261186,12.4255433173881
"2000","learn fly",0.5743598537332,17,6,11,4.57445668261186,12.4255433173881
"2000","like just like",0.5743598537332,17,6,11,4.57445668261186,12.4255433173881
"2000","medont",0.5743598537332,17,6,11,4.57445668261186,12.4255433173881
"2000","mind think",0.5743598537332,17,6,11,4.57445668261186,12.4255433173881
"2000","mineyou",0.5743598537332,17,6,11,4.57445668261186,12.4255433173881
"2000","now whos",0.5743598537332,17,6,11,4.57445668261186,12.4255433173881
"2000","oh make",0.5743598537332,17,6,11,4.57445668261186,12.4255433173881
"2000","outi",0.5743598537332,17,6,11,4.57445668261186,12.4255433173881
"2000","rappin",0.5743598537332,17,6,11,4.57445668261186,12.4255433173881
"2000","road im",0.5743598537332,17,6,11,4.57445668261186,12.4255433173881
"2000","sucks",0.5743598537332,17,6,11,4.57445668261186,12.4255433173881
"2000","thing go",0.5743598537332,17,6,11,4.57445668261186,12.4255433173881
"2000","turn radio",0.5743598537332,17,6,11,4.57445668261186,12.4255433173881
"2000","walk alone",0.5743598537332,17,6,11,4.57445668261186,12.4255433173881
"2000","without live without",0.5743598537332,17,6,11,4.57445668261186,12.4255433173881
"2000","yeah see",0.5743598537332,17,6,11,4.57445668261186,12.4255433173881
"2000","yeahits",0.5743598537332,17,6,11,4.57445668261186,12.4255433173881
"2010","fashion",0.574052027080206,29,6,23,4.46491899537523,24.5350810046248
"2010","hand ill",0.574052027080206,29,6,23,4.46491899537523,24.5350810046248
"2010","im holding",0.574052027080206,29,6,23,4.46491899537523,24.5350810046248
"2010","inch",0.574052027080206,29,6,23,4.46491899537523,24.5350810046248
"2010","meso",0.574052027080206,29,6,23,4.46491899537523,24.5350810046248
"2010","nobody knows",0.574052027080206,29,6,23,4.46491899537523,24.5350810046248
"2010","sunset",0.574052027080206,29,6,23,4.46491899537523,24.5350810046248
"2010","tonight just",0.574052027080206,29,6,23,4.46491899537523,24.5350810046248
"2010","tonighti",0.574052027080206,29,6,23,4.46491899537523,24.5350810046248
"2010","una",0.574052027080206,29,6,23,4.46491899537523,24.5350810046248
"2010","whatever want",0.574052027080206,29,6,23,4.46491899537523,24.5350810046248
"2010","wore",0.574052027080206,29,6,23,4.46491899537523,24.5350810046248
"2010","back around",0.573962649232083,46,9,37,7.08228530300899,38.917714696991
"2010","knew love",0.573962649232083,46,9,37,7.08228530300899,38.917714696991
"2010","need life",0.573962649232083,46,9,37,7.08228530300899,38.917714696991
"2000","dont need",0.57232502287537,395,113,282,106.288846448923,288.711153551077
"1970","gangsta",0.572081970287369,91,15,76,12.4531581577219,78.5468418422781
"1970","love give",0.572081970287369,91,15,76,12.4531581577219,78.5468418422781
"1980","day",0.570294691760829,2215,386,1829,372.642136730525,1842.35786326947
"2000","like love",0.569613431292057,85,26,59,22.8722834130593,62.1277165869407
"2000","spinning",0.569613431292057,85,26,59,22.8722834130593,62.1277165869407
"1980","cant remember",0.568483426035043,37,8,29,6.22472192281238,30.7752780771876
"1980","ill give love",0.568483426035043,37,8,29,6.22472192281238,30.7752780771876
"1980","messin",0.568483426035043,37,8,29,6.22472192281238,30.7752780771876
"1980","miracles",0.568483426035043,37,8,29,6.22472192281238,30.7752780771876
"1980","need time",0.568483426035043,37,8,29,6.22472192281238,30.7752780771876
"1980","new day",0.568483426035043,37,8,29,6.22472192281238,30.7752780771876
"1980","night know",0.568483426035043,37,8,29,6.22472192281238,30.7752780771876
"1980","theres many",0.568483426035043,37,8,29,6.22472192281238,30.7752780771876
"1980","til end",0.568483426035043,37,8,29,6.22472192281238,30.7752780771876
"2000","nobody else",0.566769833319694,92,28,64,24.7558832235465,67.2441167764535
"2000","yeahi",0.566769833319694,92,28,64,24.7558832235465,67.2441167764535
"1990","cure",0.565640261230273,55,14,41,11.6679582761242,43.3320417238758
"1990","go round",0.565640261230273,55,14,41,11.6679582761242,43.3320417238758
"1990","love gonna",0.565640261230273,55,14,41,11.6679582761242,43.3320417238758
"1980","counting",0.563136483504375,69,14,55,11.6082652074069,57.3917347925931
"1980","everytime",0.563136483504375,69,14,55,11.6082652074069,57.3917347925931
"1980","thought id",0.563136483504375,69,14,55,11.6082652074069,57.3917347925931
"2010","fat",0.563108435532438,99,18,81,15.2423096738672,83.7576903261328
"1960","upon",0.562279245446844,207,15,192,12.3627175923249,194.637282407675
"1990","enough",0.561673126511852,798,178,620,169.291467351766,628.708532648234
"1990","hopes",0.561026968259048,38,10,28,8.0614984453222,29.9385015546778
"1990","laughed",0.561026968259048,38,10,28,8.0614984453222,29.9385015546778
"1990","need now",0.561026968259048,38,10,28,8.0614984453222,29.9385015546778
"1990","nobody nobody",0.561026968259048,38,10,28,8.0614984453222,29.9385015546778
"1990","right way",0.561026968259048,38,10,28,8.0614984453222,29.9385015546778
"1990","split",0.561026968259048,38,10,28,8.0614984453222,29.9385015546778
"1990","vow",0.561026968259048,38,10,28,8.0614984453222,29.9385015546778
"1960","love one",0.560825971816012,88,7,81,5.25564805857291,82.7443519414271
"1990","drivin",0.559933129831458,68,17,51,14.4258393232082,53.5741606767919
"1990","heart beat",0.559933129831458,68,17,51,14.4258393232082,53.5741606767919
"1960","come true",0.559577037960214,132,10,122,7.88347208785936,124.116527912141
"2010","live without",0.5593618159794,202,35,167,31.1004702436482,170.899529756352
"1960","matter",0.557993714794611,533,36,497,31.8325047184018,501.167495281598
"1970","asked",0.557020571613717,118,19,99,16.1480512374856,101.851948762514
"2000","right cause",0.555535504289069,54,17,37,14.530627109473,39.469372890527
"1960","streets",0.555323878933361,177,13,164,10.5710193905387,166.428980609461
"1970","bother",0.554943239359958,39,7,32,5.33706778188082,33.6629322181192
"1970","know hes",0.554943239359958,39,7,32,5.33706778188082,33.6629322181192
"1970","now let",0.554943239359958,39,7,32,5.33706778188082,33.6629322181192
"1970","worried",0.554943239359958,39,7,32,5.33706778188082,33.6629322181192
"1970","suddenly",0.554833159559413,78,13,65,10.6741355637616,67.3258644362384
"1990","can tell",0.553468062092799,264,61,203,56.0061997253963,207.993800274604
"1980","barely",0.55288343521313,53,11,42,8.91649356510963,44.0835064348904
"1980","bleed",0.55288343521313,53,11,42,8.91649356510963,44.0835064348904
"1980","hopin",0.55288343521313,53,11,42,8.91649356510963,44.0835064348904
"2000","fish",0.551987412968661,37,12,25,9.9561704268611,27.0438295731389
"2010","one want",0.551614366185299,52,10,42,8.00606164687973,43.9939383531203
"2010","sheets",0.551614366185299,52,10,42,8.00606164687973,43.9939383531203
"1990","know just",0.550577795852934,237,55,182,50.278292935299,186.721707064701
"1980","baby yeah",0.550459002721276,80,16,64,13.4588582114862,66.5411417885138
"1980","many times",0.550459002721276,80,16,64,13.4588582114862,66.5411417885138
"1980","youll find",0.550459002721276,80,16,64,13.4588582114862,66.5411417885138
"1970","little girl",0.550450920198428,98,16,82,13.4110934006236,84.5889065993764
"1970","best",0.549401545665209,908,132,776,124.257885793533,783.742114206467
"1970","seen",0.548704272258078,576,85,491,78.8243857016244,497.175614298376
"2000","cold",0.547295057093788,522,148,374,140.462728724905,381.537271275095
"1980","dont say",0.546712575918711,124,24,100,20.8612302278037,103.138769772196
"1980","spent",0.546712575918711,124,24,100,20.8612302278037,103.138769772196
"2000","moment",0.545725208926683,410,117,293,110.32513175711,299.67486824289
"1970","love way",0.545358123544892,248,38,210,33.9382771770883,214.061722822912
"1970","want want",0.544687908091978,193,30,163,26.4116431257179,166.588356874282
"1960","never",0.544528841250496,4753,296,4457,283.86471843633,4469.13528156367
"1990","true love",0.543380636383595,112,27,85,23.7602059441075,88.2397940558925
"1980","going crazy",0.543193783564755,32,7,25,5.38354328459449,26.6164567154055
"1980","know yeah",0.543193783564755,32,7,25,5.38354328459449,26.6164567154055
"1980","love till",0.543193783564755,32,7,25,5.38354328459449,26.6164567154055
"1980","now say",0.543193783564755,32,7,25,5.38354328459449,26.6164567154055
"1980","pages",0.543193783564755,32,7,25,5.38354328459449,26.6164567154055
"1980","raining",0.543193783564755,32,7,25,5.38354328459449,26.6164567154055
"1980","things dont",0.543193783564755,32,7,25,5.38354328459449,26.6164567154055
"1980","youre thinkin",0.543193783564755,32,7,25,5.38354328459449,26.6164567154055
"1970","walks",0.542853029713418,65,11,54,8.89511296980137,56.1048870301986
"1970","will go",0.542853029713418,65,11,54,8.89511296980137,56.1048870301986
"1980","take away",0.542642035467532,191,36,155,32.1330239799234,158.866976020077
"1960","brought",0.542439259867789,103,8,95,6.15149715946602,96.848502840534
"1980","see can",0.542176863745599,102,20,82,17.1600442196449,84.8399557803551
"2000","bitter",0.541817926911582,27,9,18,7.26531355473648,19.7346864452635
"2000","expect",0.541817926911582,27,9,18,7.26531355473648,19.7346864452635
"2000","freeway",0.541817926911582,27,9,18,7.26531355473648,19.7346864452635
"2000","know long",0.541817926911582,27,9,18,7.26531355473648,19.7346864452635
"2000","level",0.541817926911582,27,9,18,7.26531355473648,19.7346864452635
"2000","man baby",0.541817926911582,27,9,18,7.26531355473648,19.7346864452635
"2000","now girl",0.541817926911582,27,9,18,7.26531355473648,19.7346864452635
"2000","tell cant",0.541817926911582,27,9,18,7.26531355473648,19.7346864452635
"2000","treat bad",0.541817926911582,27,9,18,7.26531355473648,19.7346864452635
"1960","im love",0.54143891988936,223,16,207,13.3182899666109,209.681710033389
"1970","around im",0.539974037807846,52,9,43,7.11609037584109,44.8839096241589
"1970","need oh",0.539974037807846,52,9,43,7.11609037584109,44.8839096241589
"1970","raised",0.539974037807846,52,9,43,7.11609037584109,44.8839096241589
"2000","heres",0.539360621745369,138,41,97,37.1338248353198,100.86617516468
"1970","thats right",0.537629099238512,159,25,134,21.7588148030526,137.241185196947
"2010","can tell",0.535977672390201,264,45,219,40.6461591303125,223.353840869688
"2000","dog",0.534254228318662,131,39,92,35.2502250248326,95.7497749751674
"2010","sittin",0.533800626942265,172,30,142,26.4815885242945,145.518411475706
"1990","like man",0.533174433263907,51,13,38,10.8193794924061,40.1806205075939
"1990","youim",0.533174433263907,51,13,38,10.8193794924061,40.1806205075939
"1990","cheat",0.532120239453315,34,9,25,7.21291966160408,26.7870803383959
"1990","girl wanna",0.532120239453315,34,9,25,7.21291966160408,26.7870803383959
"1990","mercedes",0.532120239453315,34,9,25,7.21291966160408,26.7870803383959
"1990","mine im",0.532120239453315,34,9,25,7.21291966160408,26.7870803383959
"1990","oh oh yeah",0.532120239453315,34,9,25,7.21291966160408,26.7870803383959
"1990","plastic",0.532120239453315,34,9,25,7.21291966160408,26.7870803383959
"1990","remains",0.532120239453315,34,9,25,7.21291966160408,26.7870803383959
"1990","slipping",0.532120239453315,34,9,25,7.21291966160408,26.7870803383959
"1990","think twice",0.532120239453315,34,9,25,7.21291966160408,26.7870803383959
"1990","heartbeat",0.531666724517563,77,19,58,16.3351415865739,60.6648584134261
"1990","telephone",0.531666724517563,77,19,58,16.3351415865739,60.6648584134261
"1960","asked",0.531582696222735,118,9,109,7.04734626035913,110.952653739641
"2000","green",0.531562106692036,170,50,120,45.7445668261186,124.255433173881
"2000","list",0.530386528505105,68,21,47,18.2978267304474,49.7021732695526
"1970","make feel like",0.529558585297741,85,14,71,11.6320708066633,73.3679291933367
"1970","someone else",0.529558585297741,85,14,71,11.6320708066633,73.3679291933367
"2010","board",0.529201059610649,35,7,28,5.38869533924597,29.611304660754
"2010","butterflies",0.529201059610649,35,7,28,5.38869533924597,29.611304660754
"2010","eyes know",0.529201059610649,35,7,28,5.38869533924597,29.611304660754
"2010","im lonely",0.529201059610649,35,7,28,5.38869533924597,29.611304660754
"2010","oh thats",0.529201059610649,35,7,28,5.38869533924597,29.611304660754
"2010","shade",0.529201059610649,35,7,28,5.38869533924597,29.611304660754
"2010","stay dont",0.529201059610649,35,7,28,5.38869533924597,29.611304660754
"2010","yeah ill",0.529201059610649,35,7,28,5.38869533924597,29.611304660754
"2010","picture",0.529151369566486,166,29,137,25.5578121804237,140.442187819576
"1980","matter",0.52756543638375,533,96,437,89.669642834027,443.330357165973
"1990","cant find",0.526995886900207,64,16,48,13.57726053949,50.42273946051
"1990","im thinking",0.526995886900207,64,16,48,13.57726053949,50.42273946051
"1990","speed",0.526995886900207,64,16,48,13.57726053949,50.42273946051
"1960","catch",0.525558002635433,347,24,323,20.7239758673273,326.276024132673
"2000","shouldve",0.523973215928928,75,23,52,20.1814265409347,54.8185734590653
"1960","queen",0.523583172250182,148,11,137,8.83904446214534,139.160955537855
"1980","stay",0.522992891589173,1204,212,992,202.555816082868,1001.44418391713
"1980","aint easy",0.521195560397525,27,6,21,4.5423646463766,22.4576353536234
"1980","care love",0.521195560397525,27,6,21,4.5423646463766,22.4576353536234
"1980","daydream",0.521195560397525,27,6,21,4.5423646463766,22.4576353536234
"1980","gonna put",0.521195560397525,27,6,21,4.5423646463766,22.4576353536234
"1980","got take",0.521195560397525,27,6,21,4.5423646463766,22.4576353536234
"1980","know long",0.521195560397525,27,6,21,4.5423646463766,22.4576353536234
"1980","life now",0.521195560397525,27,6,21,4.5423646463766,22.4576353536234
"1980","long ive",0.521195560397525,27,6,21,4.5423646463766,22.4576353536234
"1980","make one",0.521195560397525,27,6,21,4.5423646463766,22.4576353536234
"1980","now youre gone",0.521195560397525,27,6,21,4.5423646463766,22.4576353536234
"2000","oh ooh",0.520614548308595,44,14,30,11.8397702373483,32.1602297626517
"2000","say wanna",0.520614548308595,44,14,30,11.8397702373483,32.1602297626517
"1980","situation",0.520407363247699,48,10,38,8.07531492689174,39.9246850731083
"1980","wont get",0.520407363247699,48,10,38,8.07531492689174,39.9246850731083
"1980","youre right",0.520407363247699,48,10,38,8.07531492689174,39.9246850731083
"1970","cry cry",0.520303129490309,33,6,27,4.51598043082223,28.4840195691778
"1970","feel fine",0.520303129490309,33,6,27,4.51598043082223,28.4840195691778
"1970","stop loving",0.520303129490309,33,6,27,4.51598043082223,28.4840195691778
"2000","im bout",0.520280900217174,82,25,57,22.0650263514219,59.9349736485781
"1970","like like",0.52020740746709,318,48,270,43.5176296061051,274.482370393895
"1960","dont know",0.51941274557041,1641,105,1536,98.0058916377061,1542.99410836229
"1980","love now",0.519267782338923,130,25,105,21.8706445936651,108.129355406335
"1960","boat",0.519187116131415,89,7,82,5.31537133196578,83.6846286680342
"1960","nothings",0.519187116131415,89,7,82,5.31537133196578,83.6846286680342
"2000","crew",0.51867446634999,89,27,62,23.9486261619091,65.0513738380909
"2000","im going",0.517342395068556,156,46,110,41.9773672051441,114.022632794856
"2010","god",0.516529021677549,501,83,418,77.1353247132066,423.864675286793
"1980","just little bit",0.516055315051196,75,15,60,12.6176795732683,62.3823204267317
"1960","fell",0.516040617999376,224,16,208,13.3780132400038,210.621986759996
"2010","jumpin",0.514229556595239,70,13,57,10.7773906784919,59.2226093215081
"2010","can make",0.513640926441362,370,62,308,56.9662078720288,313.033792127971
"1980","theres nothing",0.512626213477021,186,35,151,31.2918453417055,154.708154658295
"1990","quick",0.512236508638607,108,26,82,22.9116271603894,85.0883728396106
"1980","will make",0.509903478213406,86,17,69,14.4682725773477,71.5317274226523
"2010","girls",0.509770147309402,942,153,789,145.032885987706,796.967114012294
"2000","boys",0.508496173287504,581,164,417,156.338784270441,424.661215729559
"2010","ill show",0.507844972128748,76,14,62,11.7011670223627,64.2988329776373
"1990","piece",0.506576664322579,157,37,120,33.3067172609365,123.693282739064
"1970","whole",0.505793687480043,613,90,523,83.887757699819,529.112242300181
"1960","baby lets",0.504709285558517,104,8,96,6.21122043285889,97.7887795671411
"1990","feel heart",0.504273592922524,30,8,22,6.36434087788595,23.6356591221141
"1990","ive learned",0.504273592922524,30,8,22,6.36434087788595,23.6356591221141
"1990","love night",0.504273592922524,30,8,22,6.36434087788595,23.6356591221141
"1990","made cry",0.504273592922524,30,8,22,6.36434087788595,23.6356591221141
"1990","make last",0.504273592922524,30,8,22,6.36434087788595,23.6356591221141
"1990","take little",0.504273592922524,30,8,22,6.36434087788595,23.6356591221141
"1990","tell get",0.504273592922524,30,8,22,6.36434087788595,23.6356591221141
"1990","will last",0.504273592922524,30,8,22,6.36434087788595,23.6356591221141
"1990","wonder ill",0.504273592922524,30,8,22,6.36434087788595,23.6356591221141
"2000","starts",0.504144292579354,142,42,100,38.2101675841696,103.78983241583
"2010","can give",0.503412305416338,82,15,67,12.6249433662334,69.3750566337666
"2010","now cant",0.503412305416338,82,15,67,12.6249433662334,69.3750566337666
"1980","good time",0.501538099033422,175,33,142,29.4412523376261,145.558747662374
"1990","life im",0.500788476483597,47,12,35,9.97080070868799,37.029199291312
"1990","row",0.500788476483597,47,12,35,9.97080070868799,37.029199291312
"1990","will still",0.500788476483597,47,12,35,9.97080070868799,37.029199291312
"1990","youd better",0.500788476483597,47,12,35,9.97080070868799,37.029199291312
"1970","breeze",0.500483799279968,59,10,49,8.07402561874278,50.9259743812572
"1970","love true",0.500483799279968,59,10,49,8.07402561874278,50.9259743812572
"1970","reality",0.500483799279968,59,10,49,8.07402561874278,50.9259743812572
"2000","couldnt get",0.50033517604954,51,16,35,13.7233700478356,37.2766299521644
"1990","window",0.499311357369014,184,43,141,39.0346240510338,144.965375948966
"1970","hey now",0.499258777456003,46,8,38,6.29500302478251,39.7049969752175
"1970","im losing",0.499258777456003,46,8,38,6.29500302478251,39.7049969752175
"2010","hide",0.499165993488589,358,60,298,55.1186551842874,302.881344815713
"2010","separate",0.49903306566126,41,8,33,6.31247168311671,34.6875283168833
"2010","single day",0.49903306566126,41,8,33,6.31247168311671,34.6875283168833
"2010","tied",0.49903306566126,41,8,33,6.31247168311671,34.6875283168833
"1990","exactly",0.498968110562397,73,18,55,15.4865628028558,57.5134371971442
"1990","good love",0.498968110562397,73,18,55,15.4865628028558,57.5134371971442
"2010","dime",0.498378776676208,100,18,82,15.3962723978456,84.6037276021544
"2010","love right",0.498378776676208,100,18,82,15.3962723978456,84.6037276021544
"2000","singin",0.498026978918093,135,40,95,36.3265677736824,98.6734322263176
"1980","ah ah ah ah",0.494938441805825,59,12,47,9.9259079309711,49.0740920690289
"1980","torn",0.494938441805825,59,12,47,9.9259079309711,49.0740920690289
"1990","naked",0.494058643968933,60,15,45,12.7286817557719,47.2713182442281
"1960","midnight",0.493235797191402,134,10,124,8.00291863464511,125.997081365355
"2000","everyones",0.492989369077335,34,11,23,9.14891336522372,24.8510866347763
"2000","flows",0.492989369077335,34,11,23,9.14891336522372,24.8510866347763
"2000","love first",0.492989369077335,34,11,23,9.14891336522372,24.8510866347763
"2000","think twice",0.492989369077335,34,11,23,9.14891336522372,24.8510866347763
"2000","undone",0.492989369077335,34,11,23,9.14891336522372,24.8510866347763
"1970","find way",0.490997018625806,160,25,135,21.8956626948957,138.104337305104
"1970","two three",0.490259452526119,99,16,83,13.5479412924667,85.4520587075333
"1980","give us",0.488374604571598,43,9,34,7.23413628867385,35.7658637113261
"1980","love need love",0.488374604571598,43,9,34,7.23413628867385,35.7658637113261
"1980","never make",0.488374604571598,43,9,34,7.23413628867385,35.7658637113261
"2010","hell",0.487331070688979,402,67,335,61.8930150393394,340.106984960661
"2000","ooh oh",0.487188781830807,58,18,40,15.6069698583228,42.3930301416772
"1970","fighting",0.487058991048335,79,13,66,10.8109834556047,68.1890165443953
"1970","ooh yeah",0.487058991048335,79,13,66,10.8109834556047,68.1890165443953
"1980","satisfied",0.486826134308984,125,24,101,21.0294659554472,103.970534044553
"1960","yeah",0.48529234120598,6260,387,5873,373.867691439391,5886.13230856061
"1990","yeah baby",0.482044750502167,144,34,110,30.5488362138526,113.451163786147
"1990","cause im",0.481956066180544,475,107,368,100.768730566528,374.231269433473
"1980","love sweet",0.481651627381103,70,14,56,11.7765009350505,58.2234990649496
"1980","see dont",0.481651627381103,70,14,56,11.7765009350505,58.2234990649496
"2000","can look",0.481615935032518,24,8,16,6.45805649309909,17.5419435069009
"2000","cause one",0.481615935032518,24,8,16,6.45805649309909,17.5419435069009
"2000","click",0.481615935032518,24,8,16,6.45805649309909,17.5419435069009
"2000","ever made",0.481615935032518,24,8,16,6.45805649309909,17.5419435069009
"2000","main",0.481615935032518,24,8,16,6.45805649309909,17.5419435069009
"2000","menow",0.481615935032518,24,8,16,6.45805649309909,17.5419435069009
"2000","miney",0.481615935032518,24,8,16,6.45805649309909,17.5419435069009
"2000","much just",0.481615935032518,24,8,16,6.45805649309909,17.5419435069009
"2000","murder",0.481615935032518,24,8,16,6.45805649309909,17.5419435069009
"2000","numb",0.481615935032518,24,8,16,6.45805649309909,17.5419435069009
"2000","something just",0.481615935032518,24,8,16,6.45805649309909,17.5419435069009
"2000","strings",0.481615935032518,24,8,16,6.45805649309909,17.5419435069009
"2000","travelin",0.481615935032518,24,8,16,6.45805649309909,17.5419435069009
"2000","will stand",0.481615935032518,24,8,16,6.45805649309909,17.5419435069009
"1990","im glad",0.481231550927684,104,25,79,22.0630483766713,81.9369516233287
"2000","bone",0.478900420733988,65,20,45,17.49056966881,47.50943033119
"1990","showed",0.47812945509332,82,20,62,17.3958650662216,64.6041349337784
"1990","treat like",0.47812945509332,82,20,62,17.3958650662216,64.6041349337784
"2010","apologize",0.478102886726846,47,9,38,7.23624802698745,39.7637519730126
"2010","baby wont",0.478102886726846,47,9,38,7.23624802698745,39.7637519730126
"2010","boy can",0.478102886726846,47,9,38,7.23624802698745,39.7637519730126
"2010","cops",0.478102886726846,47,9,38,7.23624802698745,39.7637519730126
"2010","row",0.478102886726846,47,9,38,7.23624802698745,39.7637519730126
"2010","tick",0.478102886726846,47,9,38,7.23624802698745,39.7637519730126
"1990","came back",0.477968796108907,26,7,19,5.51576209416782,20.4842379058322
"1990","just im",0.477968796108907,26,7,19,5.51576209416782,20.4842379058322
"1990","love im gonna",0.477968796108907,26,7,19,5.51576209416782,20.4842379058322
"1990","real slow",0.477968796108907,26,7,19,5.51576209416782,20.4842379058322
"1990","since youve gone",0.477968796108907,26,7,19,5.51576209416782,20.4842379058322
"1990","thing ive",0.477968796108907,26,7,19,5.51576209416782,20.4842379058322
"1990","way now",0.477968796108907,26,7,19,5.51576209416782,20.4842379058322
"1980","hang",0.477581383360061,198,37,161,33.3106740734284,164.689325926572
"1990","gave",0.477036815940565,466,105,361,98.8594283031617,367.140571696838
"1980","rough",0.476455950929972,103,20,83,17.3282799472885,85.6717200527115
"1970","another day",0.474792008595236,106,17,89,14.5058765353684,91.4941234646316
"1960","na na na",0.473510442454506,1049,68,981,62.6497137891248,986.350286210875
"1990","ways",0.472161043490804,207,48,159,43.913952057413,163.086047942587
"2010","runnin",0.470147841009423,241,41,200,37.105016478808,203.894983521192
"1970","fly like",0.469474211934901,66,11,55,9.03196086164446,56.9680391383555
"1970","lose control",0.469474211934901,66,11,55,9.03196086164446,56.9680391383555
"1960","im tired",0.468581955785357,105,8,97,6.27094370625176,98.7290562937482
"1990","dinner",0.468504569276673,43,11,32,9.12222192496986,33.8777780750301
"1990","keep comin",0.468504569276673,43,11,32,9.12222192496986,33.8777780750301
"1990","know girl",0.468504569276673,43,11,32,9.12222192496986,33.8777780750301
"1990","onto",0.468504569276673,43,11,32,9.12222192496986,33.8777780750301
"1990","bein",0.466297254470028,69,17,52,14.6379840191377,54.3620159808623
"1970","baby now",0.466244528140049,86,14,72,11.7689186985064,74.2310813014936
"1970","highway",0.466244528140049,86,14,72,11.7689186985064,74.2310813014936
"1990","whole",0.466188165190943,613,137,476,130.044698604803,482.955301395197
"2000","bent",0.463793596569197,41,13,28,11.032513175711,29.9674868242891
"2000","like bird",0.463793596569197,41,13,28,11.032513175711,29.9674868242891
"2000","say got",0.463793596569197,41,13,28,11.032513175711,29.9674868242891
"2010","moments",0.463363993683083,53,10,43,8.16002437085818,44.8399756291418
"2010","paul",0.463363993683083,53,10,43,8.16002437085818,44.8399756291418
"1990","wearing",0.461121401037677,56,14,42,11.8801029720538,44.1198970279462
"1990","words say",0.461121401037677,56,14,42,11.8801029720538,44.1198970279462
"1980","breaks",0.460923666240145,54,11,43,9.08472929275321,44.9152707072468
"1970","can try",0.459125282609316,40,7,33,5.47391567372392,34.5260843262761
"1970","make everything",0.459125282609316,40,7,33,5.47391567372392,34.5260843262761
"1970","time right",0.459125282609316,40,7,33,5.47391567372392,34.5260843262761
"1970","drive crazy",0.458184465558652,53,9,44,7.25293826768419,45.7470617323158
"1970","make night",0.458184465558652,53,9,44,7.25293826768419,45.7470617323158
"1970","paul",0.458184465558652,53,9,44,7.25293826768419,45.7470617323158
"1960","mean",0.457932373929633,746,49,697,44.553561951084,701.446438048916
"1990","weve got",0.457887216987698,131,31,100,27.7909551667686,103.209044833231
"2000","girl youre",0.457570984244588,132,39,93,35.519310712045,96.480689287955
"2000","year",0.457570984244588,132,39,93,35.519310712045,96.480689287955
"1980","em like",0.456957992616454,38,8,30,6.39295765045596,31.607042349544
"1980","night youre",0.456957992616454,38,8,30,6.39295765045596,31.607042349544
"1980","split",0.456957992616454,38,8,30,6.39295765045596,31.607042349544
"1980","time go",0.456957992616454,38,8,30,6.39295765045596,31.607042349544
"1980","vow",0.456957992616454,38,8,30,6.39295765045596,31.607042349544
"1980","yeahoh",0.456957992616454,38,8,30,6.39295765045596,31.607042349544
"1960","awhile",0.456729724682198,76,6,70,4.53896877785842,71.4610312221416
"1960","im trying",0.456729724682198,76,6,70,4.53896877785842,71.4610312221416
"2010","pay",0.455773457884858,322,54,268,49.5759971210629,272.424002878937
"1970","doesnt",0.45491773246078,341,51,290,46.6651311184964,294.334868881504
"1970","fast",0.45491773246078,341,51,290,46.6651311184964,294.334868881504
"1990","alone cause",0.454031872888882,22,6,16,4.6671833104497,17.3328166895503
"1990","ever let",0.454031872888882,22,6,16,4.6671833104497,17.3328166895503
"1990","get loose",0.454031872888882,22,6,16,4.6671833104497,17.3328166895503
"1990","give oh",0.454031872888882,22,6,16,4.6671833104497,17.3328166895503
"1990","ill say",0.454031872888882,22,6,16,4.6671833104497,17.3328166895503
"1990","im need",0.454031872888882,22,6,16,4.6671833104497,17.3328166895503
"1990","im sexy",0.454031872888882,22,6,16,4.6671833104497,17.3328166895503
"1990","la da da da",0.454031872888882,22,6,16,4.6671833104497,17.3328166895503
"1990","let things",0.454031872888882,22,6,16,4.6671833104497,17.3328166895503
"1990","love show",0.454031872888882,22,6,16,4.6671833104497,17.3328166895503
"1990","nothing dont",0.454031872888882,22,6,16,4.6671833104497,17.3328166895503
"1990","oh please",0.454031872888882,22,6,16,4.6671833104497,17.3328166895503
"1990","silent",0.454031872888882,22,6,16,4.6671833104497,17.3328166895503
"1990","wack",0.454031872888882,22,6,16,4.6671833104497,17.3328166895503
"1990","wander",0.454031872888882,22,6,16,4.6671833104497,17.3328166895503
"1990","want time",0.454031872888882,22,6,16,4.6671833104497,17.3328166895503
"1990","yeah oh oh",0.454031872888882,22,6,16,4.6671833104497,17.3328166895503
"1990","yeah right",0.454031872888882,22,6,16,4.6671833104497,17.3328166895503
"2010","cant pretend",0.453600908237691,30,6,24,4.61888171935369,25.3811182806463
"2010","conscience",0.453600908237691,30,6,24,4.61888171935369,25.3811182806463
"2010","dont wanna miss",0.453600908237691,30,6,24,4.61888171935369,25.3811182806463
"2010","lookin good",0.453600908237691,30,6,24,4.61888171935369,25.3811182806463
"2010","puffin",0.453600908237691,30,6,24,4.61888171935369,25.3811182806463
"2010","rocky",0.453600908237691,30,6,24,4.61888171935369,25.3811182806463
"2010","still believe",0.453600908237691,30,6,24,4.61888171935369,25.3811182806463
"2010","together love",0.453600908237691,30,6,24,4.61888171935369,25.3811182806463
"2010","together now",0.453600908237691,30,6,24,4.61888171935369,25.3811182806463
"2010","wants dance",0.453600908237691,30,6,24,4.61888171935369,25.3811182806463
"2010","wouldve",0.453600908237691,30,6,24,4.61888171935369,25.3811182806463
"1970","every day",0.453220998673483,209,32,177,28.6012093952075,180.398790604793
"1990","learn",0.453194895841447,239,55,184,50.7025823271581,188.297417672842
"2010","breathing",0.452977792993152,59,11,48,9.08380071472892,49.9161992852711
"2010","go cause",0.452977792993152,59,11,48,9.08380071472892,49.9161992852711
"2010","need someone",0.452977792993152,59,11,48,9.08380071472892,49.9161992852711
"2010","pick",0.452693737904997,186,32,154,28.6370666599929,157.362933340007
"1980","guess",0.450667185762143,484,87,397,81.4260921794917,402.573907820508
"1990","hanging",0.450190307021321,149,35,114,31.6095596935002,117.3904403065
"1980","want want",0.448900085597193,193,36,157,32.4694954352105,160.530504564789
"1980","let take",0.447247939711025,65,13,52,10.9353222968326,54.0646777031674
"1990","come go",0.446035544421453,78,19,59,16.5472862825035,61.4527137174965
"2010","come come come come",0.445768574616093,65,12,53,10.0075770585997,54.9924229414003
"2010","doi",0.445768574616093,65,12,53,10.0075770585997,54.9924229414003
"2010","let take",0.445768574616093,65,12,53,10.0075770585997,54.9924229414003
"2010","stranger",0.445768574616093,65,12,53,10.0075770585997,54.9924229414003
"2000","embrace",0.445767339047333,48,15,33,12.9161129861982,35.0838870138018
"2000","know want know",0.445767339047333,48,15,33,12.9161129861982,35.0838870138018
"2000","wont get",0.445767339047333,48,15,33,12.9161129861982,35.0838870138018
"2000","know need",0.445314059346185,118,35,83,31.7521110910705,86.2478889089295
"1970","fate",0.444589075532565,73,12,61,9.98989610454615,63.0101038954538
"1960","way love",0.44394142586069,227,16,211,13.5571830601824,213.442816939818
"1990","work",0.44329230247385,844,187,657,179.050123364525,664.949876635475
"1980","mans",0.44318384547014,98,19,79,16.4871013090706,81.5128986909294
"1960","know well",0.441620624863721,91,7,84,5.43481787875153,85.5651821212485
"1960","repeat",0.441620624863721,91,7,84,5.43481787875153,85.5651821212485
"1980","upside",0.441480994067618,76,15,61,12.7859153009119,63.2140846990881
"2010","happiness",0.440949311595447,71,13,58,10.9313534024704,60.0686465975296
"2010","know oh",0.440949311595447,71,13,58,10.9313534024704,60.0686465975296
"1970","feels like",0.440715101545823,168,26,142,22.9904458296404,145.00955417036
"2000","say say",0.440341209988421,150,44,106,40.3628530818693,109.637146918131
"1980","war",0.439963858102021,137,26,111,23.0482946871702,113.95170531283
"1980","will always",0.439963858102021,137,26,111,23.0482946871702,113.95170531283
"2010","spin",0.436448585790489,83,15,68,12.7789060902119,70.2210939097881
"1990","yard",0.436353939278654,39,10,29,8.27364314125173,30.7263568587483
"2000","baby lets",0.434974111407878,104,31,73,27.9849114700961,76.0150885299039
"2000","better get",0.43470285173554,55,17,38,14.7997127966854,40.2002872033146
"2000","blessed",0.43470285173554,55,17,38,14.7997127966854,40.2002872033146
"2000","hero",0.43470285173554,55,17,38,14.7997127966854,40.2002872033146
"1990","asked",0.43422701518644,118,28,90,25.0330741196847,92.9669258803153
"2000","explode",0.434225673208944,31,10,21,8.34165630358633,22.6583436964137
"2000","give chance",0.434225673208944,31,10,21,8.34165630358633,22.6583436964137
"2000","happening",0.434225673208944,31,10,21,8.34165630358633,22.6583436964137
"2000","listen baby",0.434225673208944,31,10,21,8.34165630358633,22.6583436964137
"2000","love lets",0.434225673208944,31,10,21,8.34165630358633,22.6583436964137
"2000","pardon",0.434225673208944,31,10,21,8.34165630358633,22.6583436964137
"2000","pretending",0.434225673208944,31,10,21,8.34165630358633,22.6583436964137
"2000","will get",0.434225673208944,31,10,21,8.34165630358633,22.6583436964137
"1990","just need",0.433659298711876,65,16,49,13.7894052354196,51.2105947645804
"1990","will go",0.433659298711876,65,16,49,13.7894052354196,51.2105947645804
"2000","calling",0.432620123850603,218,63,155,58.6606798123168,159.339320187683
"1960","scene",0.431237222064609,121,9,112,7.22651608053775,113.773483919462
"1960","know dont",0.430988531313667,243,17,226,14.5127554344684,228.487244565532
"1990","see youre",0.430987065058587,87,21,66,18.4565885458693,68.5434114541307
"1970","magic",0.4308425557252,279,42,237,38.1805618242243,240.819438175776
"2000","wave",0.43078016673919,97,29,68,26.1013116596088,70.8986883403912
"1980","get enough",0.43074182576902,126,24,102,21.1977016830908,104.802298316909
"1990","giving",0.429155842959226,235,54,181,49.8540035434399,185.14599645656
"2010","looking",0.428786143013005,769,125,644,118.397334739433,650.602665260567
"2000","cause can",0.428270896410219,62,19,43,16.6833126071727,45.3166873928273
"2000","ohi",0.428270896410219,62,19,43,16.6833126071727,45.3166873928273
"2000","trying get",0.428270896410219,62,19,43,16.6833126071727,45.3166873928273
"1990","bread",0.428184158106423,52,13,39,11.0315241883356,40.9684758116644
"2000","let tell",0.427437489508866,90,27,63,24.2177118491216,65.7822881508784
"1980","can talk",0.426987864071218,49,10,39,8.24355065453532,40.7564493454647
"1980","hurt dont",0.426987864071218,49,10,39,8.24355065453532,40.7564493454647
"1980","jealous",0.426987864071218,49,10,39,8.24355065453532,40.7564493454647
"1980","just think",0.426987864071218,49,10,39,8.24355065453532,40.7564493454647
"1980","something can",0.426987864071218,49,10,39,8.24355065453532,40.7564493454647
"1980","can play",0.426433649266875,33,7,26,5.55177901223807,27.4482209877619
"1980","cause wont",0.426433649266875,33,7,26,5.55177901223807,27.4482209877619
"1980","laughin",0.426433649266875,33,7,26,5.55177901223807,27.4482209877619
"1980","like need",0.426433649266875,33,7,26,5.55177901223807,27.4482209877619
"1980","load",0.426433649266875,33,7,26,5.55177901223807,27.4482209877619
"1980","show im",0.426433649266875,33,7,26,5.55177901223807,27.4482209877619
"1980","youso",0.426433649266875,33,7,26,5.55177901223807,27.4482209877619
"2010","living",0.425464508104595,517,85,432,79.5987282968619,437.401271703138
"2000","uh uh uh uh",0.425159338109301,83,25,58,22.3341120386344,60.6658879613656
"1990","held",0.425117960778239,136,32,104,28.8516786464163,107.148321353584
"2000","got money",0.425077374989771,69,21,48,18.5669124176599,50.4330875823401
"2000","sang",0.425077374989771,69,21,48,18.5669124176599,50.4330875823401
"2000","spending",0.425077374989771,69,21,48,18.5669124176599,50.4330875823401
"2010","cant breathe",0.424291082144558,36,7,29,5.54265806322443,30.4573419367756
"2010","dont know can",0.424291082144558,36,7,29,5.54265806322443,30.4573419367756
"2010","got cause",0.424291082144558,36,7,29,5.54265806322443,30.4573419367756
"2010","laying",0.424291082144558,36,7,29,5.54265806322443,30.4573419367756
"2010","til youre",0.424291082144558,36,7,29,5.54265806322443,30.4573419367756
"1970","baby yeah",0.424271880564582,80,13,67,10.9478313474478,69.0521686525522
"1970","bound",0.424271880564582,80,13,67,10.9478313474478,69.0521686525522
"1970","deep love",0.424271880564582,80,13,67,10.9478313474478,69.0521686525522
"2000","im getting",0.424236717453546,76,23,53,20.4505122281471,55.5494877718529
"1990","track",0.422395603953078,145,34,111,30.7609809097821,114.239019090218
"2000","alright baby",0.421413943153459,21,7,14,5.65079943146171,15.3492005685383
"2000","bit little bit",0.421413943153459,21,7,14,5.65079943146171,15.3492005685383
"2000","cant buy",0.421413943153459,21,7,14,5.65079943146171,15.3492005685383
"2000","dance hall",0.421413943153459,21,7,14,5.65079943146171,15.3492005685383
"2000","dean",0.421413943153459,21,7,14,5.65079943146171,15.3492005685383
"2000","game love",0.421413943153459,21,7,14,5.65079943146171,15.3492005685383
"2000","glance",0.421413943153459,21,7,14,5.65079943146171,15.3492005685383
"2000","like us",0.421413943153459,21,7,14,5.65079943146171,15.3492005685383
"2000","little bit little bit",0.421413943153459,21,7,14,5.65079943146171,15.3492005685383
"2000","make well",0.421413943153459,21,7,14,5.65079943146171,15.3492005685383
"2000","mind can",0.421413943153459,21,7,14,5.65079943146171,15.3492005685383
"2000","need nobody",0.421413943153459,21,7,14,5.65079943146171,15.3492005685383
"2000","next door",0.421413943153459,21,7,14,5.65079943146171,15.3492005685383
"2000","nobody ever",0.421413943153459,21,7,14,5.65079943146171,15.3492005685383
"2000","nothing say",0.421413943153459,21,7,14,5.65079943146171,15.3492005685383
"2000","oh oh oh yeah",0.421413943153459,21,7,14,5.65079943146171,15.3492005685383
"2000","perfectly",0.421413943153459,21,7,14,5.65079943146171,15.3492005685383
"2000","stride",0.421413943153459,21,7,14,5.65079943146171,15.3492005685383
"2000","tell lie",0.421413943153459,21,7,14,5.65079943146171,15.3492005685383
"1990","stone",0.420612400307579,154,36,118,32.6702831731479,121.329716826852
"1990","aah",0.420226744769386,190,44,146,40.307492226611,149.692507773389
"1970","everyones",0.419877014603324,34,6,28,4.65282832266533,29.3471716773347
"1970","foreign",0.419877014603324,34,6,28,4.65282832266533,29.3471716773347
"1970","give dont",0.419877014603324,34,6,28,4.65282832266533,29.3471716773347
"1970","guess ill",0.419877014603324,34,6,28,4.65282832266533,29.3471716773347
"1970","hot hot hot",0.419877014603324,34,6,28,4.65282832266533,29.3471716773347
"1970","morning light",0.419877014603324,34,6,28,4.65282832266533,29.3471716773347
"1970","oh ill",0.419877014603324,34,6,28,4.65282832266533,29.3471716773347
"1970","said goodbye",0.419877014603324,34,6,28,4.65282832266533,29.3471716773347
"1970","seas",0.419877014603324,34,6,28,4.65282832266533,29.3471716773347
"1970","us together",0.419877014603324,34,6,28,4.65282832266533,29.3471716773347
"1970","wont ever",0.419877014603324,34,6,28,4.65282832266533,29.3471716773347
"1990","deal",0.419709417951751,96,23,73,20.365890809235,75.634109190765
"1990","baby know",0.419510409733147,181,42,139,38.3981899632452,142.601810036755
"1980","say dont",0.419404045782113,143,27,116,24.0577090530316,118.942290946968
"1980","someday",0.419404045782113,143,27,116,24.0577090530316,118.942290946968
"1960","love can",0.419283002124531,182,13,169,10.8696357575031,171.130364242497
"2010","bop bop",0.418168428131273,150,26,124,23.0944085967684,126.905591403232
"1960","evil",0.416533249763234,77,6,71,4.59869205125129,72.4013079487487
"1970","feel like im",0.415981649261003,47,8,39,6.4318509166256,40.5681490833744
"1970","middle night",0.415981649261003,47,8,39,6.4318509166256,40.5681490833744
"1990","can keep",0.414033371297911,74,18,56,15.6987074987853,58.3012925012147
"1990","wanna live",0.414033371297911,74,18,56,15.6987074987853,58.3012925012147
"1980","oh now",0.412844252040941,60,12,48,10.0941436586147,49.9058563413853
"2010","clear",0.411652628309424,224,38,186,34.4876501711742,189.512349828826
"2000","id like",0.411148936469369,122,36,86,32.8284538399204,89.1715461600796
"1960","dirty",0.409406431290779,244,17,227,14.5724787078612,229.427521292139
"1980","alright",0.408615616734355,705,125,580,118.606187988722,586.393812011278
"2000","can hold",0.40751163368689,38,12,26,10.2252561140736,27.7747438859264
"2000","dont want go",0.40751163368689,38,12,26,10.2252561140736,27.7747438859264
"2000","gonna show",0.40751163368689,38,12,26,10.2252561140736,27.7747438859264
"1970","baby",0.40680441163159,9098,1266,7832,1245.0421199885,7852.9578800115
"1960","paper",0.405606145653587,92,7,85,5.4945411521444,86.5054588478556
"2010","stomp",0.405094934433665,42,8,34,6.46643440709516,35.5335655929048
"1980","sight",0.405063647671343,211,39,172,35.4977385327949,175.502261467205
"1990","cause shes",0.404382003322997,35,9,26,7.42506435753361,27.5749356424664
"1990","crawl",0.404382003322997,35,9,26,7.42506435753361,27.5749356424664
"1990","ignore",0.404382003322997,35,9,26,7.42506435753361,27.5749356424664
"1990","love let love",0.404382003322997,35,9,26,7.42506435753361,27.5749356424664
"1990","mix",0.404382003322997,35,9,26,7.42506435753361,27.5749356424664
"1990","tell lies",0.404382003322997,35,9,26,7.42506435753361,27.5749356424664
"1990","tell world",0.404382003322997,35,9,26,7.42506435753361,27.5749356424664
"1990","yeah ill",0.404382003322997,35,9,26,7.42506435753361,27.5749356424664
"1960","going",0.404323076007589,1104,71,1033,65.9344938257328,1038.06550617427
"1990","cause",0.403682912735611,4691,1013,3678,995.170768605433,3695.82923139457
"2010","im feeling",0.402748792337169,132,23,109,20.3230795651562,111.676920434844
"1980","enough",0.402459088680564,798,141,657,134.252110659575,663.747889340425
"1970","soft",0.402156844445177,67,11,56,9.16880875348756,57.8311912465124
"1990","named",0.401060739667652,61,15,46,12.9408264517014,48.0591735482986
"1960","part",0.40007777008252,338,23,315,20.1864664067914,317.813533593209
"1960","whats",0.398997114266193,847,55,792,50.5856125637642,796.414387436236
"1960","na na na na",0.398442593743523,831,54,777,49.6300401894782,781.369959810522
"2000","brain",0.398421583134474,108,32,76,29.0612542189459,78.9387457810541
"2000","dont believe",0.398421583134474,108,32,76,29.0612542189459,78.9387457810541
"2010","get enough",0.39801040937819,126,22,104,19.3993032212855,106.600696778715
"2010","slowly",0.39801040937819,126,22,104,19.3993032212855,106.600696778715
"1980","believe youre",0.397271727802295,28,6,22,4.71060037402018,23.2893996259798
"1980","believer",0.397271727802295,28,6,22,4.71060037402018,23.2893996259798
"1980","confusion",0.397271727802295,28,6,22,4.71060037402018,23.2893996259798
"1980","far im",0.397271727802295,28,6,22,4.71060037402018,23.2893996259798
"1980","just right",0.397271727802295,28,6,22,4.71060037402018,23.2893996259798
"1980","long can",0.397271727802295,28,6,22,4.71060037402018,23.2893996259798
"1980","make world",0.397271727802295,28,6,22,4.71060037402018,23.2893996259798
"1980","open wide",0.397271727802295,28,6,22,4.71060037402018,23.2893996259798
"1980","sad sad",0.397271727802295,28,6,22,4.71060037402018,23.2893996259798
"1980","see things",0.397271727802295,28,6,22,4.71060037402018,23.2893996259798
"1980","thing can",0.397271727802295,28,6,22,4.71060037402018,23.2893996259798
"2010","guy",0.396378886292253,243,41,202,37.4129419267649,205.587058073235
"1990","open",0.395788254535955,519,116,403,110.103097187427,408.896902812573
"1990","backseat",0.39524691517516,48,12,36,10.1829454046175,37.8170545953825
"1990","extra",0.39524691517516,48,12,36,10.1829454046175,37.8170545953825
"1990","ill just",0.39524691517516,48,12,36,10.1829454046175,37.8170545953825
"1990","time baby",0.39524691517516,48,12,36,10.1829454046175,37.8170545953825
"1990","understands",0.39524691517516,48,12,36,10.1829454046175,37.8170545953825
"1990","youre like",0.39524691517516,48,12,36,10.1829454046175,37.8170545953825
"1970","way",0.395037699497692,4483,628,3855,613.489099132608,3869.51090086739
"1970","talkin bout",0.393372145800368,94,15,79,12.8637018332512,81.1362981667488
"1980","habit",0.393157809371255,44,9,35,7.40237201631743,36.5976279836826
"1980","kind love",0.393157809371255,44,9,35,7.40237201631743,36.5976279836826
"1980","names",0.393157809371255,44,9,35,7.40237201631743,36.5976279836826
"1980","station",0.393157809371255,44,9,35,7.40237201631743,36.5976279836826
"1980","wont go",0.393157809371255,44,9,35,7.40237201631743,36.5976279836826
"2010","box",0.392324376932729,48,9,39,7.3902107509659,40.6097892490341
"2010","shaking",0.392324376932729,48,9,39,7.3902107509659,40.6097892490341
"2010","youre like",0.392324376932729,48,9,39,7.3902107509659,40.6097892490341
"2000","apple",0.391960122680476,45,14,31,12.1088559245608,32.8911440754392
"2000","cards",0.391960122680476,45,14,31,12.1088559245608,32.8911440754392
"2000","dont wanna go",0.391960122680476,45,14,31,12.1088559245608,32.8911440754392
"2000","simply",0.391960122680476,45,14,31,12.1088559245608,32.8911440754392
"1990","heaven",0.391455761062904,432,97,335,91.6465086415577,340.353491358442
"1980","sleeping",0.390584154465687,110,21,89,18.5059300407936,91.4940699592064
"1990","promises",0.389235097141303,92,22,70,19.5173120255169,72.4826879744831
"1980","future",0.389175319983037,138,26,112,23.2165304148138,114.783469585186
"1970","knees",0.385514373388588,197,30,167,26.9590346930903,170.04096530691
"2010","meant",0.38550069770919,318,53,265,48.9601462251491,269.039853774851
"2010","dont believe",0.385461640396477,108,19,89,16.6279741896733,91.3720258103267
"1970","ya love",0.38411526431037,54,9,45,7.38978615952729,46.6102138404727
"2010","lovei",0.383891354137791,54,10,44,8.31398709483664,45.6860129051634
"1990","far",0.383360622602352,616,137,479,130.681132692591,485.318867307409
"2000","believe im",0.38312033658719,52,16,36,13.992455735048,38.007544264952
"1990","plays",0.381524320008954,101,24,77,21.4266142888827,79.5733857111173
"2000","aint way",0.378630855522798,59,18,41,15.8760555455353,43.1239444544647
"2000","sell",0.378630855522798,59,18,41,15.8760555455353,43.1239444544647
"1960","suddenly",0.378531964168904,78,6,72,4.65841532464417,73.3415846753558
"2010","people say",0.378524592610641,60,11,49,9.23776343870738,50.7622365612926
"2010","sold",0.378524592610641,60,11,49,9.23776343870738,50.7622365612926
"2000","hope",0.378477597088134,523,147,376,140.731814412118,382.268185587882
"1980","go round",0.378440564370877,55,11,44,9.25296502039679,45.7470349796032
"2000","ill go",0.377122047890549,66,20,46,17.7596553560225,48.2403446439775
"2000","just cant get",0.377122047890549,66,20,46,17.7596553560225,48.2403446439775
"1980","sister",0.377028810297981,88,17,71,14.8047440326349,73.1952559673651
"2010","get low",0.3765596116278,90,16,74,13.8566451580611,76.1433548419389
"2010","rise",0.3765596116278,90,16,74,13.8566451580611,76.1433548419389
"1990","hoe",0.375930068522929,110,26,84,23.3359165522485,86.6640834477515
"2000","ill wait",0.375772135940659,28,9,19,7.53439924194894,20.4656007580511
"2000","open wide",0.375772135940659,28,9,19,7.53439924194894,20.4656007580511
"2000","take can",0.375772135940659,28,9,19,7.53439924194894,20.4656007580511
"2010","iti",0.375405623688293,66,12,54,10.1615397825781,55.8384602174219
"2010","silver",0.375405623688293,66,12,54,10.1615397825781,55.8384602174219
"1960","king",0.374852830297954,138,10,128,8.2418117282166,129.758188271783
"2010","tree",0.374800722531143,84,15,69,12.9328688141903,71.0671311858097
"1970","back time",0.373917455728896,41,7,34,5.61076356556702,35.389236434433
"1970","time just",0.373917455728896,41,7,34,5.61076356556702,35.389236434433
"1970","love know",0.373912520661819,149,23,126,20.3903358846216,128.609664115378
"1970","bang",0.373876546901476,239,36,203,32.7066461505004,206.2933538495
"2010","now tell",0.373874091943038,78,14,64,12.0090924703196,65.9909075296804
"1980","telephone",0.373378478170304,77,15,62,12.9541510285555,64.0458489714445
"1980","ever wanted",0.373175592312458,66,13,53,11.1035580244761,54.8964419755239
"1980","love baby love",0.373175592312458,66,13,53,11.1035580244761,54.8964419755239
"1980","silver",0.373175592312458,66,13,53,11.1035580244761,54.8964419755239
"1980","waste time",0.373175592312458,66,13,53,11.1035580244761,54.8964419755239
"1990","bitch im",0.372657460070401,31,8,23,6.57648557381548,24.4235144261845
"1990","explode",0.372657460070401,31,8,23,6.57648557381548,24.4235144261845
"1990","long long time",0.372657460070401,31,8,23,6.57648557381548,24.4235144261845
"1990","sucker",0.372657460070401,31,8,23,6.57648557381548,24.4235144261845
"1990","tale",0.372657460070401,31,8,23,6.57648557381548,24.4235144261845
"1990","yeah think",0.372657460070401,31,8,23,6.57648557381548,24.4235144261845
"1990","yeah uh",0.372657460070401,31,8,23,6.57648557381548,24.4235144261845
"1990","youll get",0.372657460070401,31,8,23,6.57648557381548,24.4235144261845
"1990","gun",0.371853286578393,191,44,147,40.5196369225405,150.480363077459
"1960","runs",0.371382062490406,93,7,86,5.55426442553728,87.4457355744627
"1970","can hear",0.371348668561128,108,17,91,14.7795723190546,93.2204276809454
"1980","power",0.370998579299037,246,45,201,41.3859890003202,204.61401099968
"2010","outta",0.370718489034433,188,32,156,28.9449921079498,159.05500789205
"1960","strange",0.369504140204258,108,8,100,6.45011352643039,101.54988647357
"1960","taken",0.369504140204258,108,8,100,6.45011352643039,101.54988647357
"1990","blood",0.369326436372366,128,30,98,27.15452107898,100.84547892102
"1970","still love",0.369097042397561,156,24,132,21.3482711275233,134.651728872477
"1990","ooh yeah",0.368662564508194,79,19,60,16.759430978433,62.240569021567
"1990","cause just",0.368509904601737,57,14,43,12.0922476679833,44.9077523320167
"1990","gotta let",0.368509904601737,57,14,43,12.0922476679833,44.9077523320167
"1990","hardly",0.368509904601737,57,14,43,12.0922476679833,44.9077523320167
"1990","just friend",0.368509904601737,57,14,43,12.0922476679833,44.9077523320167
"1980","sense",0.368251442594905,116,22,94,19.515344406655,96.484655593345
"2000","met",0.366283076929777,313,89,224,84.2238200975007,228.776179902499
"1990","know can",0.365817918857392,241,55,186,51.1268717190171,189.873128280983
"2010","let go",0.363784594056211,804,130,674,123.786030078679,680.213969921321
"1970","knew",0.362413241506747,712,103,609,97.4356989922857,614.564301007714
"1970","stop",0.362330918226725,1555,221,1334,212.798471816017,1342.20152818398
"1990","got good",0.362309672243889,44,11,33,9.33436662089939,34.6656333791006
"1990","kind love",0.362309672243889,44,11,33,9.33436662089939,34.6656333791006
"1990","meoh",0.362309672243889,44,11,33,9.33436662089939,34.6656333791006
"2000","another life",0.361211951274386,18,6,12,4.84354236982432,13.1564576301757
"2000","away lets",0.361211951274386,18,6,12,4.84354236982432,13.1564576301757
"2000","baby baby like",0.361211951274386,18,6,12,4.84354236982432,13.1564576301757
"2000","baby yes",0.361211951274386,18,6,12,4.84354236982432,13.1564576301757
"2000","clique",0.361211951274386,18,6,12,4.84354236982432,13.1564576301757
"2000","court",0.361211951274386,18,6,12,4.84354236982432,13.1564576301757
"2000","dancing dancing",0.361211951274386,18,6,12,4.84354236982432,13.1564576301757
"2000","fall back",0.361211951274386,18,6,12,4.84354236982432,13.1564576301757
"2000","fightin",0.361211951274386,18,6,12,4.84354236982432,13.1564576301757
"2000","finer things",0.361211951274386,18,6,12,4.84354236982432,13.1564576301757
"2000","get much",0.361211951274386,18,6,12,4.84354236982432,13.1564576301757
"2000","give wont",0.361211951274386,18,6,12,4.84354236982432,13.1564576301757
"2000","hard like",0.361211951274386,18,6,12,4.84354236982432,13.1564576301757
"2000","help get",0.361211951274386,18,6,12,4.84354236982432,13.1564576301757
"2000","im lying",0.361211951274386,18,6,12,4.84354236982432,13.1564576301757
"2000","inside dont",0.361211951274386,18,6,12,4.84354236982432,13.1564576301757
"2000","inside youre",0.361211951274386,18,6,12,4.84354236982432,13.1564576301757
"2000","involved",0.361211951274386,18,6,12,4.84354236982432,13.1564576301757
"2000","ive come",0.361211951274386,18,6,12,4.84354236982432,13.1564576301757
"2000","ive got get",0.361211951274386,18,6,12,4.84354236982432,13.1564576301757
"2000","just cant help",0.361211951274386,18,6,12,4.84354236982432,13.1564576301757
"2000","just didnt",0.361211951274386,18,6,12,4.84354236982432,13.1564576301757
"2000","know makes",0.361211951274386,18,6,12,4.84354236982432,13.1564576301757
"2000","large",0.361211951274386,18,6,12,4.84354236982432,13.1564576301757
"2000","like old",0.361211951274386,18,6,12,4.84354236982432,13.1564576301757
"2000","need take",0.361211951274386,18,6,12,4.84354236982432,13.1564576301757
"2000","night want",0.361211951274386,18,6,12,4.84354236982432,13.1564576301757
"2000","now every",0.361211951274386,18,6,12,4.84354236982432,13.1564576301757
"2000","pay bills",0.361211951274386,18,6,12,4.84354236982432,13.1564576301757
"2000","quicker",0.361211951274386,18,6,12,4.84354236982432,13.1564576301757
"2000","right ill",0.361211951274386,18,6,12,4.84354236982432,13.1564576301757
"2000","said cant",0.361211951274386,18,6,12,4.84354236982432,13.1564576301757
"2000","shake just",0.361211951274386,18,6,12,4.84354236982432,13.1564576301757
"2000","sides",0.361211951274386,18,6,12,4.84354236982432,13.1564576301757
"2000","thats okay",0.361211951274386,18,6,12,4.84354236982432,13.1564576301757
"2000","tips",0.361211951274386,18,6,12,4.84354236982432,13.1564576301757
"2000","us know",0.361211951274386,18,6,12,4.84354236982432,13.1564576301757
"2000","veins",0.361211951274386,18,6,12,4.84354236982432,13.1564576301757
"2000","waitin waitin",0.361211951274386,18,6,12,4.84354236982432,13.1564576301757
"2000","wanna fight",0.361211951274386,18,6,12,4.84354236982432,13.1564576301757
"2000","wanna spend",0.361211951274386,18,6,12,4.84354236982432,13.1564576301757
"2000","well ill",0.361211951274386,18,6,12,4.84354236982432,13.1564576301757
"2000","wouldnt let",0.361211951274386,18,6,12,4.84354236982432,13.1564576301757
"2000","youre going way",0.361211951274386,18,6,12,4.84354236982432,13.1564576301757
"1970","changing",0.359773467344012,61,10,51,8.34772140242897,52.652278597571
"1980","bother",0.359473921659397,39,8,31,6.56119337809954,32.4388066219005
"1980","feel can",0.359473921659397,39,8,31,6.56119337809954,32.4388066219005
"1980","heal",0.359473921659397,39,8,31,6.56119337809954,32.4388066219005
"1980","loves loves",0.359473921659397,39,8,31,6.56119337809954,32.4388066219005
"1980","page",0.359473921659397,39,8,31,6.56119337809954,32.4388066219005
"1990","cause need",0.358987074215714,88,21,67,18.6687332417988,69.3312667582012
"1990","love one",0.358987074215714,88,21,67,18.6687332417988,69.3312667582012
"1990","way back",0.358987074215714,88,21,67,18.6687332417988,69.3312667582012
"1980","dust",0.358951521474183,105,20,85,17.6647514025757,87.3352485974243
"2000","im love",0.358789817188314,223,64,159,60.0061082483791,162.993891751621
"1990","along",0.357671405846345,401,90,311,85.0700230677422,315.929976932258
"1970","anyway",0.35521306583876,122,19,103,16.6954428048579,105.304557195142
"1970","deep",0.353155809715092,606,88,518,82.9298224569173,523.070177543083
"1970","chains",0.353070184777458,88,14,74,12.0426144821926,75.9573855178074
"1990","leaves",0.352069397194676,97,23,74,20.5780355051646,76.4219644948354
"2000","im never gonna",0.351908753221777,35,11,24,9.41799905243618,25.5820009475638
"1980","men",0.35106822083968,184,34,150,30.9553738864183,153.044626113582
"1990","theyd",0.350371426152369,66,16,50,14.0015499313491,51.9984500686509
"2010","came life",0.349828234307407,31,6,25,4.77284444333215,26.2271555566679
"2010","got new",0.349828234307407,31,6,25,4.77284444333215,26.2271555566679
"2010","holding back",0.349828234307407,31,6,25,4.77284444333215,26.2271555566679
"2010","man just",0.349828234307407,31,6,25,4.77284444333215,26.2271555566679
"2010","now feel",0.349828234307407,31,6,25,4.77284444333215,26.2271555566679
"2010","take love",0.349828234307407,31,6,25,4.77284444333215,26.2271555566679
"2010","things life",0.349828234307407,31,6,25,4.77284444333215,26.2271555566679
"1970","oh baby",0.349672292985252,387,57,330,52.9601341432789,334.039865856721
"1980","anywhere",0.348058441872213,122,23,99,20.5247587725165,101.475241227483
"1960","tell",0.347780253780574,3445,214,3231,205.746676838451,3239.25332316155
"1960","heart",0.347380767460463,2871,179,2692,171.465517910941,2699.53448208906
"1990","thick",0.347216308765902,106,25,81,22.4873377685304,83.5126622314696
"1990","guess",0.345824720736244,484,108,376,102.678032829893,381.321967170107
"2010","driving",0.344919152815108,121,21,100,18.6294896013932,102.370510398607
"1980","flower",0.344036876700797,50,10,40,8.4117863821789,41.5882136178211
"1980","lover lover",0.344036876700797,50,10,40,8.4117863821789,41.5882136178211
"2010","remember",0.342792637555723,894,144,750,137.64267523674,756.35732476326
"1990","find way",0.342116804358275,160,37,123,33.9431513487251,126.056848651275
"1990","shy",0.341926154020306,124,29,95,26.3059422952619,97.6940577047381
"1970","ill just",0.341435790498107,48,8,40,6.5686988084687,41.4313011915313
"2010","standing",0.341346138336633,307,51,256,47.2665562613861,259.733443738614
"1990","alright alright alright alright",0.341289403349731,27,7,20,5.72790679009735,21.2720932099026
"1990","around ill",0.341289403349731,27,7,20,5.72790679009735,21.2720932099026
"1990","dogs",0.341289403349731,27,7,20,5.72790679009735,21.2720932099026
"1990","every man",0.341289403349731,27,7,20,5.72790679009735,21.2720932099026
"1990","frozen",0.341289403349731,27,7,20,5.72790679009735,21.2720932099026
"1990","grey",0.341289403349731,27,7,20,5.72790679009735,21.2720932099026
"1990","level",0.341289403349731,27,7,20,5.72790679009735,21.2720932099026
"1990","see go",0.341289403349731,27,7,20,5.72790679009735,21.2720932099026
"1990","solve",0.341289403349731,27,7,20,5.72790679009735,21.2720932099026
"1990","squad",0.341289403349731,27,7,20,5.72790679009735,21.2720932099026
"1990","stop us",0.341289403349731,27,7,20,5.72790679009735,21.2720932099026
"1990","talk dont",0.341289403349731,27,7,20,5.72790679009735,21.2720932099026
"1990","titties",0.341289403349731,27,7,20,5.72790679009735,21.2720932099026
"1990","yup",0.341289403349731,27,7,20,5.72790679009735,21.2720932099026
"1990","now baby",0.341120184437889,151,35,116,32.0338490853593,118.966150914641
"1970","aint got",0.340704292943644,268,40,228,36.6752350139502,231.32476498605
"2000","really dont",0.340425274702034,84,25,59,22.6031977258468,61.3968022741532
"1980","tell baby",0.339889056227916,72,14,58,12.1129723903376,59.8870276096624
"1980","underneath",0.339889056227916,72,14,58,12.1129723903376,59.8870276096624
"1960","im never",0.339480191467962,109,8,101,6.50983679982326,102.490163200177
"1960","others",0.339480191467962,109,8,101,6.50983679982326,102.490163200177
"2000","buck",0.339078790467505,42,13,29,11.3015988629234,30.6984011370766
"2000","go ill",0.339078790467505,42,13,29,11.3015988629234,30.6984011370766
"2000","holler",0.339078790467505,42,13,29,11.3015988629234,30.6984011370766
"2000","know let",0.339078790467505,42,13,29,11.3015988629234,30.6984011370766
"2000","relationship",0.339078790467505,42,13,29,11.3015988629234,30.6984011370766
"1960","dont love",0.338908526599046,94,7,87,5.61398769893015,88.3860123010698
"1960","wrote",0.338908526599046,94,7,87,5.61398769893015,88.3860123010698
"1960","somehow",0.338739348710476,170,12,158,10.1529564767886,159.847043523211
"1960","cool",0.338337490143144,389,26,363,23.232353349828,365.767646650172
"1980","now can",0.337439194186204,111,21,90,18.6741657684371,92.3258342315629
"2000","lie",0.337379303024424,517,145,372,139.117300288843,377.882699711157
"1960","sad",0.33637422965546,326,22,304,19.4697871260769,306.530212873923
"1990","believed",0.336017645575061,53,13,40,11.2436688842652,41.7563311157348
"1990","calls",0.336017645575061,53,13,40,11.2436688842652,41.7563311157348
"1990","feed",0.336017645575061,53,13,40,11.2436688842652,41.7563311157348
"1990","got know",0.336017645575061,53,13,40,11.2436688842652,41.7563311157348
"1990","just love",0.336017645575061,53,13,40,11.2436688842652,41.7563311157348
"2000","baby tell",0.33592175846918,77,23,54,20.7195979153596,56.2804020846404
"1960","finally",0.335908097373069,201,14,187,12.0043779519677,188.995622048032
"2000","dip",0.334896757749418,166,48,118,44.6682240772687,121.331775922731
"2010","love like",0.334085549139795,301,50,251,46.3427799175153,254.657220082485
"2010","baby say",0.332797593536525,37,7,30,5.69662078720288,31.3033792127971
"2010","leather",0.332797593536525,37,7,30,5.69662078720288,31.3033792127971
"2010","make mind",0.332797593536525,37,7,30,5.69662078720288,31.3033792127971
"2010","way work",0.332797593536525,37,7,30,5.69662078720288,31.3033792127971
"2000","got way",0.332609879018646,49,15,34,13.1851986734107,35.8148013265894
"2000","just think",0.332609879018646,49,15,34,13.1851986734107,35.8148013265894
"2000","keepin",0.332609879018646,49,15,34,13.1851986734107,35.8148013265894
"2000","mamas",0.332609879018646,49,15,34,13.1851986734107,35.8148013265894
"2000","shots",0.332451380729099,70,21,49,18.8359981048724,51.1640018951276
"1970","fields",0.332062650294056,35,6,29,4.78967621450843,30.2103237854916
"1970","im running",0.332062650294056,35,6,29,4.78967621450843,30.2103237854916
"1970","lake",0.332062650294056,35,6,29,4.78967621450843,30.2103237854916
"1970","lonely lonely",0.332062650294056,35,6,29,4.78967621450843,30.2103237854916
"1970","see cant",0.332062650294056,35,6,29,4.78967621450843,30.2103237854916
"1970","tell lies",0.332062650294056,35,6,29,4.78967621450843,30.2103237854916
"1970","time ill",0.332062650294056,35,6,29,4.78967621450843,30.2103237854916
"1970","tryin make",0.332062650294056,35,6,29,4.78967621450843,30.2103237854916
"2000","go back",0.331950278084128,141,41,100,37.9410818969572,103.058918103043
"2000","just dont",0.331446066058687,184,53,131,49.5117664470931,134.488233552907
"2010","breaking",0.331058036884933,152,26,126,23.4023340447254,128.597665955275
"2000","now want",0.330355042372987,63,19,44,16.9523982943851,46.0476017056149
"1960","dont mind",0.330221360930157,155,11,144,9.25710737589546,145.742892624105
"2000","baby like",0.330142214421631,56,17,39,15.0687984838979,40.9312015161021
"2000","wearing",0.330142214421631,56,17,39,15.0687984838979,40.9312015161021
"1990","baby girl",0.329656305659053,201,46,155,42.6410838818359,158.358916118164
"1990","dice",0.329372429312633,40,10,30,8.48578783718126,31.5142121628187
"1990","flames",0.329372429312633,40,10,30,8.48578783718126,31.5142121628187
"1990","get dont",0.329372429312633,40,10,30,8.48578783718126,31.5142121628187
"1990","make everything",0.329372429312633,40,10,30,8.48578783718126,31.5142121628187
"1990","seats",0.329372429312633,40,10,30,8.48578783718126,31.5142121628187
"1990","take care",0.329372429312633,40,10,30,8.48578783718126,31.5142121628187
"2010","wasnt",0.329292356657779,245,41,204,37.7208673747218,207.279132625278
"2000","keeps",0.327694728572212,285,81,204,76.6894208555518,208.310579144448
"1980","agree",0.326000228872593,34,7,27,5.72001473988165,28.2799852601184
"1980","cheat",0.326000228872593,34,7,27,5.72001473988165,28.2799852601184
"1980","evry",0.326000228872593,34,7,27,5.72001473988165,28.2799852601184
"1980","heaven heaven",0.326000228872593,34,7,27,5.72001473988165,28.2799852601184
"1980","let put",0.326000228872593,34,7,27,5.72001473988165,28.2799852601184
"1980","love oh oh",0.326000228872593,34,7,27,5.72001473988165,28.2799852601184
"1980","oh oh yeah",0.326000228872593,34,7,27,5.72001473988165,28.2799852601184
"1980","seas",0.326000228872593,34,7,27,5.72001473988165,28.2799852601184
"1980","totally",0.326000228872593,34,7,27,5.72001473988165,28.2799852601184
"1980","wolf",0.326000228872593,34,7,27,5.72001473988165,28.2799852601184
"2010","acting",0.325804603437981,97,17,80,14.9343842259103,82.0656157740897
"2010","lift",0.325804603437981,97,17,80,14.9343842259103,82.0656157740897
"1960","end",0.324748971148001,629,41,588,37.5659389641177,591.434061035882
"1970","pretty",0.323866285003165,487,71,416,66.6449233275887,420.355076672411
"1990","sippin",0.322917861138281,93,22,71,19.7294567214464,73.2705432785536
"1960","kinda",0.322458399903796,264,18,246,15.7669441757187,248.233055824281
"2010","dinner",0.322365268661032,43,8,35,6.62039713107362,36.3796028689264
"2010","gonna stand",0.322365268661032,43,8,35,6.62039713107362,36.3796028689264
"2010","weight",0.322365268661032,43,8,35,6.62039713107362,36.3796028689264
"1990","youi",0.321779860091087,233,53,180,49.4297141515809,183.570285848419
"1990","open door",0.318756167491653,62,15,47,13.152971147631,48.847028852369
"2010","lately",0.318329295053307,85,15,70,13.0868315381688,71.9131684618312
"1970","cover",0.318165983933185,116,18,98,15.8743554537994,100.125644546201
"2000","eighty",0.317741225106134,25,8,17,6.72714218031156,18.2728578196884
"2000","fire fire",0.317741225106134,25,8,17,6.72714218031156,18.2728578196884
"2000","get want",0.317741225106134,25,8,17,6.72714218031156,18.2728578196884
"2000","hear sound",0.317741225106134,25,8,17,6.72714218031156,18.2728578196884
"2000","hold dont",0.317741225106134,25,8,17,6.72714218031156,18.2728578196884
"2000","honest",0.317741225106134,25,8,17,6.72714218031156,18.2728578196884
"2000","im asking",0.317741225106134,25,8,17,6.72714218031156,18.2728578196884
"2000","patient",0.317741225106134,25,8,17,6.72714218031156,18.2728578196884
"2000","thats left",0.317741225106134,25,8,17,6.72714218031156,18.2728578196884
"2000","yeahand",0.317741225106134,25,8,17,6.72714218031156,18.2728578196884
"1970","good lovin",0.317455011994809,55,9,46,7.52663405137039,47.4733659486296
"2000","breaking",0.316344389758147,152,44,108,40.9010244562943,111.098975543706
"1990","wonderful",0.316278909716081,111,26,85,23.548061248178,87.451938751822
"1960","answer",0.315939605471433,171,12,159,10.2126797501814,160.787320249819
"1990","dont ever",0.315706051667211,147,34,113,31.1852703016411,115.814729698359
"2010","late night",0.315384499835583,79,14,65,12.163055194298,66.8369448057019
"2010","like one",0.313139122486202,73,13,60,11.2392788504273,61.7607211495727
"1970","dad",0.31312090637376,82,13,69,11.221527131134,70.778472868866
"1970","flame",0.31312090637376,82,13,69,11.221527131134,70.778472868866
"1980","just feel",0.311560669403374,78,15,63,13.1223867561991,64.8776132438009
"1980","oh can",0.311560669403374,78,15,63,13.1223867561991,64.8776132438009
"1990","falling",0.311174572125152,375,84,291,79.5542609735744,295.445739026426
"1960","begin",0.310909665216142,110,8,102,6.56956007321613,103.430439926784
"1990","can feel can",0.310462134674866,23,6,17,4.87932800637923,18.1206719936208
"1990","clearly",0.310462134674866,23,6,17,4.87932800637923,18.1206719936208
"1990","close dont",0.310462134674866,23,6,17,4.87932800637923,18.1206719936208
"1990","dayi",0.310462134674866,23,6,17,4.87932800637923,18.1206719936208
"1990","finished",0.310462134674866,23,6,17,4.87932800637923,18.1206719936208
"1990","free soul",0.310462134674866,23,6,17,4.87932800637923,18.1206719936208
"1990","get close",0.310462134674866,23,6,17,4.87932800637923,18.1206719936208
"1990","hold love",0.310462134674866,23,6,17,4.87932800637923,18.1206719936208
"1990","ive waited",0.310462134674866,23,6,17,4.87932800637923,18.1206719936208
"1990","joke",0.310462134674866,23,6,17,4.87932800637923,18.1206719936208
"1990","know oh oh",0.310462134674866,23,6,17,4.87932800637923,18.1206719936208
"1990","know one thing",0.310462134674866,23,6,17,4.87932800637923,18.1206719936208
"1990","layin",0.310462134674866,23,6,17,4.87932800637923,18.1206719936208
"1990","life cause",0.310462134674866,23,6,17,4.87932800637923,18.1206719936208
"1990","long since",0.310462134674866,23,6,17,4.87932800637923,18.1206719936208
"1990","love made",0.310462134674866,23,6,17,4.87932800637923,18.1206719936208
"1990","may seem",0.310462134674866,23,6,17,4.87932800637923,18.1206719936208
"1990","need got",0.310462134674866,23,6,17,4.87932800637923,18.1206719936208
"1990","one just",0.310462134674866,23,6,17,4.87932800637923,18.1206719936208
"1990","penny",0.310462134674866,23,6,17,4.87932800637923,18.1206719936208
"1990","spoken",0.310462134674866,23,6,17,4.87932800637923,18.1206719936208
"1990","think cant",0.310462134674866,23,6,17,4.87932800637923,18.1206719936208
"1990","tomorrows",0.310462134674866,23,6,17,4.87932800637923,18.1206719936208
"1990","true im",0.310462134674866,23,6,17,4.87932800637923,18.1206719936208
"1980","cards",0.309633189030718,45,9,36,7.57060774396101,37.429392256039
"1980","just remember",0.309633189030718,45,9,36,7.57060774396101,37.429392256039
"1980","realized",0.309633189030718,45,9,36,7.57060774396101,37.429392256039
"1960","baby yeah",0.308884263968295,80,6,74,4.77786187142992,75.2221381285701
"1960","find love",0.308884263968295,80,6,74,4.77786187142992,75.2221381285701
"1960","need need",0.308147005593249,95,7,88,5.67371097232302,89.326289027677
"1990","im always",0.307145966543482,71,17,54,15.0622734109967,55.9377265890033
"1980","know now",0.306970864645697,106,20,86,17.8329871302193,88.1670128697807
"1990","find",0.306580860466436,1686,367,1319,357.67595733719,1328.32404266281
"2000","dont see",0.305876055758377,120,35,85,32.2902824654955,87.7097175345045
"2000","sounds",0.305876055758377,120,35,85,32.2902824654955,87.7097175345045
"2000","turns",0.305876055758377,120,35,85,32.2902824654955,87.7097175345045
"2010","get right",0.305851763502987,128,22,106,19.7072286692424,108.292771330758
"2010","turning",0.305295631431505,165,28,137,25.4038494564453,139.596150543555
"1980","drum",0.30505028172805,56,11,45,9.42120074804036,46.5787992519596
"1980","release",0.30505028172805,56,11,45,9.42120074804036,46.5787992519596
"2000","way back",0.3050473228297,88,26,62,23.6795404746967,64.3204595253033
"1970","just keep",0.303402291633586,137,21,116,18.7481611825044,118.251838817496
"1980","love way",0.303335430608199,248,45,203,41.7224604556073,206.277539544393
"1970","flowers",0.302987653497032,89,14,75,12.1794623740357,76.8205376259643
"1970","skies",0.302987653497032,89,14,75,12.1794623740357,76.8205376259643
"1990","homie",0.29930732949104,80,19,61,16.9715756743625,63.0284243256375
"1990","question",0.29930732949104,80,19,61,16.9715756743625,63.0284243256375
"1970","forever ever",0.299182042130495,62,10,52,8.48456929427207,53.5154307057279
"1970","pair",0.299182042130495,62,10,52,8.48456929427207,53.5154307057279
"1970","answers",0.298756316685846,42,7,35,5.74761145741011,36.2523885425899
"1970","gonna lose",0.298756316685846,42,7,35,5.74761145741011,36.2523885425899
"1970","holler",0.298756316685846,42,7,35,5.74761145741011,36.2523885425899
"1970","make see",0.298756316685846,42,7,35,5.74761145741011,36.2523885425899
"1970","note",0.298756316685846,42,7,35,5.74761145741011,36.2523885425899
"1970","pool",0.298756316685846,42,7,35,5.74761145741011,36.2523885425899
"1970","sha",0.298756316685846,42,7,35,5.74761145741011,36.2523885425899
"1970","stay away",0.298756316685846,42,7,35,5.74761145741011,36.2523885425899
"1970","think ill",0.298756316685846,42,7,35,5.74761145741011,36.2523885425899
"2010","thats right",0.298429688441941,159,27,132,24.4800731125746,134.519926887425
"2000","back cause",0.297178226031561,32,10,22,8.61074199079879,23.3892580092012
"2000","back right",0.297178226031561,32,10,22,8.61074199079879,23.3892580092012
"2000","know yeah",0.297178226031561,32,10,22,8.61074199079879,23.3892580092012
"2000","lets lets",0.297178226031561,32,10,22,8.61074199079879,23.3892580092012
"2000","trap",0.297178226031561,32,10,22,8.61074199079879,23.3892580092012
"1980","burnin",0.297081506979089,157,29,128,26.4130092400417,130.586990759958
"1980","plans",0.296573508563218,95,18,77,15.9823941261399,79.0176058738601
"1990","able",0.29643518638136,36,9,27,7.63720905346314,28.3627909465369
"1990","battle",0.29643518638136,36,9,27,7.63720905346314,28.3627909465369
"1990","one us",0.29643518638136,36,9,27,7.63720905346314,28.3627909465369
"1960","stop",0.296351837024464,1555,98,1457,92.869690125919,1462.13030987408
"2010","baby im",0.295725383880059,340,56,284,52.3473261526751,287.652673847325
"1980","sweet",0.295331489992401,1136,198,938,191.115786603105,944.884213396896
"2000","relax",0.293239646623279,74,22,52,19.9123408537222,54.0876591462778
"2000","standin",0.293239646623279,74,22,52,19.9123408537222,54.0876591462778
"2010","past",0.293038007987469,215,36,179,33.1019856553681,181.898014344632
"1980","cause dont know",0.29284455297351,29,6,23,4.87883610166376,24.1211638983362
"1980","erase",0.29284455297351,29,6,23,4.87883610166376,24.1211638983362
"1980","everlasting",0.29284455297351,29,6,23,4.87883610166376,24.1211638983362
"1980","fashion",0.29284455297351,29,6,23,4.87883610166376,24.1211638983362
"1980","fiesta",0.29284455297351,29,6,23,4.87883610166376,24.1211638983362
"1980","gave heart",0.29284455297351,29,6,23,4.87883610166376,24.1211638983362
"1980","go never",0.29284455297351,29,6,23,4.87883610166376,24.1211638983362
"1980","good dont",0.29284455297351,29,6,23,4.87883610166376,24.1211638983362
"1980","however",0.29284455297351,29,6,23,4.87883610166376,24.1211638983362
"1980","man aint",0.29284455297351,29,6,23,4.87883610166376,24.1211638983362
"1980","man like",0.29284455297351,29,6,23,4.87883610166376,24.1211638983362
"1980","mean nothing",0.29284455297351,29,6,23,4.87883610166376,24.1211638983362
"1980","meso",0.29284455297351,29,6,23,4.87883610166376,24.1211638983362
"1980","rising",0.29284455297351,29,6,23,4.87883610166376,24.1211638983362
"1980","stay night",0.29284455297351,29,6,23,4.87883610166376,24.1211638983362
"1980","summers",0.29284455297351,29,6,23,4.87883610166376,24.1211638983362
"1980","tell really",0.29284455297351,29,6,23,4.87883610166376,24.1211638983362
"1980","tonighti",0.29284455297351,29,6,23,4.87883610166376,24.1211638983362
"1980","traffic",0.29284455297351,29,6,23,4.87883610166376,24.1211638983362
"1980","una",0.29284455297351,29,6,23,4.87883610166376,24.1211638983362
"2000","funny",0.290774729132375,192,55,137,51.6644519447928,140.335548055207
"2010","fear",0.290335627070846,184,31,153,28.329141212036,155.670858787964
"1960","explain",0.290272847624675,126,9,117,7.52513244750212,118.474867552498
"1960","father",0.290272847624675,126,9,117,7.52513244750212,118.474867552498
"2010","feel",0.28751458164513,3697,581,3116,569.200190548353,3127.79980945165
"2000","just trying",0.287340252440404,39,12,27,10.494341801286,28.505658198714
"2000","lala",0.287340252440404,39,12,27,10.494341801286,28.505658198714
"2000","might well",0.287340252440404,39,12,27,10.494341801286,28.505658198714
"1980","make make",0.287161217179347,84,16,68,14.1318011220605,69.8681988779394
"2000","missin",0.284958326339218,60,18,42,16.1451412327477,43.8548587672523
"2000","reasons",0.284958326339218,60,18,42,16.1451412327477,43.8548587672523
"2000","ya got",0.284958326339218,60,18,42,16.1451412327477,43.8548587672523
"1970","bein",0.284927462754063,69,11,58,9.44250453717376,59.5574954628262
"1970","come around",0.284927462754063,69,11,58,9.44250453717376,59.5574954628262
"1970","ive waiting",0.284927462754063,69,11,58,9.44250453717376,59.5574954628262
"1970","shakin",0.284927462754063,69,11,58,9.44250453717376,59.5574954628262
"1980","slip",0.284638904119559,129,24,105,21.7024088660216,107.297591133978
"1980","walkin",0.284638904119559,129,24,105,21.7024088660216,107.297591133978
"1980","cant see",0.284263890337096,306,55,251,51.4801326589348,254.519867341065
"1970","please dont",0.284155634333988,249,37,212,34.0751250689314,214.924874931069
"1970","night long",0.283935050609105,242,36,206,33.1171898260297,208.88281017397
"1960","love thats",0.283765227592693,111,8,103,6.62928334660901,104.370716653391
"2000","im thinkin",0.283384916659847,46,14,32,12.3779416117733,33.6220583882267
"2000","love take",0.283384916659847,46,14,32,12.3779416117733,33.6220583882267
"2000","barely",0.283004289907332,53,16,37,14.2615414222605,38.7384585777395
"2000","dont bring",0.283004289907332,53,16,37,14.2615414222605,38.7384585777395
"1970","snow",0.281746186793194,110,17,93,15.0532681027408,94.9467318972592
"2000","aint nothin",0.281101833794259,99,29,70,26.6394830340338,72.3605169659662
"1990","try",0.279422614006055,1260,275,985,267.30231687121,992.69768312879
"1980","begging",0.27917335396535,73,14,59,12.2812081179812,60.7187918820188
"1980","just hold",0.27917335396535,73,14,59,12.2812081179812,60.7187918820188
"1960","aint never",0.279060226097484,96,7,89,5.7334342457159,90.2665657542841
"1960","become",0.279060226097484,96,7,89,5.7334342457159,90.2665657542841
"1960","bite",0.277128105153177,81,6,75,4.83758514482279,76.1624148551772
"2010","ground",0.276949959011502,278,46,232,42.8016372660109,235.198362733989
"2010","now dont",0.276089963803108,172,29,143,26.4815885242945,145.518411475706
"1980","affection",0.275229501360638,40,8,32,6.72942910574312,33.2705708942569
"1980","dive",0.275229501360638,40,8,32,6.72942910574312,33.2705708942569
"1980","love long",0.275229501360638,40,8,32,6.72942910574312,33.2705708942569
"1980","never end",0.275229501360638,40,8,32,6.72942910574312,33.2705708942569
"1980","using",0.275229501360638,40,8,32,6.72942910574312,33.2705708942569
"1980","wanna fun",0.275229501360638,40,8,32,6.72942910574312,33.2705708942569
"1970","gods",0.275225460099214,49,8,41,6.7055467003118,42.2944532996882
"1970","naturally",0.275225460099214,49,8,41,6.7055467003118,42.2944532996882
"1970","shared",0.275225460099214,49,8,41,6.7055467003118,42.2944532996882
"1960","said",0.274891884582125,2163,135,2028,129.181440348786,2033.81855965121
"2000","la la la la",0.274514490353752,1002,277,725,269.623858586887,732.376141413113
"1980","cause can",0.273356287959356,62,12,50,10.4306151139018,51.5693848860982
"2000","look back",0.27328571412068,92,27,65,24.7558832235465,67.2441167764535
"2000","lying",0.27328571412068,92,27,65,24.7558832235465,67.2441167764535
"1980","thoughts",0.271862919639023,118,22,96,19.8518158619422,98.1481841380578
"1990","arent",0.271271655356011,45,11,34,9.54651131682892,35.4534886831711
"1990","people dont",0.271271655356011,45,11,34,9.54651131682892,35.4534886831711
"1980","bodies",0.2710884318728,51,10,41,8.58002210982247,42.4199778901775
"1980","hes got",0.2710884318728,51,10,41,8.58002210982247,42.4199778901775
"1980","like want",0.2710884318728,51,10,41,8.58002210982247,42.4199778901775
"1990","mine",0.270091638287692,1033,226,807,219.145470895206,813.854529104794
"1990","class",0.269962624085899,76,18,58,16.1229968906444,59.8770031093556
"1990","think",0.269863795634016,2640,571,2069,560.061997253964,2079.93800274604
"1980","asking",0.265928186013507,90,17,73,15.141215487922,74.858784512078
"1980","wont stop",0.265928186013507,90,17,73,15.141215487922,74.858784512078
"1960","girl like",0.265826184206385,127,9,118,7.58485572089499,119.415144279105
"2000","lately",0.265781053346018,85,25,60,22.8722834130593,62.1277165869407
"1970","fall",0.265284719133691,925,132,793,126.584299954866,798.415700045134
"1980","made",0.265165934776483,1068,186,882,179.675757123341,888.324242876659
"1990","can always",0.263497943450103,32,8,24,6.78863026974501,25.211369730255
"1990","dream come true",0.263497943450103,32,8,24,6.78863026974501,25.211369730255
"1990","give anything",0.263497943450103,32,8,24,6.78863026974501,25.211369730255
"1990","giving love",0.263497943450103,32,8,24,6.78863026974501,25.211369730255
"1990","heart youre",0.263497943450103,32,8,24,6.78863026974501,25.211369730255
"1990","help im",0.263497943450103,32,8,24,6.78863026974501,25.211369730255
"1990","something baby",0.263497943450103,32,8,24,6.78863026974501,25.211369730255
"1990","tracks",0.263497943450103,32,8,24,6.78863026974501,25.211369730255
"1990","youre thinkin",0.263497943450103,32,8,24,6.78863026974501,25.211369730255
"1960","one day",0.262413746643806,158,11,147,9.43627719607408,148.563722803926
"2010","homie",0.262348220570088,80,14,66,12.3170179182765,67.6829820817235
"2010","movie",0.262348220570088,80,14,66,12.3170179182765,67.6829820817235
"2010","shining",0.261889381546336,160,27,133,24.634035836553,135.365964163447
"2010","burning",0.261849530519451,216,36,180,33.2559483793466,182.744051620653
"1970","breaking",0.261779218619482,152,23,129,20.8008795601509,131.199120439849
"2010","back cause",0.261549584621826,32,6,26,4.9268071673106,27.0731928326894
"2010","cant resist",0.261549584621826,32,6,26,4.9268071673106,27.0731928326894
"2010","cause like",0.261549584621826,32,6,26,4.9268071673106,27.0731928326894
"2010","last one",0.261549584621826,32,6,26,4.9268071673106,27.0731928326894
"2010","life ill",0.261549584621826,32,6,26,4.9268071673106,27.0731928326894
"2010","need want",0.261549584621826,32,6,26,4.9268071673106,27.0731928326894
"2010","nigga dont",0.261549584621826,32,6,26,4.9268071673106,27.0731928326894
"1980","moving",0.260759747679146,215,39,176,36.1706814433693,178.829318556631
"2000","back youre",0.260307274154298,22,7,15,5.91988511867417,16.0801148813258
"2000","bad bitch",0.260307274154298,22,7,15,5.91988511867417,16.0801148813258
"2000","better now",0.260307274154298,22,7,15,5.91988511867417,16.0801148813258
"2000","bit little",0.260307274154298,22,7,15,5.91988511867417,16.0801148813258
"2000","cant seem",0.260307274154298,22,7,15,5.91988511867417,16.0801148813258
"2000","day baby",0.260307274154298,22,7,15,5.91988511867417,16.0801148813258
"2000","end night",0.260307274154298,22,7,15,5.91988511867417,16.0801148813258
"2000","every time touch",0.260307274154298,22,7,15,5.91988511867417,16.0801148813258
"2000","go keep",0.260307274154298,22,7,15,5.91988511867417,16.0801148813258
"2000","go lets go",0.260307274154298,22,7,15,5.91988511867417,16.0801148813258
"2000","like fuck",0.260307274154298,22,7,15,5.91988511867417,16.0801148813258
"2000","little bit little",0.260307274154298,22,7,15,5.91988511867417,16.0801148813258
"2000","longest",0.260307274154298,22,7,15,5.91988511867417,16.0801148813258
"2000","nothing dont",0.260307274154298,22,7,15,5.91988511867417,16.0801148813258
"2000","oh hey",0.260307274154298,22,7,15,5.91988511867417,16.0801148813258
"2000","one got",0.260307274154298,22,7,15,5.91988511867417,16.0801148813258
"2000","one step",0.260307274154298,22,7,15,5.91988511867417,16.0801148813258
"2000","real feel",0.260307274154298,22,7,15,5.91988511867417,16.0801148813258
"2000","time touch",0.260307274154298,22,7,15,5.91988511867417,16.0801148813258
"2000","touch feel",0.260307274154298,22,7,15,5.91988511867417,16.0801148813258
"2000","try keep",0.260307274154298,22,7,15,5.91988511867417,16.0801148813258
"2000","way keep",0.260307274154298,22,7,15,5.91988511867417,16.0801148813258
"2000","yeah right",0.260307274154298,22,7,15,5.91988511867417,16.0801148813258
"1980","sitting",0.259378341450531,107,20,87,18.0012228578628,88.9987771421372
"1990","wont let",0.258757660939234,221,50,171,46.8839778004265,174.116022199574
"2000","know never",0.258671197534278,78,23,55,20.9886836025721,57.0113163974279
"1970","door",0.258649479281759,597,86,511,81.6981914303295,515.301808569671
"2010","can keep",0.258231416136894,74,13,61,11.3932415744058,62.6067584255942
"2010","church",0.258231416136894,74,13,61,11.3932415744058,62.6067584255942
"2010","doors",0.258231416136894,74,13,61,11.3932415744058,62.6067584255942
"2010","never see",0.258231416136894,74,13,61,11.3932415744058,62.6067584255942
"2000","makes",0.258198860066926,739,205,534,198.85432285001,540.14567714999
"1960","love cant",0.258020308999688,112,8,104,6.68900662000188,105.310993379998
"1970","heart can",0.257910805625311,56,9,47,7.66348194321348,48.3365180567865
"1970","jimmy",0.257910805625311,56,9,47,7.66348194321348,48.3365180567865
"1970","know gonna",0.257910805625311,56,9,47,7.66348194321348,48.3365180567865
"1970","rocks",0.257910805625311,56,9,47,7.66348194321348,48.3365180567865
"1970","roll",0.257315282219734,804,115,689,110.025705041851,693.974294958149
"1980","can take",0.256791400701665,261,47,214,43.9095249149738,217.090475085026
"1990","can come",0.256118254319304,54,13,41,11.4558135801947,42.5441864198053
"1990","now wanna",0.256118254319304,54,13,41,11.4558135801947,42.5441864198053
"1990","say youll",0.256118254319304,54,13,41,11.4558135801947,42.5441864198053
"1970","able",0.256076842873571,36,6,30,4.92652410635153,31.0734758936485
"1970","baby cant see",0.256076842873571,36,6,30,4.92652410635153,31.0734758936485
"1970","back door",0.256076842873571,36,6,30,4.92652410635153,31.0734758936485
"1970","closing",0.256076842873571,36,6,30,4.92652410635153,31.0734758936485
"1970","james",0.256076842873571,36,6,30,4.92652410635153,31.0734758936485
"1970","know wrong",0.256076842873571,36,6,30,4.92652410635153,31.0734758936485
"1970","little things",0.256076842873571,36,6,30,4.92652410635153,31.0734758936485
"1970","neither",0.256076842873571,36,6,30,4.92652410635153,31.0734758936485
"1970","records",0.256076842873571,36,6,30,4.92652410635153,31.0734758936485
"1970","things said",0.256076842873571,36,6,30,4.92652410635153,31.0734758936485
"1970","cause youre",0.255778168798372,194,29,165,26.548491017561,167.451508982439
"1960","ready",0.255251696213049,571,37,534,34.101989107331,536.898010892669
"2010","anything want",0.254663436042633,68,12,56,10.469465230535,57.530534769465
"2010","can hold",0.253922486064374,38,7,31,5.85058351118134,32.1494164888187
"2010","every single day",0.253922486064374,38,7,31,5.85058351118134,32.1494164888187
"2010","lets ride",0.253922486064374,38,7,31,5.85058351118134,32.1494164888187
"2010","need love need",0.253922486064374,38,7,31,5.85058351118134,32.1494164888187
"2010","nothings gonna",0.253922486064374,38,7,31,5.85058351118134,32.1494164888187
"2010","twisted",0.253922486064374,38,7,31,5.85058351118134,32.1494164888187
"1960","music",0.253513008957267,700,45,655,41.8062913750118,658.193708624988
"1960","hope",0.253370440656686,523,34,489,31.2352719844731,491.764728015527
"2000","skin",0.252837298466083,146,42,104,39.2865103330195,106.71348966698
"2010","busy",0.251801072132814,62,11,51,9.54568888666429,52.4543111133357
"2010","girl cant",0.251801072132814,62,11,51,9.54568888666429,52.4543111133357
"2010","judge",0.251801072132814,62,11,51,9.54568888666429,52.4543111133357
"2010","just aint",0.251801072132814,62,11,51,9.54568888666429,52.4543111133357
"2010","one two three",0.251801072132814,62,11,51,9.54568888666429,52.4543111133357
"1960","see face",0.251612119462092,97,7,90,5.79315751910877,91.2068424808912
"2010","act like",0.251530965321364,117,20,97,18.0136387054794,98.9863612945206
"2010","girl ill",0.250270415792183,44,8,36,6.77435985505208,37.2256401449479
"2010","groovy",0.250270415792183,44,8,36,6.77435985505208,37.2256401449479
"2010","winner",0.250270415792183,44,8,36,6.77435985505208,37.2256401449479
"2010","can still",0.249867148354095,56,10,46,8.62191254279355,47.3780874572064
"2010","get like",0.249867148354095,56,10,46,8.62191254279355,47.3780874572064
"2010","time got",0.249867148354095,56,10,46,8.62191254279355,47.3780874572064
"2010","wearing",0.249867148354095,56,10,46,8.62191254279355,47.3780874572064
"2010","finding",0.249189388338104,50,9,41,7.69813619892281,42.3018638010772
"2010","grew",0.249189388338104,50,9,41,7.69813619892281,42.3018638010772
"2010","heart im",0.249189388338104,50,9,41,7.69813619892281,42.3018638010772
"2010","tide",0.249189388338104,50,9,41,7.69813619892281,42.3018638010772
"2010","whoa whoa whoa whoa",0.249189388338104,50,9,41,7.69813619892281,42.3018638010772
"2010","block",0.247744807066107,148,25,123,22.7864831488115,125.213516851188
"1990","youre",0.247653127458364,6592,1415,5177,1398.45783556747,5193.54216443253
"1960","jungle",0.247347417895986,82,6,76,4.89730841821566,77.1026915817843
"1980","grass",0.247284558550714,96,18,78,16.1506298537835,79.8493701462165
"1980","anything want",0.247085994097585,68,13,55,11.4400294797633,56.5599705202367
"1980","go wrong",0.247085994097585,68,13,55,11.4400294797633,56.5599705202367
"1990","cant say",0.24674853468456,63,15,48,13.3651158435605,49.6348841564395
"1990","resist",0.24674853468456,63,15,48,13.3651158435605,49.6348841564395
"2000","leave alone",0.246521731831553,121,35,86,32.5593681527079,88.4406318472921
"2010","coming",0.246342941920814,614,99,515,94.5331125227722,519.466887477228
"2000","feelin like",0.246150282733816,64,19,45,17.2214839815976,46.7785160184024
"2000","like last",0.246150282733816,64,19,45,17.2214839815976,46.7785160184024
"2000","paid",0.244700844606702,96,28,68,25.8322259723964,70.1677740276036
"2000","around way",0.243594390915403,29,9,20,7.80348492916141,21.1965150708386
"2000","dont wanna lose",0.243594390915403,29,9,20,7.80348492916141,21.1965150708386
"2000","fashion",0.243594390915403,29,9,20,7.80348492916141,21.1965150708386
"2000","hand ill",0.243594390915403,29,9,20,7.80348492916141,21.1965150708386
"2000","hard see",0.243594390915403,29,9,20,7.80348492916141,21.1965150708386
"2000","im fine",0.243594390915403,29,9,20,7.80348492916141,21.1965150708386
"2000","one thats",0.243594390915403,29,9,20,7.80348492916141,21.1965150708386
"2000","place id rather",0.243594390915403,29,9,20,7.80348492916141,21.1965150708386
"2000","sit back",0.243594390915403,29,9,20,7.80348492916141,21.1965150708386
"2000","till day",0.243594390915403,29,9,20,7.80348492916141,21.1965150708386
"2000","traffic",0.243594390915403,29,9,20,7.80348492916141,21.1965150708386
"2000","wanna lose",0.243594390915403,29,9,20,7.80348492916141,21.1965150708386
"2000","want love want",0.243594390915403,29,9,20,7.80348492916141,21.1965150708386
"2000","heard",0.243471603271303,586,163,423,157.684212706503,428.315787293497
"1970","broken heart",0.241964006688379,111,17,94,15.1901159945839,95.8098840054161
"2000","away im",0.241153065166023,57,17,40,15.3378841711103,41.6621158288897
"2000","blowin",0.241153065166023,57,17,40,15.3378841711103,41.6621158288897
"2000","plain",0.241153065166023,57,17,40,15.3378841711103,41.6621158288897
"1990","complete",0.241022375251084,72,17,55,15.2744181069263,56.7255818930737
"1980","babyyou",0.240825813690551,35,7,28,5.88825046752523,29.1117495324748
"1980","eyes know",0.240825813690551,35,7,28,5.88825046752523,29.1117495324748
"1980","heart will",0.240825813690551,35,7,28,5.88825046752523,29.1117495324748
"1980","im running",0.240825813690551,35,7,28,5.88825046752523,29.1117495324748
"1980","just dream",0.240825813690551,35,7,28,5.88825046752523,29.1117495324748
"1980","now hes",0.240825813690551,35,7,28,5.88825046752523,29.1117495324748
"1980","perfume",0.240825813690551,35,7,28,5.88825046752523,29.1117495324748
"1980","right side",0.240825813690551,35,7,28,5.88825046752523,29.1117495324748
"1980","shade",0.240825813690551,35,7,28,5.88825046752523,29.1117495324748
"1980","show show",0.240825813690551,35,7,28,5.88825046752523,29.1117495324748
"1980","time make",0.240825813690551,35,7,28,5.88825046752523,29.1117495324748
"1980","us now",0.240825813690551,35,7,28,5.88825046752523,29.1117495324748
"1980","without dont",0.240825813690551,35,7,28,5.88825046752523,29.1117495324748
"1980","word say",0.240825813690551,35,7,28,5.88825046752523,29.1117495324748
"1990","aside",0.23906472754666,41,10,31,8.6979325331108,32.3020674668892
"1990","baby go",0.23906472754666,41,10,31,8.6979325331108,32.3020674668892
"1990","back time",0.23906472754666,41,10,31,8.6979325331108,32.3020674668892
"1990","know think",0.23906472754666,41,10,31,8.6979325331108,32.3020674668892
"1990","players",0.23906472754666,41,10,31,8.6979325331108,32.3020674668892
"1990","slip away",0.23906472754666,41,10,31,8.6979325331108,32.3020674668892
"1990","point",0.237862422516939,117,27,90,24.8209294237552,92.1790705762448
"2000","man can",0.237465271949356,50,15,35,13.4542843606231,36.5457156393769
"2000","mine baby",0.237465271949356,50,15,35,13.4542843606231,36.5457156393769
"1980","sail away",0.237223167795733,46,9,37,7.73884347160458,38.2611565283954
"2000","free mind",0.237034965893366,36,11,25,9.68708473964864,26.3129152603514
"2000","let make",0.237034965893366,36,11,25,9.68708473964864,26.3129152603514
"2000","love go",0.237034965893366,36,11,25,9.68708473964864,26.3129152603514
"1970","baby come",0.235816121571269,125,19,106,17.1059864803872,107.894013519613
"2000","hesitate",0.23571962768181,43,13,30,11.5706845501359,31.4293154498641
"2000","thinking bout",0.23571962768181,43,13,30,11.5706845501359,31.4293154498641
"2000","way want",0.23571962768181,43,13,30,11.5706845501359,31.4293154498641
"2000","wanna see",0.235253591167581,262,74,188,70.5004500496651,191.499549950335
"1970","blowing",0.234649064402479,70,11,59,9.57935242901686,60.4206475709831
"1970","good thing",0.233122264070024,43,7,36,5.88445934925321,37.1155406507468
"1970","got got got got",0.233122264070024,43,7,36,5.88445934925321,37.1155406507468
"1970","got lot",0.233122264070024,43,7,36,5.88445934925321,37.1155406507468
"1970","im way",0.233122264070024,43,7,36,5.88445934925321,37.1155406507468
"1970","ive found",0.233122264070024,43,7,36,5.88445934925321,37.1155406507468
"1970","since youve",0.233122264070024,43,7,36,5.88445934925321,37.1155406507468
"1970","wanna stay",0.233122264070024,43,7,36,5.88445934925321,37.1155406507468
"2010","somebody",0.232415592877624,672,108,564,103.462950513523,568.537049486477
"1980","workin",0.23078559775797,102,19,83,17.1600442196449,84.8399557803551
"1990","betta",0.230560700518839,28,7,21,5.94005148602689,22.0599485139731
"1990","dance wanna",0.230560700518839,28,7,21,5.94005148602689,22.0599485139731
"1990","give just one",0.230560700518839,28,7,21,5.94005148602689,22.0599485139731
"1990","ill one",0.230560700518839,28,7,21,5.94005148602689,22.0599485139731
"1990","ill wait",0.230560700518839,28,7,21,5.94005148602689,22.0599485139731
"1990","night time",0.230560700518839,28,7,21,5.94005148602689,22.0599485139731
"1990","rolls",0.230560700518839,28,7,21,5.94005148602689,22.0599485139731
"1990","throat",0.230560700518839,28,7,21,5.94005148602689,22.0599485139731
"1990","tour",0.230560700518839,28,7,21,5.94005148602689,22.0599485139731
"1990","ya see",0.230560700518839,28,7,21,5.94005148602689,22.0599485139731
"1990","youre lookin",0.230560700518839,28,7,21,5.94005148602689,22.0599485139731
"1970","everywhere",0.230371273030127,237,35,202,32.4329503668142,204.567049633186
"2010","want know",0.228848654926964,305,50,255,46.9586308134292,258.041369186571
"1960","fool",0.228735145969847,381,25,356,22.754567162685,358.245432837315
"2000","touch",0.228315221267788,942,260,682,253.478717354139,688.521282645861
"2000","sitting",0.228054145454474,107,31,76,28.7921685317335,78.2078314682665
"1970","baby please",0.226680961605776,77,12,65,10.5372876719185,66.4627123280815
"1970","now love",0.226680961605776,77,12,65,10.5372876719185,66.4627123280815
"1970","weather",0.226680961605776,77,12,65,10.5372876719185,66.4627123280815
"1990","attack",0.22519131092874,50,12,38,10.6072347964766,39.3927652035234
"1990","come lets",0.22519131092874,50,12,38,10.6072347964766,39.3927652035234
"1990","dont give damn",0.22519131092874,50,12,38,10.6072347964766,39.3927652035234
"1980","byamandah",0.224959462790808,74,14,60,12.4494438456248,61.5505561543752
"1980","byamandah editor",0.224959462790808,74,14,60,12.4494438456248,61.5505561543752
"2010","meet",0.221419412043089,381,62,319,58.6597978357918,322.340202164208
"2000","adore",0.22017060499421,75,22,53,20.1814265409347,54.8185734590653
"2000","youand",0.22017060499421,75,22,53,20.1814265409347,54.8185734590653
"1960","older",0.219492431012754,83,6,77,4.95703169160854,78.0429683083915
"1960","touched",0.219492431012754,83,6,77,4.95703169160854,78.0429683083915
"2000","dont let go",0.21892170632522,100,29,71,26.9085687212462,73.0914312787538
"1980","love ill",0.218206455546818,91,17,74,15.3094512155656,75.6905487844344
"1990","comes",0.217673172916392,702,154,548,148.925576542531,553.074423457469
"1990","tease",0.21711350759322,59,14,45,12.5165370598424,46.4834629401576
"1970","flight",0.216981294822361,50,8,42,6.8423945921549,43.1576054078451
"1970","go take",0.216981294822361,50,8,42,6.8423945921549,43.1576054078451
"1970","mine mine",0.216981294822361,50,8,42,6.8423945921549,43.1576054078451
"1980","turnin",0.216082969334054,108,20,88,18.1694585855064,89.8305414144936
"2000","shoes",0.21565595697529,172,49,123,46.2827382005435,125.717261799456
"1970","love ill",0.215306608065261,91,14,77,12.4531581577219,78.5468418422781
"1990","stay",0.213677991236734,1204,262,942,255.422213899156,948.577786100844
"1980","ahead",0.213050526476811,165,30,135,27.7588950611904,137.24110493881
"2010","thoughts",0.212740041586059,118,20,98,18.1676014294578,99.8323985705422
"1990","id never",0.21255898038912,68,16,52,14.4258393232082,53.5741606767919
"2010","feeling",0.21002383715901,922,147,775,141.953631508137,780.046368491863
"2000","everythings",0.209877116237735,93,27,66,25.024968910759,67.975031089241
"1980","lead",0.209711949807788,188,34,154,31.6283167969926,156.371683203007
"1990","drinks",0.209639894814844,86,20,66,18.2444438499397,67.7555561500603
"2000","lost",0.209458473527958,635,176,459,170.869411379914,464.130588620086
"1990","four",0.209331807778968,195,44,151,41.3682157062587,153.631784293741
"2010","business",0.209084214065637,75,13,62,11.5472042983842,63.4527957016158
"1980","dont mess",0.207707112935579,52,10,42,8.74825783746605,43.251742162534
"1980","life just",0.207707112935579,52,10,42,8.74825783746605,43.251742162534
"1980","now time",0.207707112935579,52,10,42,8.74825783746605,43.251742162534
"1980","many",0.207326617662342,541,95,446,91.0155286551757,449.984471344824
"2000","runnin",0.207303119871225,241,68,173,64.8496506182034,176.150349381797
"1990","finish",0.207016685648956,37,9,28,7.84935374939267,29.1506462506073
"1990","itd",0.207016685648956,37,9,28,7.84935374939267,29.1506462506073
"1990","meif",0.207016685648956,37,9,28,7.84935374939267,29.1506462506073
"1990","planet",0.207016685648956,37,9,28,7.84935374939267,29.1506462506073
"1990","theres nothin",0.207016685648956,37,9,28,7.84935374939267,29.1506462506073
"1980","girl baby",0.20642212602047,30,6,24,5.04707182930734,24.9529281706927
"1980","just much",0.20642212602047,30,6,24,5.04707182930734,24.9529281706927
"1980","let love let love",0.20642212602047,30,6,24,5.04707182930734,24.9529281706927
"1980","made cry",0.20642212602047,30,6,24,5.04707182930734,24.9529281706927
"1980","one know",0.20642212602047,30,6,24,5.04707182930734,24.9529281706927
"1980","staying",0.20642212602047,30,6,24,5.04707182930734,24.9529281706927
"1980","take little",0.20642212602047,30,6,24,5.04707182930734,24.9529281706927
"1980","find love",0.206070465458913,80,15,65,13.4588582114862,66.5411417885138
"1980","makin love",0.206070465458913,80,15,65,13.4588582114862,66.5411417885138
"2000","oclock",0.205574468234685,61,18,43,16.4142269199602,44.5857730800398
"1970","hardly",0.20520681788197,57,9,48,7.80032983505658,49.1996701649434
"1970","like see",0.20520681788197,57,9,48,7.80032983505658,49.1996701649434
"2010","riding",0.203852594084192,69,12,57,10.6234279545135,58.3765720454865
"2010","tonight tonight",0.203852594084192,69,12,57,10.6234279545135,58.3765720454865
"2000","baby work",0.203755816843445,19,6,13,5.11262805703678,13.8873719429632
"2000","bad oh",0.203755816843445,19,6,13,5.11262805703678,13.8873719429632
"2000","boy like",0.203755816843445,19,6,13,5.11262805703678,13.8873719429632
"2000","cant get mind",0.203755816843445,19,6,13,5.11262805703678,13.8873719429632
"2000","cooler",0.203755816843445,19,6,13,5.11262805703678,13.8873719429632
"2000","davis",0.203755816843445,19,6,13,5.11262805703678,13.8873719429632
"2000","easy love",0.203755816843445,19,6,13,5.11262805703678,13.8873719429632
"2000","em im",0.203755816843445,19,6,13,5.11262805703678,13.8873719429632
"2000","everything dont",0.203755816843445,19,6,13,5.11262805703678,13.8873719429632
"2000","followed",0.203755816843445,19,6,13,5.11262805703678,13.8873719429632
"2000","fruit",0.203755816843445,19,6,13,5.11262805703678,13.8873719429632
"2000","going dont",0.203755816843445,19,6,13,5.11262805703678,13.8873719429632
"2000","home yeah",0.203755816843445,19,6,13,5.11262805703678,13.8873719429632
"2000","ill leave",0.203755816843445,19,6,13,5.11262805703678,13.8873719429632
"2000","just believe",0.203755816843445,19,6,13,5.11262805703678,13.8873719429632
"2000","just tryin",0.203755816843445,19,6,13,5.11262805703678,13.8873719429632
"2000","kinda girl",0.203755816843445,19,6,13,5.11262805703678,13.8873719429632
"2000","know keep",0.203755816843445,19,6,13,5.11262805703678,13.8873719429632
"2000","love day",0.203755816843445,19,6,13,5.11262805703678,13.8873719429632
"2000","meeting",0.203755816843445,19,6,13,5.11262805703678,13.8873719429632
"2000","mend broken",0.203755816843445,19,6,13,5.11262805703678,13.8873719429632
"2000","mind ive",0.203755816843445,19,6,13,5.11262805703678,13.8873719429632
"2000","neighborhood",0.203755816843445,19,6,13,5.11262805703678,13.8873719429632
"2000","night aint",0.203755816843445,19,6,13,5.11262805703678,13.8873719429632
"2000","night need",0.203755816843445,19,6,13,5.11262805703678,13.8873719429632
"2000","one left",0.203755816843445,19,6,13,5.11262805703678,13.8873719429632
"2000","play just",0.203755816843445,19,6,13,5.11262805703678,13.8873719429632
"2000","shit like",0.203755816843445,19,6,13,5.11262805703678,13.8873719429632
"2000","things know",0.203755816843445,19,6,13,5.11262805703678,13.8873719429632
"2000","think baby",0.203755816843445,19,6,13,5.11262805703678,13.8873719429632
"2000","tonight youre",0.203755816843445,19,6,13,5.11262805703678,13.8873719429632
"2000","touch now",0.203755816843445,19,6,13,5.11262805703678,13.8873719429632
"2000","want cry",0.203755816843445,19,6,13,5.11262805703678,13.8873719429632
"2000","youre baby",0.203755816843445,19,6,13,5.11262805703678,13.8873719429632
"1970","fell",0.203724799216604,224,33,191,30.6539277728539,193.346072227146
"1980","single day",0.203490047927786,41,8,33,6.8976648333867,34.1023351666133
"1980","tied",0.203490047927786,41,8,33,6.8976648333867,34.1023351666133
"1980","time just",0.203490047927786,41,8,33,6.8976648333867,34.1023351666133
"1980","try make",0.203490047927786,41,8,33,6.8976648333867,34.1023351666133
"1970","remember",0.203310691373197,894,127,767,122.34201530773,771.65798469227
"1980","price",0.202899947438181,114,21,93,19.1788729513679,94.8211270486321
"1980","leaves",0.202803626532384,97,18,79,16.3188655814271,80.6811344185729
"1980","see face",0.202803626532384,97,18,79,16.3188655814271,80.6811344185729
"1980","everyone",0.201062875768168,217,39,178,36.5071528986564,180.492847101344
"2000","thinkin bout",0.200941754132276,86,25,61,23.1413691002718,62.8586308997282
"2000","bunch",0.199210791567237,54,16,38,14.530627109473,39.469372890527
"2000","swallow",0.199210791567237,54,16,38,14.530627109473,39.469372890527
"1970","im ready",0.199159774666654,147,22,125,20.1166401009354,126.883359899065
"2010","know baby",0.199005204689095,63,11,52,9.69965161064275,53.3003483893573
"1990","alright cause",0.19762345758758,24,6,18,5.09147270230876,18.9085272976912
"1990","bad yeah",0.19762345758758,24,6,18,5.09147270230876,18.9085272976912
"1990","can look",0.19762345758758,24,6,18,5.09147270230876,18.9085272976912
"1990","can run can",0.19762345758758,24,6,18,5.09147270230876,18.9085272976912
"1990","emotional",0.19762345758758,24,6,18,5.09147270230876,18.9085272976912
"1990","eyes just",0.19762345758758,24,6,18,5.09147270230876,18.9085272976912
"1990","flowing",0.19762345758758,24,6,18,5.09147270230876,18.9085272976912
"1990","forever oh",0.19762345758758,24,6,18,5.09147270230876,18.9085272976912
"1990","hope know",0.19762345758758,24,6,18,5.09147270230876,18.9085272976912
"1990","huggin",0.19762345758758,24,6,18,5.09147270230876,18.9085272976912
"1990","im little",0.19762345758758,24,6,18,5.09147270230876,18.9085272976912
"1990","little boy",0.19762345758758,24,6,18,5.09147270230876,18.9085272976912
"1990","murder",0.19762345758758,24,6,18,5.09147270230876,18.9085272976912
"1990","noi",0.19762345758758,24,6,18,5.09147270230876,18.9085272976912
"1990","plate",0.19762345758758,24,6,18,5.09147270230876,18.9085272976912
"1990","pourin",0.19762345758758,24,6,18,5.09147270230876,18.9085272976912
"1990","rely",0.19762345758758,24,6,18,5.09147270230876,18.9085272976912
"1990","sayi",0.19762345758758,24,6,18,5.09147270230876,18.9085272976912
"1990","temptation",0.19762345758758,24,6,18,5.09147270230876,18.9085272976912
"1990","wop",0.19762345758758,24,6,18,5.09147270230876,18.9085272976912
"1960","now know",0.197313363820478,177,12,165,10.5710193905387,166.428980609461
"1970","love tonight",0.196398807450339,64,10,54,8.75826507795827,55.2417349220417
"1970","never seen",0.196398807450339,64,10,54,8.75826507795827,55.2417349220417
"2000","one day",0.196271828463664,158,45,113,42.515538579569,115.484461420431
"2010","baby give",0.194661779011667,57,10,47,8.77587526677201,48.224124733228
"2010","hollywood",0.194661779011667,57,10,47,8.77587526677201,48.224124733228
"2010","just tell",0.194661779011667,57,10,47,8.77587526677201,48.224124733228
"1990","im thinkin",0.194617548570652,46,11,35,9.75865601275846,36.2413439872415
"1990","lonely nights",0.194617548570652,46,11,35,9.75865601275846,36.2413439872415
"1990","wont let go",0.194617548570652,46,11,35,9.75865601275846,36.2413439872415
"1980","age",0.194587659991519,69,13,56,11.6082652074069,57.3917347925931
"1980","im goin",0.194587659991519,69,13,56,11.6082652074069,57.3917347925931
"1980","therell",0.194587659991519,69,13,56,11.6082652074069,57.3917347925931
"1980","rush",0.194411728107516,137,25,112,23.0482946871702,113.95170531283
"2000","day im",0.193838201060188,47,14,33,12.6470272989857,34.3529727010143
"2000","oh yeah oh yeah",0.193838201060188,47,14,33,12.6470272989857,34.3529727010143
"2000","still got",0.193838201060188,47,14,33,12.6470272989857,34.3529727010143
"1960","really dont",0.193515231749783,84,6,78,5.01675496500141,78.9832450349986
"1960","watchin",0.193515231749783,84,6,78,5.01675496500141,78.9832450349986
"2000","love always",0.192144548630016,79,23,56,21.2577692897845,57.7422307102155
"2010","love never",0.1921277350226,100,17,83,15.3962723978456,84.6037276021544
"2010","youre never",0.1921277350226,100,17,83,15.3962723978456,84.6037276021544
"1960","city",0.191811212712163,545,35,510,32.5491839991163,512.450816000884
"2000","boy ill",0.191560168293595,26,8,18,6.99622786752402,19.003772132476
"2000","can buy",0.191560168293595,26,8,18,6.99622786752402,19.003772132476
"2000","contigo",0.191560168293595,26,8,18,6.99622786752402,19.003772132476
"2000","crazy baby",0.191560168293595,26,8,18,6.99622786752402,19.003772132476
"2000","gate",0.191560168293595,26,8,18,6.99622786752402,19.003772132476
"2000","got head",0.191560168293595,26,8,18,6.99622786752402,19.003772132476
"2000","got takes",0.191560168293595,26,8,18,6.99622786752402,19.003772132476
"2000","love im gonna",0.191560168293595,26,8,18,6.99622786752402,19.003772132476
"2000","mind just",0.191560168293595,26,8,18,6.99622786752402,19.003772132476
"2000","never say",0.191560168293595,26,8,18,6.99622786752402,19.003772132476
"2000","will lead",0.191560168293595,26,8,18,6.99622786752402,19.003772132476
"2000","wow wow",0.191560168293595,26,8,18,6.99622786752402,19.003772132476
"2000","youre ever",0.191560168293595,26,8,18,6.99622786752402,19.003772132476
"1970","china",0.191207351037288,37,6,31,5.06337199819462,31.9366280018054
"1970","feel inside",0.191207351037288,37,6,31,5.06337199819462,31.9366280018054
"1970","lets just",0.191207351037288,37,6,31,5.06337199819462,31.9366280018054
"1970","make way",0.191207351037288,37,6,31,5.06337199819462,31.9366280018054
"1970","michael",0.191207351037288,37,6,31,5.06337199819462,31.9366280018054
"1970","night know",0.191207351037288,37,6,31,5.06337199819462,31.9366280018054
"1970","way like",0.191207351037288,37,6,31,5.06337199819462,31.9366280018054
"1970","well just",0.191207351037288,37,6,31,5.06337199819462,31.9366280018054
"1980","promise",0.19106234009897,385,68,317,64.7707551427775,320.229244857223
"2010","mom",0.190997577031984,51,9,42,7.85209892290127,43.1479010770987
"2010","say need",0.190997577031984,51,9,42,7.85209892290127,43.1479010770987
"2010","strip",0.190997577031984,51,9,42,7.85209892290127,43.1479010770987
"2000","baby love baby",0.189972217559478,40,12,28,10.7634274884985,29.2365725115015
"2000","get mind",0.189972217559478,40,12,28,10.7634274884985,29.2365725115015
"2000","give im",0.189972217559478,40,12,28,10.7634274884985,29.2365725115015
"2000","ityou",0.189972217559478,40,12,28,10.7634274884985,29.2365725115015
"2000","peter",0.189972217559478,40,12,28,10.7634274884985,29.2365725115015
"2000","seek",0.189972217559478,40,12,28,10.7634274884985,29.2365725115015
"2000","suit",0.189972217559478,40,12,28,10.7634274884985,29.2365725115015
"2000","youif",0.189972217559478,40,12,28,10.7634274884985,29.2365725115015
"1990","breathe",0.18993621485616,191,43,148,40.5196369225405,150.480363077459
"1970","heads",0.189698193869782,71,11,60,9.71620032085995,61.2837996791401
"1970","hungry",0.189698193869782,71,11,60,9.71620032085995,61.2837996791401
"1980","moonlight",0.189161653486015,103,19,84,17.3282799472885,85.6717200527115
"2000","away can",0.188561023945275,33,10,23,8.87982767801125,24.1201723219887
"2000","cause wont",0.188561023945275,33,10,23,8.87982767801125,24.1201723219887
"2000","keep us",0.188561023945275,33,10,23,8.87982767801125,24.1201723219887
"2000","let just",0.188561023945275,33,10,23,8.87982767801125,24.1201723219887
"2000","load",0.188561023945275,33,10,23,8.87982767801125,24.1201723219887
"2000","one makes",0.188561023945275,33,10,23,8.87982767801125,24.1201723219887
"2000","said said",0.188561023945275,33,10,23,8.87982767801125,24.1201723219887
"2000","said youre",0.188561023945275,33,10,23,8.87982767801125,24.1201723219887
"2000","thursday",0.188561023945275,33,10,23,8.87982767801125,24.1201723219887
"2000","said",0.188428265029629,2163,591,1572,582.032341440556,1580.96765855944
"2010","cards",0.1882798058139,45,8,37,6.92832257903053,38.0716774209695
"2010","grand",0.1882798058139,45,8,37,6.92832257903053,38.0716774209695
"2010","hatin",0.1882798058139,45,8,37,6.92832257903053,38.0716774209695
"2010","just remember",0.1882798058139,45,8,37,6.92832257903053,38.0716774209695
"2010","whose",0.1882798058139,45,8,37,6.92832257903053,38.0716774209695
"1990","yeah love",0.187965034261464,55,13,42,11.6679582761242,43.3320417238758
"2010","gift",0.187702811844146,33,6,27,5.08076989128906,27.9192301087109
"2010","hurt bad",0.187702811844146,33,6,27,5.08076989128906,27.9192301087109
"2010","melt",0.187702811844146,33,6,27,5.08076989128906,27.9192301087109
"2010","wanna miss",0.187702811844146,33,6,27,5.08076989128906,27.9192301087109
"2010","wanna run",0.187702811844146,33,6,27,5.08076989128906,27.9192301087109
"2010","completely",0.186937045971519,39,7,32,6.0045462351598,32.9954537648402
"2010","dont worry bout",0.186937045971519,39,7,32,6.0045462351598,32.9954537648402
"2010","heal",0.186937045971519,39,7,32,6.0045462351598,32.9954537648402
"2010","purple",0.186937045971519,39,7,32,6.0045462351598,32.9954537648402
"2010","wanna give",0.186937045971519,39,7,32,6.0045462351598,32.9954537648402
"1990","tough",0.186220624994466,150,34,116,31.8217043894297,118.17829561057
"2000","lift",0.18619159779021,97,28,69,26.1013116596088,70.8986883403912
"1990","around",0.186060325917211,2228,481,1747,472.658382530996,1755.341617469
"2010","havent",0.18460155628163,125,21,104,19.245340497307,105.754659502693
"1980","go im",0.184125721297452,58,11,47,9.75767220332752,48.2423277966725
"1990","know much",0.183739743208976,82,19,63,17.3958650662216,64.6041349337784
"2000","back home",0.183525633455026,72,21,51,19.3741694792973,52.6258305207027
"1990","know time",0.183485753185531,73,17,56,15.4865628028558,57.5134371971442
"2000","lady",0.183254587041633,530,147,383,142.615414222605,387.384585777395
"2000","baby im",0.182872732547959,340,95,245,91.4891336522372,248.510866347763
"1970","least",0.180573448187605,85,13,72,11.6320708066633,73.3679291933367
"1970","like love",0.180573448187605,85,13,72,11.6320708066633,73.3679291933367
"1960","anybody",0.179859463282539,131,9,122,7.82374881446649,123.176251185534
"1960","beauty",0.178756160766449,100,7,93,5.97232733928739,94.0276726607126
"1960","dime",0.178756160766449,100,7,93,5.97232733928739,94.0276726607126
"1960","youre still",0.178756160766449,100,7,93,5.97232733928739,94.0276726607126
"2000","gun",0.17872390679765,191,54,137,51.3953662575803,139.60463374242
"2010","dont know dont",0.178659224130045,88,15,73,13.5487197101042,74.4512802898958
"1970","surprise",0.177509311864178,92,14,78,12.590006049565,79.409993950435
"1980","whisper",0.176996575968992,109,20,89,18.33769431315,90.66230568685
"1960","mmm",0.176856424570612,194,13,181,11.5863150382175,182.413684961782
"1970","get baby",0.176535092388729,44,7,37,6.02130724109631,37.9786927589037
"1970","hypnotized",0.176535092388729,44,7,37,6.02130724109631,37.9786927589037
"1970","made love",0.176535092388729,44,7,37,6.02130724109631,37.9786927589037
"1970","say wanna",0.176535092388729,44,7,37,6.02130724109631,37.9786927589037
"1970","want need",0.176535092388729,44,7,37,6.02130724109631,37.9786927589037
"1990","win",0.176262508960905,196,44,152,41.5803604021882,154.419639597812
"1980","number",0.175955503028501,241,43,198,40.5448103621023,200.455189637898
"1980","yeahi",0.17553411041984,92,17,75,15.4776869432092,76.5223130567908
"1980","know better",0.175392097179986,47,9,38,7.90707919924816,39.0929208007518
"1980","say oh",0.175392097179986,47,9,38,7.90707919924816,39.0929208007518
"1980","youd better",0.175392097179986,47,9,38,7.90707919924816,39.0929208007518
"1990","just let",0.175244533803755,164,37,127,34.7917301324432,129.208269867557
"1990","away can",0.175185713076185,33,8,25,7.00077496567454,25.9992250343255
"1990","deja",0.175185713076185,33,8,25,7.00077496567454,25.9992250343255
"1990","dyin",0.175185713076185,33,8,25,7.00077496567454,25.9992250343255
"1990","life without",0.175185713076185,33,8,25,7.00077496567454,25.9992250343255
"1990","like will",0.175185713076185,33,8,25,7.00077496567454,25.9992250343255
"1990","promise ill",0.175185713076185,33,8,25,7.00077496567454,25.9992250343255
"1990","said ill",0.175185713076185,33,8,25,7.00077496567454,25.9992250343255
"1990","stole",0.175185713076185,33,8,25,7.00077496567454,25.9992250343255
"1990","stop loving",0.175185713076185,33,8,25,7.00077496567454,25.9992250343255
"1990","think dont",0.175185713076185,33,8,25,7.00077496567454,25.9992250343255
"1990","wont forget",0.175185713076185,33,8,25,7.00077496567454,25.9992250343255
"2000","father",0.174921365631578,126,36,90,33.9047965887702,92.0952034112297
"1960","game",0.174590913137584,644,41,603,38.4617880650108,605.538211934989
"1980","now dont",0.173672318710413,172,31,141,28.9365451546954,143.063454845305
"1970","hey",0.172739184773326,2216,310,1906,303.254928324305,1912.7450716757
"2010","nine",0.172042608937572,82,14,68,12.6249433662334,69.3750566337666
"2010","showed",0.172042608937572,82,14,68,12.6249433662334,69.3750566337666
"2010","smiling",0.172042608937572,82,14,68,12.6249433662334,69.3750566337666
"2000","can see",0.171710348761996,450,125,325,121.088559245608,328.911440754392
"1970","losing",0.170764638351537,155,23,132,21.2114232356802,133.78857676432
"1970","think can",0.170644987030906,127,19,108,17.3796822640734,109.620317735927
"1970","dear",0.170295599497353,141,21,120,19.2955527498768,121.704447250123
"2010","break heart",0.170223513232854,113,19,94,17.3977878095656,95.6022121904344
"1980","cant forget",0.169944528113958,36,7,29,6.05648619516881,29.9435138048312
"1980","little baby",0.169944528113958,36,7,29,6.05648619516881,29.9435138048312
"1980","neither",0.169944528113958,36,7,29,6.05648619516881,29.9435138048312
"1980","showing",0.169944528113958,36,7,29,6.05648619516881,29.9435138048312
"1980","tonight ill",0.169944528113958,36,7,29,6.05648619516881,29.9435138048312
"1980","well go",0.169944528113958,36,7,29,6.05648619516881,29.9435138048312
"1960","fit",0.169369674355238,85,6,79,5.07647823839428,79.9235217616057
"1960","killing",0.169369674355238,85,6,79,5.07647823839428,79.9235217616057
"2010","really wanna",0.169230207243416,188,31,157,28.9449921079498,159.05500789205
"1960","lips",0.168623435007703,338,22,316,20.1864664067914,317.813533593209
"1980","reach",0.168298650649177,224,40,184,37.6848029921615,186.315197007839
"2000","direction",0.16707960610236,58,17,41,15.6069698583228,42.3930301416772
"2000","go im",0.16707960610236,58,17,41,15.6069698583228,42.3930301416772
"1970","love cause",0.16635801024581,51,8,43,6.97924248399799,44.020757516002
"1970","north",0.16635801024581,51,8,43,6.97924248399799,44.020757516002
"2010","way can",0.165529018442466,76,13,63,11.7011670223627,64.2988329776373
"1990","nothin",0.165453518113617,487,107,380,103.314466917682,383.685533082318
"2000","talk",0.165224610428663,975,268,707,262.358545032151,712.641454967849
"1980","minds",0.164856372367147,64,12,52,10.767086569189,53.232913430811
"1980","time see",0.164856372367147,64,12,52,10.767086569189,53.232913430811
"1990","answers",0.16449902312304,42,10,32,8.91007722904033,33.0899227709597
"1990","burns",0.16449902312304,42,10,32,8.91007722904033,33.0899227709597
"1990","cruise",0.16449902312304,42,10,32,8.91007722904033,33.0899227709597
"1990","dreams come true",0.16449902312304,42,10,32,8.91007722904033,33.0899227709597
"1990","every word",0.16449902312304,42,10,32,8.91007722904033,33.0899227709597
"1990","go ill",0.16449902312304,42,10,32,8.91007722904033,33.0899227709597
"1960","im feeling",0.161229199951898,132,9,123,7.88347208785936,124.116527912141
"1990","like never",0.160628915944526,87,20,67,18.4565885458693,68.5434114541307
"1990","make right",0.160628915944526,87,20,67,18.4565885458693,68.5434114541307
"2010","shame",0.160130210267559,157,26,131,24.1721476646176,132.827852335382
"2000","voice",0.159953699244092,177,50,127,47.6281666366058,129.371833363394
"1960","nights",0.159848267094288,387,25,362,23.1129068030422,363.887093196958
"1980","get get get get",0.159668499131813,161,29,132,27.085952150616,133.914047849384
"2000","creep",0.159468632007603,51,15,36,13.7233700478356,37.2766299521644
"2000","youim",0.159468632007603,51,15,36,13.7233700478356,37.2766299521644
"2010","love song",0.159144749552455,70,12,58,10.7773906784919,59.2226093215081
"2010","night im",0.159144749552455,70,12,58,10.7773906784919,59.2226093215081
"1970","direction",0.159082991966593,58,9,49,7.93717772689968,50.0628222731003
"1970","go im",0.159082991966593,58,9,49,7.93717772689968,50.0628222731003
"1990","dumb",0.158574948344618,78,18,60,16.5472862825035,61.4527137174965
"1990","fools",0.158574948344618,78,18,60,16.5472862825035,61.4527137174965
"1990","now ive",0.158574948344618,78,18,60,16.5472862825035,61.4527137174965
"1990","yeah got",0.158574948344618,78,18,60,16.5472862825035,61.4527137174965
"1970","saw",0.15847937777223,425,61,364,58.1603540333166,366.839645966683
"2000","like youre",0.158172194879073,76,22,54,20.4505122281471,55.5494877718529
"1960","gotta get",0.158151604407717,227,15,212,13.5571830601824,213.442816939818
"1960","guess",0.157797056902383,484,31,453,28.906064322151,455.093935677849
"2010","goin",0.15762035550335,556,89,467,85.6032745320217,470.396725467978
"1980","goodbye",0.157506471938572,410,72,338,68.9766483338669,341.023351666133
"1990","ahh",0.157450480006621,60,14,46,12.7286817557719,47.2713182442281
"1990","evening",0.157450480006621,60,14,46,12.7286817557719,47.2713182442281
"1990","people say",0.157450480006621,60,14,46,12.7286817557719,47.2713182442281
"1990","sweetest",0.157450480006621,60,14,46,12.7286817557719,47.2713182442281
"1990","youre mine",0.157450480006621,60,14,46,12.7286817557719,47.2713182442281
"1990","get know",0.157387014496946,69,16,53,14.6379840191377,54.3620159808623
"1990","know will",0.157387014496946,69,16,53,14.6379840191377,54.3620159808623
"1990","throw hands",0.157387014496946,69,16,53,14.6379840191377,54.3620159808623
"1990","moving",0.156839685802228,215,48,167,45.6111096248493,169.388890375151
"1980","meet",0.156123988321261,381,67,314,64.0978122322032,316.902187767797
"2010","plays",0.15588555985872,101,17,84,15.5502351218241,85.4497648781759
"1980","get get get",0.155398835541434,265,47,218,44.5824678255482,220.417532174452
"1960","hear",0.154638700630987,1398,87,1311,83.4931362032378,1314.50686379676
"1970","wrap",0.153790434332317,65,10,55,8.89511296980137,56.1048870301986
"1980","baby tonight",0.153485432322849,53,10,43,8.91649356510963,44.0835064348904
"1980","drive crazy",0.153485432322849,53,10,43,8.91649356510963,44.0835064348904
"1980","got know",0.153485432322849,53,10,43,8.91649356510963,44.0835064348904
"1980","make night",0.153485432322849,53,10,43,8.91649356510963,44.0835064348904
"1980","moments",0.153485432322849,53,10,43,8.91649356510963,44.0835064348904
"1990","sunshine",0.152967833632109,183,41,142,38.8224793551043,144.177520644896
"2010","can work",0.152925881751493,64,11,53,9.8536143346212,54.1463856653788
"2010","hold hand",0.152925881751493,64,11,53,9.8536143346212,54.1463856653788
"1980","nights",0.152741094377284,387,68,319,65.1072265980647,321.892773401935
"2000","baddest",0.15252366141485,44,13,31,11.8397702373483,32.1602297626517
"2000","get baby",0.15252366141485,44,13,31,11.8397702373483,32.1602297626517
"2000","got good",0.15252366141485,44,13,31,11.8397702373483,32.1602297626517
"1980","darkness",0.151930014662872,104,19,85,17.4965156749321,86.5034843250679
"2010","wanna get",0.151245898358719,195,32,163,30.022731175799,164.977268824201
"1970","send",0.150719987697978,191,28,163,26.1379473420317,164.862052657968
"1960","god",0.150356503712651,501,32,469,29.9213599698298,471.07864003017
"1970","cos",0.149912254563145,72,11,61,9.85304821270305,62.146951787297
"1980","just might",0.148818987905342,70,13,57,11.7765009350505,58.2234990649496
"2010","wanna dance",0.148736351099071,95,16,79,14.6264587779533,80.3735412220467
"1960","hand",0.148455041056417,859,54,805,51.3022918444787,807.697708155521
"1990","bass",0.147741934627075,174,39,135,36.9131770917385,137.086822908261
"1960","highway",0.147011294206861,86,6,80,5.13620151178716,80.8637984882128
"2010","everything will",0.146923292888584,58,10,48,8.92983799075047,49.0701620092495
"2010","kissing",0.146923292888584,58,10,48,8.92983799075047,49.0701620092495
"2000","aint love",0.14661982331164,37,11,26,9.9561704268611,27.0438295731389
"2000","forever forever",0.14661982331164,37,11,26,9.9561704268611,27.0438295731389
"2000","im still love",0.14661982331164,37,11,26,9.9561704268611,27.0438295731389
"2000","love songs",0.14661982331164,37,11,26,9.9561704268611,27.0438295731389
"2000","make way",0.14661982331164,37,11,26,9.9561704268611,27.0438295731389
"2000","mind got",0.14661982331164,37,11,26,9.9561704268611,27.0438295731389
"2000","need time",0.14661982331164,37,11,26,9.9561704268611,27.0438295731389
"1980","bright",0.14646292703633,277,49,228,46.6012965572711,230.398703442729
"2000","wont let",0.146213251987633,221,62,159,59.4679368739542,161.532063126046
"2000","dust",0.145767804692981,105,30,75,28.2539971573085,76.7460028426915
"1980","dress",0.145694023379071,150,27,123,25.2353591465367,124.764640853463
"2010","choose",0.145471961399672,120,20,100,18.4755268774148,101.524473122585
"1970","hello",0.14496586229364,156,23,133,21.3482711275233,134.651728872477
"1970","im going",0.14496586229364,156,23,133,21.3482711275233,134.651728872477
"2000","like im",0.144679407364649,283,79,204,76.1512494811268,206.848750518873
"1990","making love",0.144124636366229,101,23,78,21.4266142888827,79.5733857111173
"1970","key",0.14408414406853,149,22,127,20.3903358846216,128.609664115378
"1990","away now",0.143662355019536,29,7,22,6.15219618195642,22.8478038180436
"1990","colder",0.143662355019536,29,7,22,6.15219618195642,22.8478038180436
"1990","days gone",0.143662355019536,29,7,22,6.15219618195642,22.8478038180436
"1990","every step",0.143662355019536,29,7,22,6.15219618195642,22.8478038180436
"1990","go never",0.143662355019536,29,7,22,6.15219618195642,22.8478038180436
"1990","id make",0.143662355019536,29,7,22,6.15219618195642,22.8478038180436
"1990","im holding",0.143662355019536,29,7,22,6.15219618195642,22.8478038180436
"1990","mean im",0.143662355019536,29,7,22,6.15219618195642,22.8478038180436
"1990","now dont know",0.143662355019536,29,7,22,6.15219618195642,22.8478038180436
"1990","playin song",0.143662355019536,29,7,22,6.15219618195642,22.8478038180436
"1990","run can",0.143662355019536,29,7,22,6.15219618195642,22.8478038180436
"1990","said want",0.143662355019536,29,7,22,6.15219618195642,22.8478038180436
"1990","senses",0.143662355019536,29,7,22,6.15219618195642,22.8478038180436
"1990","tonight just",0.143662355019536,29,7,22,6.15219618195642,22.8478038180436
"1990","baby im",0.143651240238451,340,75,265,72.1291966160408,267.870803383959
"1980","go ill",0.143580608589673,42,8,34,7.06590056103027,34.9340994389697
"1980","growing",0.143580608589673,42,8,34,7.06590056103027,34.9340994389697
"1980","weekend",0.143580608589673,42,8,34,7.06590056103027,34.9340994389697
"1970","dime",0.1426791083871,100,15,85,13.6847891843098,86.3152108156902
"1970","youre still",0.1426791083871,100,15,85,13.6847891843098,86.3152108156902
"2000","front back",0.142479163169609,30,9,21,8.07257061637387,21.9274293836261
"2000","left right",0.142479163169609,30,9,21,8.07257061637387,21.9274293836261
"2000","now make",0.142479163169609,30,9,21,8.07257061637387,21.9274293836261
"2000","now yeah",0.142479163169609,30,9,21,8.07257061637387,21.9274293836261
"2000","sweet dream",0.142479163169609,30,9,21,8.07257061637387,21.9274293836261
"2000","third",0.142479163169609,30,9,21,8.07257061637387,21.9274293836261
"2000","together now",0.142479163169609,30,9,21,8.07257061637387,21.9274293836261
"2000","wait see",0.142479163169609,30,9,21,8.07257061637387,21.9274293836261
"2000","way thats",0.142479163169609,30,9,21,8.07257061637387,21.9274293836261
"1980","edge",0.142033684317895,110,20,90,18.5059300407936,91.4940699592064
"1980","love let",0.142033684317895,110,20,90,18.5059300407936,91.4940699592064
"1970","hundred",0.141967525304552,121,18,103,16.5585949130148,104.441405086985
"1970","hear say",0.141919316917034,114,17,97,15.6006596701132,98.3993403298868
"2000","can im",0.141692458329923,23,7,16,6.18897080588663,16.8110291941134
"2000","danced night",0.141692458329923,23,7,16,6.18897080588663,16.8110291941134
"2000","ever heard",0.141692458329923,23,7,16,6.18897080588663,16.8110291941134
"2000","finished",0.141692458329923,23,7,16,6.18897080588663,16.8110291941134
"2000","im taking",0.141692458329923,23,7,16,6.18897080588663,16.8110291941134
"2000","image",0.141692458329923,23,7,16,6.18897080588663,16.8110291941134
"2000","ive gone",0.141692458329923,23,7,16,6.18897080588663,16.8110291941134
"2000","ive loved",0.141692458329923,23,7,16,6.18897080588663,16.8110291941134
"2000","know said",0.141692458329923,23,7,16,6.18897080588663,16.8110291941134
"2000","night come",0.141692458329923,23,7,16,6.18897080588663,16.8110291941134
"2000","times im",0.141692458329923,23,7,16,6.18897080588663,16.8110291941134
"2000","tomorrows",0.141692458329923,23,7,16,6.18897080588663,16.8110291941134
"2000","wanna roll",0.141692458329923,23,7,16,6.18897080588663,16.8110291941134
"2000","way dont wanna",0.141692458329923,23,7,16,6.18897080588663,16.8110291941134
"2000","wednesday thursday",0.141692458329923,23,7,16,6.18897080588663,16.8110291941134
"2000","yeah cant",0.141692458329923,23,7,16,6.18897080588663,16.8110291941134
"2000","memories",0.141298096070339,163,46,117,43.8609670156314,119.139032984369
"2010","heart cant",0.141211113999001,52,9,43,8.00606164687973,43.9939383531203
"2010","love ya",0.141211113999001,52,9,43,8.00606164687973,43.9939383531203
"2000","just aint",0.139918077491816,62,18,44,16.6833126071727,45.3166873928273
"2000","let hold",0.139918077491816,62,18,44,16.6833126071727,45.3166873928273
"1980","deny",0.139185553719055,133,24,109,22.3753517765959,110.624648223404
"1960","strong",0.138209479742944,470,30,440,28.0699384946508,441.930061505349
"1960","workin",0.137767354129531,102,7,95,6.09177388607314,95.9082261139269
"1980","nothin",0.136879825239129,487,85,402,81.9307993624224,405.069200637578
"1970","believe can",0.136804545254654,38,6,32,5.20021989003772,32.7997801099623
"1970","can stand",0.136804545254654,38,6,32,5.20021989003772,32.7997801099623
"1970","gonna show",0.136804545254654,38,6,32,5.20021989003772,32.7997801099623
"1970","laughed",0.136804545254654,38,6,32,5.20021989003772,32.7997801099623
"1970","life aint",0.136804545254654,38,6,32,5.20021989003772,32.7997801099623
"1970","partner",0.136804545254654,38,6,32,5.20021989003772,32.7997801099623
"1970","person",0.136804545254654,38,6,32,5.20021989003772,32.7997801099623
"1970","rainy night",0.136804545254654,38,6,32,5.20021989003772,32.7997801099623
"1970","used love",0.136804545254654,38,6,32,5.20021989003772,32.7997801099623
"1980","add",0.136678143979678,31,6,25,5.21530755695092,25.7846924430491
"1980","caress",0.136678143979678,31,6,25,5.21530755695092,25.7846924430491
"1980","give love give",0.136678143979678,31,6,25,5.21530755695092,25.7846924430491
"1980","gonna know",0.136678143979678,31,6,25,5.21530755695092,25.7846924430491
"1980","like come",0.136678143979678,31,6,25,5.21530755695092,25.7846924430491
"1980","never stop",0.136678143979678,31,6,25,5.21530755695092,25.7846924430491
"1980","tale",0.136678143979678,31,6,25,5.21530755695092,25.7846924430491
"1980","things life",0.136678143979678,31,6,25,5.21530755695092,25.7846924430491
"1980","time take",0.136678143979678,31,6,25,5.21530755695092,25.7846924430491
"1980","yeah think",0.136678143979678,31,6,25,5.21530755695092,25.7846924430491
"2000","roll",0.136426646630111,804,221,583,216.34489251882,587.65510748118
"2000","oh youre",0.136016951944257,80,23,57,21.526854976997,58.473145023003
"1980","go cause",0.135931459819512,59,11,48,9.9259079309711,49.0740920690289
"1980","innocent",0.135931459819512,59,11,48,9.9259079309711,49.0740920690289
"1980","love true",0.135931459819512,59,11,48,9.9259079309711,49.0740920690289
"1980","reality",0.135931459819512,59,11,48,9.9259079309711,49.0740920690289
"2010","circles",0.13590172938945,46,8,38,7.08228530300899,38.917714696991
"2010","hey now",0.13590172938945,46,8,38,7.08228530300899,38.917714696991
"1990","away just",0.13498131204295,38,9,29,8.0614984453222,29.9385015546778
"1990","dont want go",0.13498131204295,38,9,29,8.0614984453222,29.9385015546778
"1990","match",0.13498131204295,38,9,29,8.0614984453222,29.9385015546778
"1990","twisted",0.13498131204295,38,9,29,8.0614984453222,29.9385015546778
"1990","ya baby",0.13498131204295,38,9,29,8.0614984453222,29.9385015546778
"2010","makes feel",0.134491714221953,83,14,69,12.7789060902119,70.2210939097881
"1970","listen",0.134362429722587,491,70,421,67.1923148949611,423.807685105039
"1990","im ready",0.132196881720718,147,33,114,31.1852703016411,115.814729698359
"1990","memory",0.132196881720718,147,33,114,31.1852703016411,115.814729698359
"1990","get home",0.13214579028717,65,15,50,13.7894052354196,51.2105947645804
"1990","began",0.131632389925488,47,11,36,9.97080070868799,37.029199291312
"1990","theres much",0.131632389925488,47,11,36,9.97080070868799,37.029199291312
"1990","think know",0.131632389925488,47,11,36,9.97080070868799,37.029199291312
"1990","want ill",0.131632389925488,47,11,36,9.97080070868799,37.029199291312
"1960","ill tell",0.131542242546961,118,8,110,7.04734626035913,110.952653739641
"1960","know need",0.131542242546961,118,8,110,7.04734626035913,110.952653739641
"1980","im still",0.131338869663853,214,38,176,36.0024457157257,177.997554284274
"2010","dont dont dont",0.131174110285044,40,7,33,6.15850895913825,33.8414910408617
"2010","get now",0.131174110285044,40,7,33,6.15850895913825,33.8414910408617
"2010","just fine",0.131174110285044,40,7,33,6.15850895913825,33.8414910408617
"2010","painted",0.131174110285044,40,7,33,6.15850895913825,33.8414910408617
"2010","southern",0.131174110285044,40,7,33,6.15850895913825,33.8414910408617
"2010","take care",0.131174110285044,40,7,33,6.15850895913825,33.8414910408617
"2010","upi",0.131174110285044,40,7,33,6.15850895913825,33.8414910408617
"2010","want let",0.131174110285044,40,7,33,6.15850895913825,33.8414910408617
"1990","cause thats",0.131069721862608,56,13,43,11.8801029720538,44.1198970279462
"1990","see know",0.131069721862608,56,13,43,11.8801029720538,44.1198970279462
"1990","sings",0.131069721862608,56,13,43,11.8801029720538,44.1198970279462
"1990","cmon",0.130707662416296,239,53,186,50.7025823271581,188.297417672842
"2000","ways",0.128751066798468,207,58,149,55.7007372529797,151.29926274702
"1970","grand",0.128550098046305,45,7,38,6.15815513293941,38.8418448670606
"1970","ive done",0.128550098046305,45,7,38,6.15815513293941,38.8418448670606
"1990","stars",0.127885330545108,313,69,244,66.4012898259434,246.598710174057
"2010","wheel",0.127404638913159,77,13,64,11.8551297463411,65.1448702536589
"2010","coat",0.127331718021316,34,6,28,5.23473261526751,28.7652673847325
"2010","college",0.127331718021316,34,6,28,5.23473261526751,28.7652673847325
"2010","got little",0.127331718021316,34,6,28,5.23473261526751,28.7652673847325
"2010","ill anything",0.127331718021316,34,6,28,5.23473261526751,28.7652673847325
"2010","mention",0.127331718021316,34,6,28,5.23473261526751,28.7652673847325
"2010","new orleans",0.127331718021316,34,6,28,5.23473261526751,28.7652673847325
"2010","oh ill",0.127331718021316,34,6,28,5.23473261526751,28.7652673847325
"2010","say yes",0.127331718021316,34,6,28,5.23473261526751,28.7652673847325
"2010","see wanna",0.127331718021316,34,6,28,5.23473261526751,28.7652673847325
"2010","talked",0.127331718021316,34,6,28,5.23473261526751,28.7652673847325
"2010","yep",0.127331718021316,34,6,28,5.23473261526751,28.7652673847325
"2010","played",0.126602913686861,152,25,127,23.4023340447254,128.597665955275
"2010","waste",0.126602913686861,152,25,127,23.4023340447254,128.597665955275
"2000","ones",0.126587202031334,218,61,157,58.6606798123168,159.339320187683
"2000","begging",0.126418649233042,73,21,52,19.6432551665097,53.3567448334902
"2000","exactly",0.126418649233042,73,21,52,19.6432551665097,53.3567448334902
"2000","leavin",0.126332097400569,91,26,65,24.4867975363341,66.5132024636659
"2010","will never",0.125426941628256,253,41,212,38.9525691665494,214.047430833451
"1980","lets",0.124387116156447,1662,285,1377,279.607779343627,1382.39222065637
"1960","tough",0.124357840826685,150,10,140,8.95849100893109,141.041508991069
"2010","think can",0.124064287149104,127,21,106,19.5532659452639,107.446734054736
"1980","nine",0.123666193099679,82,15,67,13.7953296667734,68.2046703332266
"1980","blow mind",0.123642279275357,48,9,39,8.07531492689174,39.9246850731083
"1980","pure",0.123642279275357,48,9,39,8.07531492689174,39.9246850731083
"1970","everybody knows",0.123032347465854,52,8,44,7.11609037584109,44.8839096241589
"1970","give heart",0.123032347465854,52,8,44,7.11609037584109,44.8839096241589
"1970","im afraid",0.123032347465854,52,8,44,7.11609037584109,44.8839096241589
"1970","plenty",0.123032347465854,52,8,44,7.11609037584109,44.8839096241589
"1970","treat right",0.123032347465854,52,8,44,7.11609037584109,44.8839096241589
"1990","save",0.122648012349353,304,67,237,64.4919875625776,239.508012437422
"2000","extra",0.122350422303351,48,14,34,12.9161129861982,35.0838870138018
"2000","let one",0.122350422303351,48,14,34,12.9161129861982,35.0838870138018
"1990","slip",0.121990194886703,129,29,100,27.3666657749096,101.63333422509
"1980","im im",0.121554469629073,65,12,53,10.9353222968326,54.0646777031674
"1980","stranger",0.121554469629073,65,12,53,10.9353222968326,54.0646777031674
"1970","piece",0.121384221284873,157,23,134,21.4851190193664,135.514880980634
"2010","day day",0.120348971796979,71,12,59,10.9313534024704,60.0686465975296
"1990","less",0.119540874868712,152,34,118,32.2459937812888,119.754006218711
"2000","lifes",0.118877042838325,102,29,73,27.4467400956712,74.5532599043289
"1970","cross",0.117625109134849,136,20,116,18.6113132906613,117.388686709339
"2000","give everything",0.116845667788206,66,19,47,17.7596553560225,48.2403446439775
"1970","happens",0.116777256688547,66,10,56,9.03196086164446,56.9680391383555
"1970","right dont",0.116777256688547,66,10,56,9.03196086164446,56.9680391383555
"2000","lyin",0.116614243754371,84,24,60,22.6031977258468,61.3968022741532
"2010","sail",0.116377569119738,96,16,80,14.7804215019318,81.2195784980682
"1970","hey baby",0.115608787548467,122,18,104,16.6954428048579,105.304557195142
"1970","begging",0.115135998304063,73,11,62,9.98989610454615,63.0101038954538
"1970","like one",0.115135998304063,73,11,62,9.98989610454615,63.0101038954538
"1970","missed",0.115135998304063,73,11,62,9.98989610454615,63.0101038954538
"1970","passed",0.115135998304063,73,11,62,9.98989610454615,63.0101038954538
"1970","vision",0.115135998304063,73,11,62,9.98989610454615,63.0101038954538
"1970","ground",0.114907465632044,278,40,238,38.0437139323812,239.956286067619
"1970","really need",0.114800713736985,115,17,98,15.7375075619563,99.2624924380437
"2010","realize",0.114663647832867,184,30,154,28.329141212036,155.670858787964
"1970","mistake",0.11416027295146,108,16,92,14.7795723190546,93.2204276809454
"2000","blew",0.114042736869128,41,12,29,11.032513175711,29.9674868242891
"2000","kiss like",0.114042736869128,41,12,29,11.032513175711,29.9674868242891
"2000","lets take",0.114042736869128,41,12,29,11.032513175711,29.9674868242891
"2000","money dont",0.114042736869128,41,12,29,11.032513175711,29.9674868242891
"2000","now shes",0.114042736869128,41,12,29,11.032513175711,29.9674868242891
"2000","refuse",0.114042736869128,41,12,29,11.032513175711,29.9674868242891
"2000","see cry",0.114042736869128,41,12,29,11.032513175711,29.9674868242891
"2000","shes one",0.114042736869128,41,12,29,11.032513175711,29.9674868242891
"2000","studio",0.114042736869128,41,12,29,11.032513175711,29.9674868242891
"1970","back now",0.113644454842279,87,13,74,11.9057665903495,75.0942334096505
"1980","wanna love",0.113626947454316,88,16,72,14.8047440326349,73.1952559673651
"2010","drove",0.113333375484199,65,11,54,10.0075770585997,54.9924229414003
"2010","wrap",0.113333375484199,65,11,54,10.0075770585997,54.9924229414003
"1990","baby really",0.11259565546437,25,6,19,5.30361739823829,19.6963826017617
"1990","cause dont wanna",0.11259565546437,25,6,19,5.30361739823829,19.6963826017617
"1990","didnt even",0.11259565546437,25,6,19,5.30361739823829,19.6963826017617
"1990","droppin",0.11259565546437,25,6,19,5.30361739823829,19.6963826017617
"1990","get party",0.11259565546437,25,6,19,5.30361739823829,19.6963826017617
"1990","going way",0.11259565546437,25,6,19,5.30361739823829,19.6963826017617
"1990","good im",0.11259565546437,25,6,19,5.30361739823829,19.6963826017617
"1990","half way",0.11259565546437,25,6,19,5.30361739823829,19.6963826017617
"1990","leave now",0.11259565546437,25,6,19,5.30361739823829,19.6963826017617
"1990","lonely dont",0.11259565546437,25,6,19,5.30361739823829,19.6963826017617
"1990","madness",0.11259565546437,25,6,19,5.30361739823829,19.6963826017617
"1990","oh one",0.11259565546437,25,6,19,5.30361739823829,19.6963826017617
"1990","rolled",0.11259565546437,25,6,19,5.30361739823829,19.6963826017617
"1990","say ill",0.11259565546437,25,6,19,5.30361739823829,19.6963826017617
"1990","summer time",0.11259565546437,25,6,19,5.30361739823829,19.6963826017617
"1990","thing never",0.11259565546437,25,6,19,5.30361739823829,19.6963826017617
"1990","wrong cant",0.11259565546437,25,6,19,5.30361739823829,19.6963826017617
"1990","yo yo",0.11259565546437,25,6,19,5.30361739823829,19.6963826017617
"1970","ways",0.1125620346991,207,30,177,28.3275136115213,178.672486388479
"1980","leather",0.112479731395404,37,7,30,6.22472192281238,30.7752780771876
"1980","life will",0.112479731395404,37,7,30,6.22472192281238,30.7752780771876
"1980","mind got",0.112479731395404,37,7,30,6.22472192281238,30.7752780771876
"1980","now im gonna",0.112479731395404,37,7,30,6.22472192281238,30.7752780771876
"1980","oughta",0.112479731395404,37,7,30,6.22472192281238,30.7752780771876
"1980","spend time",0.112479731395404,37,7,30,6.22472192281238,30.7752780771876
"1990","come let",0.110966614947835,70,16,54,14.8501287150672,55.1498712849328
"1960","land",0.110008221704005,151,10,141,9.01821428232397,141.981785717676
"2000","thats way",0.109723639528742,204,57,147,54.8934801913423,149.106519808658
"1980","day day",0.109567434795024,71,13,58,11.944736662694,59.055263337306
"1980","know oh",0.109567434795024,71,13,58,11.944736662694,59.055263337306
"1980","seeing",0.109567434795024,71,13,58,11.944736662694,59.055263337306
"2000","holding",0.109281790138931,299,83,216,80.4566204765262,218.543379523474
"2010","wishing",0.109103971049771,90,15,75,13.8566451580611,76.1433548419389
"1960","called",0.108817394799871,231,15,216,13.7960761537539,217.203923846246
"2000","pretend",0.108298624543034,124,35,89,33.3666252143453,90.6333747856547
"2000","stroke",0.108298624543034,124,35,89,33.3666252143453,90.6333747856547
"1990","ooo",0.108137544966181,180,40,140,38.1860452673157,141.813954732684
"1980","garden",0.108041484667027,54,10,44,9.08472929275321,44.9152707072468
"1980","long im",0.108041484667027,54,10,44,9.08472929275321,44.9152707072468
"1990","baby make",0.107934261786152,61,14,47,12.9408264517014,48.0591735482986
"1990","oclock",0.107934261786152,61,14,47,12.9408264517014,48.0591735482986
"1980","tomorrow",0.107687219145273,279,49,230,46.9377680125582,232.062231987442
"1960","ran",0.107486133301247,88,6,82,5.25564805857291,82.7443519414271
"1960","whole life",0.107486133301247,88,6,82,5.25564805857291,82.7443519414271
"2000","cats",0.107307005205711,59,17,42,15.8760555455353,43.1239444544647
"2000","hiding",0.107307005205711,59,17,42,15.8760555455353,43.1239444544647
"2000","need one",0.107307005205711,59,17,42,15.8760555455353,43.1239444544647
"2010","aint way",0.106370020793029,59,10,49,9.08380071472892,49.9161992852711
"2010","girl aint",0.106370020793029,59,10,49,9.08380071472892,49.9161992852711
"2000","life baby",0.106312421338402,34,10,24,9.14891336522372,24.8510866347763
"2000","marvin",0.106312421338402,34,10,24,9.14891336522372,24.8510866347763
"2000","oh oh yeah",0.106312421338402,34,10,24,9.14891336522372,24.8510866347763
"2000","us apart",0.106312421338402,34,10,24,9.14891336522372,24.8510866347763
"2000","wolf",0.106312421338402,34,10,24,9.14891336522372,24.8510866347763
"1990","coat",0.10627949019456,34,8,26,7.21291966160408,26.7870803383959
"1990","come play",0.10627949019456,34,8,26,7.21291966160408,26.7870803383959
"1990","deep heart",0.10627949019456,34,8,26,7.21291966160408,26.7870803383959
"1990","hearted",0.10627949019456,34,8,26,7.21291966160408,26.7870803383959
"1990","im gonna find",0.10627949019456,34,8,26,7.21291966160408,26.7870803383959
"1990","indian",0.10627949019456,34,8,26,7.21291966160408,26.7870803383959
"1990","life just",0.105716632229746,52,12,40,11.0315241883356,40.9684758116644
"1990","love ya",0.105716632229746,52,12,40,11.0315241883356,40.9684758116644
"1990","one want",0.105716632229746,52,12,40,11.0315241883356,40.9684758116644
"1990","plenty",0.105716632229746,52,12,40,11.0315241883356,40.9684758116644
"1990","treat right",0.105716632229746,52,12,40,11.0315241883356,40.9684758116644
"1990","conversation",0.104819947407422,43,10,33,9.12222192496986,33.8777780750301
"1990","right right right",0.104819947407422,43,10,33,9.12222192496986,33.8777780750301
"1990","since youve",0.104819947407422,43,10,33,9.12222192496986,33.8777780750301
"1990","step take",0.104819947407422,43,10,33,9.12222192496986,33.8777780750301
"1990","time time",0.103742677594426,194,43,151,41.1560710103291,152.843928989671
"1970","sittin",0.103452563954931,172,25,147,23.5378373970128,148.462162602987
"1990","block",0.102569310616296,148,33,115,31.3974149975707,116.602585002429
"1990","dont dont",0.102279138410108,93,21,72,19.7294567214464,73.2705432785536
"1980","needed",0.101923077459804,227,40,187,38.1895101750922,188.810489824908
"1960","love dont",0.101405203582907,280,18,262,16.7225165500047,263.277483449995
"2010","cold",0.100945720468512,522,83,439,80.3685419167542,441.631458083246
"1990","can make",0.100811388061969,370,81,289,78.4935374939267,291.506462506073
"1980","cant wait",0.0996292589295398,146,26,120,24.5624162359624,121.437583764038
"2000","aint easy",0.0996053957836185,27,8,19,7.26531355473648,19.7346864452635
"2000","begins",0.0996053957836185,27,8,19,7.26531355473648,19.7346864452635
"2000","forth",0.0996053957836185,27,8,19,7.26531355473648,19.7346864452635
"2000","heart let",0.0996053957836185,27,8,19,7.26531355473648,19.7346864452635
"2000","palm",0.0996053957836185,27,8,19,7.26531355473648,19.7346864452635
"2000","say cause",0.0996053957836185,27,8,19,7.26531355473648,19.7346864452635
"2000","see go",0.0996053957836185,27,8,19,7.26531355473648,19.7346864452635
"2000","struck",0.0996053957836185,27,8,19,7.26531355473648,19.7346864452635
"1960","short",0.0994862726613697,120,8,112,7.16679280714487,112.833207192855
"2010","gonna go",0.0994765628139742,53,9,44,8.16002437085818,44.8399756291418
"2010","headed",0.0994765628139742,53,9,44,8.16002437085818,44.8399756291418
"2010","need somebody",0.0994765628139742,53,9,44,8.16002437085818,44.8399756291418
"2010","ooh love",0.0994765628139742,53,9,44,8.16002437085818,44.8399756291418
"1980","roses",0.0994235790225262,77,14,63,12.9541510285555,64.0458489714445
"2000","without",0.0987363538505512,1367,373,994,367.840134419436,999.159865580564
"1980","nice",0.0983052807434821,233,41,192,39.1989245409537,193.801075459046
"2000","just know",0.0971785364619677,70,20,50,18.8359981048724,51.1640018951276
"1960","everybodys",0.0965979887272037,152,10,142,9.07793755571684,142.922062444283
"1960","start",0.0959579422203616,753,47,706,44.9716248648341,708.028375135166
"1990","must",0.0957908657541413,696,151,545,147.652708366954,548.347291633046
"2010","dont",0.0957725820866884,11587,1796,9791,1783.96608273837,9803.03391726163
"1980","sold",0.0955069513264846,60,11,49,10.0941436586147,49.9058563413853
"2000","weak",0.0954080526455341,128,36,92,34.4429679631952,93.5570320368048
"1970","started",0.0951399367578647,315,45,270,43.1070859305758,271.892914069424
"1970","get away",0.0950854550797424,137,20,117,18.7481611825044,118.251838817496
"1960","couldnt",0.0950542751977883,508,32,476,30.33942288358,477.66057711642
"2000","aint stoppin",0.0949861087797392,20,6,14,5.38171374424925,14.6182862557508
"2000","back got",0.0949861087797392,20,6,14,5.38171374424925,14.6182862557508
"2000","come tonight",0.0949861087797392,20,6,14,5.38171374424925,14.6182862557508
"2000","drive night",0.0949861087797392,20,6,14,5.38171374424925,14.6182862557508
"2000","enemy",0.0949861087797392,20,6,14,5.38171374424925,14.6182862557508
"2000","give money",0.0949861087797392,20,6,14,5.38171374424925,14.6182862557508
"2000","go every",0.0949861087797392,20,6,14,5.38171374424925,14.6182862557508
"2000","hey boy",0.0949861087797392,20,6,14,5.38171374424925,14.6182862557508
"2000","like time",0.0949861087797392,20,6,14,5.38171374424925,14.6182862557508
"2000","listenin",0.0949861087797392,20,6,14,5.38171374424925,14.6182862557508
"2000","magazine",0.0949861087797392,20,6,14,5.38171374424925,14.6182862557508
"2000","meyoure",0.0949861087797392,20,6,14,5.38171374424925,14.6182862557508
"2000","role",0.0949861087797392,20,6,14,5.38171374424925,14.6182862557508
"2000","run hide",0.0949861087797392,20,6,14,5.38171374424925,14.6182862557508
"2000","see another",0.0949861087797392,20,6,14,5.38171374424925,14.6182862557508
"2000","spread wings",0.0949861087797392,20,6,14,5.38171374424925,14.6182862557508
"2000","trance",0.0949861087797392,20,6,14,5.38171374424925,14.6182862557508
"2000","want rock",0.0949861087797392,20,6,14,5.38171374424925,14.6182862557508
"2000","wed never",0.0949861087797392,20,6,14,5.38171374424925,14.6182862557508
"2000","will never change",0.0949861087797392,20,6,14,5.38171374424925,14.6182862557508
"2000","youre just like",0.0949861087797392,20,6,14,5.38171374424925,14.6182862557508
"2010","say im",0.094962245088404,242,39,203,37.2589792027864,204.741020797214
"1980","cant feel",0.0948796347065231,43,8,35,7.23413628867385,35.7658637113261
"1980","conversation",0.0948796347065231,43,8,35,7.23413628867385,35.7658637113261
"1980","feel alright",0.0948796347065231,43,8,35,7.23413628867385,35.7658637113261
"1980","promise promise",0.0948796347065231,43,8,35,7.23413628867385,35.7658637113261
"1980","way want",0.0948796347065231,43,8,35,7.23413628867385,35.7658637113261
"2010","around world",0.094556774909822,78,13,65,12.0090924703196,65.9909075296804
"2010","doesnt matter",0.094556774909822,78,13,65,12.0090924703196,65.9909075296804
"2010","im love",0.0943539859811162,223,36,187,34.3336874471958,188.666312552804
"1980","still",0.0942875075056016,1843,315,1528,310.058446047114,1532.94155395289
"2000","thinkin",0.0937695850916933,362,100,262,97.4090187709113,264.590981229089
"1980","baby know",0.0935257719692468,181,32,149,30.4506667034876,150.549333296512
"1990","shouldve",0.0931103124972328,75,17,58,15.9108521947149,59.0891478052851
"1990","youand",0.0931103124972328,75,17,58,15.9108521947149,59.0891478052851
"2010","goodnight",0.0926796222586082,47,8,39,7.23624802698745,39.7637519730126
"2010","know better",0.0926796222586082,47,8,39,7.23624802698745,39.7637519730126
"2010","ready go",0.0926796222586082,47,8,39,7.23624802698745,39.7637519730126
"1960","will",0.0922774437110565,3611,220,3391,215.660740221668,3395.33925977833
"1970","get caught",0.0922742605993903,39,6,33,5.33706778188082,33.6629322181192
"1970","make believe",0.0922742605993903,39,6,33,5.33706778188082,33.6629322181192
"1970","mercy mercy",0.0922742605993903,39,6,33,5.33706778188082,33.6629322181192
"1970","mind dont",0.0922742605993903,39,6,33,5.33706778188082,33.6629322181192
"1970","wanna give",0.0922742605993903,39,6,33,5.33706778188082,33.6629322181192
"1970","wash away",0.0922742605993903,39,6,33,5.33706778188082,33.6629322181192
"1970","call name",0.0920874891694266,123,18,105,16.832290696701,106.167709303299
"1970","used",0.0917314442324724,732,103,629,100.172656829148,631.827343170852
"2010","anywhere",0.0915394619707857,122,20,102,18.7834523253717,103.216547674628
"1980","rings",0.0907311653633189,83,15,68,13.963565394417,69.036434605583
"1980","ocean",0.0902729460545482,106,19,87,17.8329871302193,88.1670128697807
"1960","brings",0.0902381261119694,89,6,83,5.31537133196578,83.6846286680342
"1960","rhyme",0.0902381261119694,89,6,83,5.31537133196578,83.6846286680342
"1960","face",0.0892903781697596,869,54,815,51.8995245784075,817.100475421592
"1990","shines",0.0888605848210826,66,15,51,14.0015499313491,51.9984500686509
"1970","got mind",0.0887546559320891,46,7,39,6.29500302478251,39.7049969752175
"1970","theres way",0.0887546559320891,46,7,39,6.29500302478251,39.7049969752175
"2000","arent",0.0883965585404209,45,13,32,12.1088559245608,32.8911440754392
"2000","ive done",0.0883965585404209,45,13,32,12.1088559245608,32.8911440754392
"2000","owe",0.0883965585404209,45,13,32,12.1088559245608,32.8911440754392
"2000","stop stop",0.0883965585404209,45,13,32,12.1088559245608,32.8911440754392
"2000","wanna ride",0.0883965585404209,45,13,32,12.1088559245608,32.8911440754392
"2000","goodbye",0.0882821399780847,410,113,297,110.32513175711,299.67486824289
"1970","never find",0.0882188318511368,102,15,87,13.958484967996,88.041515032004
"2010","know like",0.0882110760866115,160,26,134,24.634035836553,135.365964163447
"1960","caught",0.0881996206419902,330,21,309,19.7086802196484,310.291319780352
"2010","see face",0.0881857281128977,97,16,81,14.9343842259103,82.0656157740897
"2000","tell em",0.0881283193074589,161,45,116,43.3227956412064,117.677204358794
"2000","babyi",0.0874606828157889,63,18,45,16.9523982943851,46.0476017056149
"2000","just make",0.0874606828157889,63,18,45,16.9523982943851,46.0476017056149
"2000","shop",0.0874606828157889,63,18,45,16.9523982943851,46.0476017056149
"1980","na na na na",0.087318710923844,831,143,688,139.803889671813,691.196110328187
"1970","need need",0.0871702680835627,95,14,81,13.0005497250943,81.9994502749057
"1970","believed",0.0867012345778384,53,8,45,7.25293826768419,45.7470617323158
"1970","calls",0.0867012345778384,53,8,45,7.25293826768419,45.7470617323158
"1970","hopin",0.0867012345778384,53,8,45,7.25293826768419,45.7470617323158
"1970","johnny",0.0867012345778384,53,8,45,7.25293826768419,45.7470617323158
"1960","everyone",0.0866283130240935,217,14,203,12.9599503262536,204.040049673746
"1970","feel way",0.086607404964552,180,26,154,24.6326205317576,155.367379468242
"1990","didnt know",0.0865100359728808,144,32,112,30.5488362138526,113.451163786147
"2010","back time",0.0860213044687859,41,7,34,6.31247168311671,34.6875283168833
"2010","money dont",0.0860213044687859,41,7,34,6.31247168311671,34.6875283168833
"2010","panties",0.0860213044687859,41,7,34,6.31247168311671,34.6875283168833
"2010","things never",0.0860213044687859,41,7,34,6.31247168311671,34.6875283168833
"1970","belongs",0.0856202047135954,81,12,69,11.0846792392909,69.9153207607091
"1970","know feel",0.0856202047135954,81,12,69,11.0846792392909,69.9153207607091
"1970","heavens",0.0856074650322451,60,9,51,8.21087351058588,51.7891264894141
"1970","reasons",0.0856074650322451,60,9,51,8.21087351058588,51.7891264894141
"1970","woh woh",0.0856074650322451,60,9,51,8.21087351058588,51.7891264894141
"1970","ya got",0.0856074650322451,60,9,51,8.21087351058588,51.7891264894141
"1970","meyou",0.0852210881404454,74,11,63,10.1267439963892,63.8732560036107
"1980","cadillac",0.0852202105907369,66,12,54,11.1035580244761,54.8964419755239
"1980","happens",0.0852202105907369,66,12,54,11.1035580244761,54.8964419755239
"1980","shines",0.0852202105907369,66,12,54,11.1035580244761,54.8964419755239
"1970","dont ask",0.085176073235911,67,10,57,9.16880875348756,57.8311912465124
"1970","know way",0.085176073235911,67,10,57,9.16880875348756,57.8311912465124
"1970","youre alone",0.085176073235911,67,10,57,9.16880875348756,57.8311912465124
"1990","away im",0.0849740467438471,57,13,44,12.0922476679833,44.9077523320167
"1990","blows",0.0849740467438471,57,13,44,12.0922476679833,44.9077523320167
"1990","plain",0.0849740467438471,57,13,44,12.0922476679833,44.9077523320167
"1990","signs",0.0849740467438471,57,13,44,12.0922476679833,44.9077523320167
"1990","way say",0.0849740467438471,57,13,44,12.0922476679833,44.9077523320167
"1990","youoh",0.0849740467438471,57,13,44,12.0922476679833,44.9077523320167
"1960","get away",0.0843697980023106,137,9,128,8.18208845482373,128.817911545176
"1980","brings",0.0832021622512014,89,16,73,14.9729797602784,74.0270202397216
"1990","else can",0.0830177065988096,89,20,69,18.8808779377283,70.1191220622717
"1970","got got",0.0826893323034184,166,24,142,22.7167500459543,143.283249954046
"1980","come girl",0.0824281861835736,32,6,26,5.38354328459449,26.6164567154055
"1980","dance come",0.0824281861835736,32,6,26,5.38354328459449,26.6164567154055
"1980","eyes im",0.0824281861835736,32,6,26,5.38354328459449,26.6164567154055
"1980","loaded",0.0824281861835736,32,6,26,5.38354328459449,26.6164567154055
"1980","long know",0.0824281861835736,32,6,26,5.38354328459449,26.6164567154055
"1980","mountain high",0.0824281861835736,32,6,26,5.38354328459449,26.6164567154055
"1980","night dont",0.0824281861835736,32,6,26,5.38354328459449,26.6164567154055
"1980","pulling",0.0824281861835736,32,6,26,5.38354328459449,26.6164567154055
"1980","san",0.0824281861835736,32,6,26,5.38354328459449,26.6164567154055
"1980","velvet",0.0824281861835736,32,6,26,5.38354328459449,26.6164567154055
"1980","want youre",0.0824281861835736,32,6,26,5.38354328459449,26.6164567154055
"1980","well good",0.0824281861835736,32,6,26,5.38354328459449,26.6164567154055
"1980","whats mind",0.0824281861835736,32,6,26,5.38354328459449,26.6164567154055
"2000","taking",0.0824209674057585,216,60,156,58.1225084378919,157.877491562108
"1990","far away",0.082199174620043,158,35,123,33.518861956866,124.481138043134
"1980","one time",0.0821075274736907,199,35,164,33.478909801072,165.521090198928
"1990","kitchen",0.0816535308687794,48,11,37,10.1829454046175,37.8170545953825
"1980","got way",0.0815104521942538,49,9,40,8.24355065453532,40.7564493454647
"1980","keepin",0.0815104521942538,49,9,40,8.24355065453532,40.7564493454647
"1980","shared",0.0815104521942538,49,9,40,8.24355065453532,40.7564493454647
"1980","youre always",0.0815104521942538,49,9,40,8.24355065453532,40.7564493454647
"1980","somehow",0.0813385168102028,170,30,140,28.6000736994082,141.399926300592
"1990","tell love",0.0810966425212158,112,25,87,23.7602059441075,88.2397940558925
"2010","fly away",0.0810488552173441,91,15,76,14.0106078820395,76.9893921179605
"2000","wanna live",0.0803774572814153,74,21,53,19.9123408537222,54.0876591462778
"2010","compare",0.0795723747762276,35,6,29,5.38869533924597,29.611304660754
"2010","jackson",0.0795723747762276,35,6,29,5.38869533924597,29.611304660754
"2010","kicked",0.0795723747762276,35,6,29,5.38869533924597,29.611304660754
"2010","love call",0.0795723747762276,35,6,29,5.38869533924597,29.611304660754
"2010","might just",0.0795723747762276,35,6,29,5.38869533924597,29.611304660754
"1990","kiss kiss",0.0792874741723091,39,9,30,8.27364314125173,30.7263568587483
"1990","know hes",0.0792874741723091,39,9,30,8.27364314125173,30.7263568587483
"1990","loveyou",0.0792874741723091,39,9,30,8.27364314125173,30.7263568587483
"1990","night love",0.0792874741723091,39,9,30,8.27364314125173,30.7263568587483
"1990","oh well",0.0792874741723091,39,9,30,8.27364314125173,30.7263568587483
"1990","please dont go",0.0792874741723091,39,9,30,8.27364314125173,30.7263568587483
"1990","wanna give",0.0792874741723091,39,9,30,8.27364314125173,30.7263568587483
"2000","away just",0.0790860974395367,38,11,27,10.2252561140736,27.7747438859264
"2000","look way",0.0790860974395367,38,11,27,10.2252561140736,27.7747438859264
"2000","partner",0.0790860974395367,38,11,27,10.2252561140736,27.7747438859264
"2000","smart",0.0790860974395367,38,11,27,10.2252561140736,27.7747438859264
"2000","spend life",0.0790860974395367,38,11,27,10.2252561140736,27.7747438859264
"1970","aye",0.0788282264565061,152,22,130,20.8008795601509,131.199120439849
"1970","pride",0.0788282264565061,152,22,130,20.8008795601509,131.199120439849
"1990","cant pretend",0.0787252400033105,30,7,23,6.36434087788595,23.6356591221141
"1990","cell",0.0787252400033105,30,7,23,6.36434087788595,23.6356591221141
"1990","ended",0.0787252400033105,30,7,23,6.36434087788595,23.6356591221141
"1990","get cause",0.0787252400033105,30,7,23,6.36434087788595,23.6356591221141
"1990","heart now",0.0787252400033105,30,7,23,6.36434087788595,23.6356591221141
"1990","heart thats",0.0787252400033105,30,7,23,6.36434087788595,23.6356591221141
"1990","living life",0.0787252400033105,30,7,23,6.36434087788595,23.6356591221141
"1990","rapper",0.0787252400033105,30,7,23,6.36434087788595,23.6356591221141
"1990","really know",0.0787252400033105,30,7,23,6.36434087788595,23.6356591221141
"1990","ripped",0.0787252400033105,30,7,23,6.36434087788595,23.6356591221141
"1990","scratch",0.0787252400033105,30,7,23,6.36434087788595,23.6356591221141
"1990","turn turn turn",0.0787252400033105,30,7,23,6.36434087788595,23.6356591221141
"1990","yes will",0.0787252400033105,30,7,23,6.36434087788595,23.6356591221141
"1980","takin",0.0786485490381166,118,21,97,19.8518158619422,98.1481841380578
"1990","deep love",0.0779699640843989,80,18,62,16.9715756743625,63.0284243256375
"2000","can still",0.0777428291695743,56,16,40,15.0687984838979,40.9312015161021
"2000","lie lie",0.0777428291695743,56,16,40,15.0687984838979,40.9312015161021
"1980","youll never",0.0775519428331197,176,31,145,29.6094880652697,146.39051193473
"1990","telling",0.0774858260126758,260,57,203,55.1576209416782,204.842379058322
"1980","dont ever",0.077288461135911,147,26,121,24.730651963606,122.269348036394
"2000","give",0.0771716087335363,3148,854,2294,847.081743344831,2300.91825665517
"1970","baby youre",0.0769241731189672,145,21,124,19.8429443172492,125.157055682751
"1980","gonna let",0.0766200452711652,95,17,78,15.9823941261399,79.0176058738601
"1970","live without",0.0761090174961039,202,29,173,27.6432741523058,174.356725847694
"2010","theres nothing",0.0756999805080745,186,30,156,28.6370666599929,157.362933340007
"1970","air",0.0752603845820863,417,59,358,57.0655708985718,359.934429101428
"1960","asking",0.0746147044960297,90,6,84,5.37509460535865,84.6249053946413
"2010","thats",0.0742350321620879,2727,425,2302,419.85634828925,2307.14365171075
"2010","wont take",0.0739313459700148,85,14,71,13.0868315381688,71.9131684618312
"1980","another",0.0736782186211373,1121,192,929,188.592250688451,932.407749311549
"1960","need",0.0733683132329714,3735,227,3508,223.066426122384,3511.93357387762
"1990","know oh",0.0730129691440864,71,16,55,15.0622734109967,55.9377265890033
"1990","love ive",0.0730129691440864,71,16,55,15.0622734109967,55.9377265890033
"1980","didnt",0.072301839822221,868,149,719,146.028611594626,721.971388405374
"1960","heres",0.0721412474789411,138,9,129,8.2418117282166,129.758188271783
"1980","can turn",0.0710168421589477,55,10,45,9.25296502039679,45.7470349796032
"1980","good lovin",0.0710168421589477,55,10,45,9.25296502039679,45.7470349796032
"1980","im gonna love",0.0710168421589477,55,10,45,9.25296502039679,45.7470349796032
"2010","lets get",0.0708767817715996,269,43,226,41.4159727502047,227.584027249795
"2010","im glad",0.0708645337408889,104,17,87,16.0121232937595,87.9878767062406
"1980","round",0.0708563043837334,727,125,602,122.307373996881,604.692626003119
"1980","plays",0.0708188971012653,101,18,83,16.9918084920014,84.0081915079986
"1980","heard",0.070600632906122,586,101,485,98.5861363991367,487.413863600863
"1980","ask",0.0701433383472434,498,86,412,83.7813923665018,414.218607633498
"2000","belly",0.0699590387459081,31,9,22,8.34165630358633,22.6583436964137
"2000","caress",0.0699590387459081,31,9,22,8.34165630358633,22.6583436964137
"2000","freaks",0.0699590387459081,31,9,22,8.34165630358633,22.6583436964137
"2000","lip",0.0699590387459081,31,9,22,8.34165630358633,22.6583436964137
"2000","place id",0.0699590387459081,31,9,22,8.34165630358633,22.6583436964137
"2000","think got",0.0699590387459081,31,9,22,8.34165630358633,22.6583436964137
"2000","want cant",0.0699590387459081,31,9,22,8.34165630358633,22.6583436964137
"2010","wanted",0.06969483853862,448,71,377,68.9753003423484,379.024699657652
"2000","might",0.0694475641062411,702,192,510,188.898152423149,513.101847576851
"1980","crowd",0.0691757633368373,130,23,107,21.8706445936651,108.129355406335
"1990","need baby",0.0681860922734054,62,14,48,13.152971147631,48.847028852369
"1990","need say",0.0681860922734054,62,14,48,13.152971147631,48.847028852369
"2000","wed",0.068100410846998,191,53,138,51.3953662575803,139.60463374242
"2000","fooled",0.0680249755233693,49,14,35,13.1851986734107,35.8148013265894
"1980","every single day",0.0676333158127227,38,7,31,6.39295765045596,31.607042349544
"1980","game play",0.0676333158127227,38,7,31,6.39295765045596,31.607042349544
"1980","need just",0.0676333158127227,38,7,31,6.39295765045596,31.607042349544
"1980","treasure",0.0676333158127227,38,7,31,6.39295765045596,31.607042349544
"1980","well dont",0.0676333158127227,38,7,31,6.39295765045596,31.607042349544
"2000","taste",0.0671266726670705,224,62,162,60.2751939355916,163.724806064408
"1970","bang bang",0.0660965654508912,103,15,88,14.0953328598391,88.9046671401609
"2000","jump",0.0656737942698777,404,111,293,108.710617633835,295.289382366165
"2010","ballin",0.0654623826298628,54,9,45,8.31398709483664,45.6860129051634
"1980","held",0.0650708134481262,136,24,112,22.8800589595266,113.119941040473
"1960","songs",0.0644016180737372,187,12,175,11.1682521244674,175.831747875533
"2010","open",0.0643632830653553,519,82,437,79.9066537448188,439.093346255181
"2010","cant keep",0.0640669504502922,98,16,82,15.0883469498887,82.9116530501113
"2010","welcome",0.0640669504502922,98,16,82,15.0883469498887,82.9116530501113
"1990","gonna go",0.0635553293342355,53,12,41,11.2436688842652,41.7563311157348
"1990","make change",0.0635553293342355,53,12,41,11.2436688842652,41.7563311157348
"1990","need somebody",0.0635553293342355,53,12,41,11.2436688842652,41.7563311157348
"1990","time say",0.0635553293342355,53,12,41,11.2436688842652,41.7563311157348
"1980","lyin",0.0631119939934632,84,15,69,14.1318011220605,69.8681988779394
"2000","self",0.0625804099405078,89,25,64,23.9486261619091,65.0513738380909
"1980","store",0.0625667264081027,61,11,50,10.2623793862583,50.7376206137417
"1980","rest",0.0622036994466364,241,42,199,40.5448103621023,200.455189637898
"1960","even though",0.0618773664458498,155,10,145,9.25710737589546,145.742892624105
"1970","know true",0.061391659446248,82,12,70,11.221527131134,70.778472868866
"1980","starts",0.0613166668308742,142,25,117,23.8894733253881,118.110526674612
"2000","see love",0.0612580238158711,60,17,43,16.1451412327477,43.8548587672523
"2000","cant get head",0.0611752111516755,24,7,17,6.45805649309909,17.5419435069009
"2000","hear im",0.0611752111516755,24,7,17,6.45805649309909,17.5419435069009
"2000","helped",0.0611752111516755,24,7,17,6.45805649309909,17.5419435069009
"2000","lee",0.0611752111516755,24,7,17,6.45805649309909,17.5419435069009
"2000","like used",0.0611752111516755,24,7,17,6.45805649309909,17.5419435069009
"2000","nothing world",0.0611752111516755,24,7,17,6.45805649309909,17.5419435069009
"2000","now gonna",0.0611752111516755,24,7,17,6.45805649309909,17.5419435069009
"2000","rang",0.0611752111516755,24,7,17,6.45805649309909,17.5419435069009
"2000","see time",0.0611752111516755,24,7,17,6.45805649309909,17.5419435069009
"2000","stray",0.0611752111516755,24,7,17,6.45805649309909,17.5419435069009
"2000","together baby",0.0611752111516755,24,7,17,6.45805649309909,17.5419435069009
"2000","youits",0.0611752111516755,24,7,17,6.45805649309909,17.5419435069009
"1990","double",0.0607052975454603,122,27,95,25.8816529034029,96.1183470965971
"1990","id like",0.0607052975454603,122,27,95,25.8816529034029,96.1183470965971
"1960","doctor",0.0605786896236444,91,6,85,5.43481787875153,85.5651821212485
"1960","insane",0.0605786896236444,91,6,85,5.43481787875153,85.5651821212485
"1960","round",0.0605554321652964,727,45,682,43.4188197566193,683.581180243381
"2000","dime",0.0600620053501149,100,28,72,26.9085687212462,73.0914312787538
"1970","comfort",0.0600256932625183,75,11,64,10.2635918882323,64.7364081117677
"1970","dont talk",0.0600256932625183,75,11,64,10.2635918882323,64.7364081117677
"1970","take look",0.0600256932625183,75,11,64,10.2635918882323,64.7364081117677
"2010","passed",0.0597735876893801,73,12,61,11.2392788504273,61.7607211495727
"2010","trippin",0.0597735876893801,73,12,61,11.2392788504273,61.7607211495727
"1990","case",0.0597704374343559,76,17,59,16.1229968906444,59.8770031093556
"1990","arms around",0.0592403898807139,44,10,34,9.33436662089939,34.6656333791006
"1990","butterfly",0.0592403898807139,44,10,34,9.33436662089939,34.6656333791006
"1990","cries",0.0592403898807139,44,10,34,9.33436662089939,34.6656333791006
"1990","give good",0.0592403898807139,44,10,34,9.33436662089939,34.6656333791006
"1990","love well",0.0592403898807139,44,10,34,9.33436662089939,34.6656333791006
"1990","went away",0.0592403898807139,44,10,34,9.33436662089939,34.6656333791006
"1990","world can",0.0592403898807139,44,10,34,9.33436662089939,34.6656333791006
"1990","ya dont",0.0592403898807139,44,10,34,9.33436662089939,34.6656333791006
"1980","thought",0.0592185555501175,799,137,662,134.420346387219,664.579653612781
"1970","cant get enough",0.0588125545674245,68,10,58,9.30565664533066,58.6943433546693
"2000","man got",0.0583071218771856,42,12,30,11.3015988629234,30.6984011370766
"1990","couldnt",0.0583028435355031,508,110,398,107.769505532202,400.230494467798
"2010","put put",0.058188784559869,48,8,40,7.3902107509659,40.6097892490341
"2010","suck",0.058188784559869,48,8,40,7.3902107509659,40.6097892490341
"2000","now can",0.0581862154386301,111,31,80,29.8685112805833,81.1314887194167
"1980","queen",0.0578712300098547,148,26,122,24.8988876912495,123.10111230875
"1970","bop bop bop bop",0.0578043937742334,61,9,52,8.34772140242897,52.652278597571
"1970","store",0.0578043937742334,61,9,52,8.34772140242897,52.652278597571
"1980","let show",0.0577031112766873,90,16,74,15.141215487922,74.858784512078
"1970","aint gonna",0.0574537328160218,139,20,119,19.0218569661906,119.978143033809
"1970","day just",0.0570801364757301,54,8,46,7.38978615952729,46.6102138404727
"1970","food",0.0570801364757301,54,8,46,7.38978615952729,46.6102138404727
"1970","love yes",0.0570801364757301,54,8,46,7.38978615952729,46.6102138404727
"1970","marry",0.0570801364757301,54,8,46,7.38978615952729,46.6102138404727
"1970","need little",0.0570801364757301,54,8,46,7.38978615952729,46.6102138404727
"1970","bars",0.0570716433548326,40,6,34,5.47391567372392,34.5260843262761
"1970","dive",0.0570716433548326,40,6,34,5.47391567372392,34.5260843262761
"1970","never end",0.0570716433548326,40,6,34,5.47391567372392,34.5260843262761
"1970","pressure",0.0570716433548326,40,6,34,5.47391567372392,34.5260843262761
"1980","walked",0.0569756284208927,218,38,180,36.6753886263,181.3246113737
"1980","dont worry",0.0568555157990192,183,32,151,30.7871381587748,152.212861841225
"1980","inspiration",0.0568134737271579,44,8,36,7.40237201631743,36.5976279836826
"1980","want like",0.0568134737271579,44,8,36,7.40237201631743,36.5976279836826
"1980","world can",0.0568134737271579,44,8,36,7.40237201631743,36.5976279836826
"1970","hes gonna",0.056765199832463,47,7,40,6.4318509166256,40.5681490833744
"1970","stopped",0.056765199832463,47,7,40,6.4318509166256,40.5681490833744
"1970","sun goes",0.056765199832463,47,7,40,6.4318509166256,40.5681490833744
"1970","things want",0.056765199832463,47,7,40,6.4318509166256,40.5681490833744
"1970","time youre",0.056765199832463,47,7,40,6.4318509166256,40.5681490833744
"2010","close",0.056251758807794,764,120,644,117.627521119541,646.372478880459
"1980","twist",0.0556209159199248,67,12,55,11.2717937521197,55.7282062478803
"1990","can help",0.0554833074739176,35,8,27,7.42506435753361,27.5749356424664
"1990","cheese",0.0554833074739176,35,8,27,7.42506435753361,27.5749356424664
"1990","history",0.0554833074739176,35,8,27,7.42506435753361,27.5749356424664
"1990","just thought",0.0554833074739176,35,8,27,7.42506435753361,27.5749356424664
"1990","now hes",0.0554833074739176,35,8,27,7.42506435753361,27.5749356424664
"1990","now will",0.0554833074739176,35,8,27,7.42506435753361,27.5749356424664
"1990","said hey",0.0554833074739176,35,8,27,7.42506435753361,27.5749356424664
"1990","stay dont",0.0554833074739176,35,8,27,7.42506435753361,27.5749356424664
"1990","wicked",0.0554833074739176,35,8,27,7.42506435753361,27.5749356424664
"1990","special",0.0545487322891511,201,44,157,42.6410838818359,158.358916118164
"1990","cry dont",0.0544893890296472,67,15,52,14.2136946272786,52.7863053727214
"1990","promised",0.0544893890296472,67,15,52,14.2136946272786,52.7863053727214
"1970","understand",0.0543215755906687,585,82,503,80.0560167282123,504.943983271788
"1990","go oh",0.0540687724830906,90,20,70,19.0930226336578,70.9069773663421
"1990","rise",0.0540687724830906,90,20,70,19.0930226336578,70.9069773663421
"2000","fallin",0.0536006117119507,188,52,136,50.5881091959429,137.411890804057
"2010","play",0.0529609864003442,1125,176,949,173.208064475763,951.791935524237
"1990","around town",0.0528583161148729,26,6,20,5.51576209416782,20.4842379058322
"1990","babe im",0.0528583161148729,26,6,20,5.51576209416782,20.4842379058322
"1990","baby never",0.0528583161148729,26,6,20,5.51576209416782,20.4842379058322
"1990","biz",0.0528583161148729,26,6,20,5.51576209416782,20.4842379058322
"1990","gotten",0.0528583161148729,26,6,20,5.51576209416782,20.4842379058322
"1990","hard believe",0.0528583161148729,26,6,20,5.51576209416782,20.4842379058322
"1990","now now now",0.0528583161148729,26,6,20,5.51576209416782,20.4842379058322
"1990","things like",0.0528583161148729,26,6,20,5.51576209416782,20.4842379058322
"1990","woods",0.0528583161148729,26,6,20,5.51576209416782,20.4842379058322
"1990","wrong im",0.0528583161148729,26,6,20,5.51576209416782,20.4842379058322
"1990","youre perfect",0.0528583161148729,26,6,20,5.51576209416782,20.4842379058322
"2010","can never",0.0527472323442735,67,11,56,10.3155025065566,56.6844974934434
"1960","ten",0.0520997004938195,156,10,146,9.31683064928833,146.683169350712
"2010","make",0.0520864917089767,5520,856,4664,849.874236361079,4670.12576363892
"2000","long youre",0.0517610848171557,53,15,38,14.2615414222605,38.7384585777395
"2000","tell feel",0.0517610848171557,53,15,38,14.2615414222605,38.7384585777395
"2010","hear voice",0.0509151864898931,42,7,35,6.46643440709516,35.5335655929048
"2010","problems",0.0506723098764832,86,14,72,13.2407942621472,72.7592057378528
"2000","music",0.05047611531218,700,191,509,188.359981048724,511.640018951276
"2010","dont say",0.050466653672073,124,20,104,19.0913777733286,104.908622226671
"2010","spent",0.050466653672073,124,20,104,19.0913777733286,104.908622226671
"1980","meant",0.0502612335538846,318,55,263,53.4989613906578,264.501038609342
"2010","fast",0.0501802098340645,341,54,287,52.5012888766536,288.498711123346
"2010","seven",0.0501484420441065,105,17,88,16.1660860177379,88.8339139822621
"1980","dreamed",0.0498146294647699,73,13,60,12.2812081179812,60.7187918820188
"1980","moved",0.0498146294647699,73,13,60,12.2812081179812,60.7187918820188
"1960","dont say",0.0495018931566249,124,8,116,7.40568590071637,116.594314099284
"1960","respect",0.0495018931566249,124,8,116,7.40568590071637,116.594314099284
"1990","just turn",0.0492473115423686,58,13,45,12.3043923639128,45.6956076360872
"2000","alone dont",0.0485892682309839,35,10,25,9.41799905243618,25.5820009475638
"2000","babyyou",0.0485892682309839,35,10,25,9.41799905243618,25.5820009475638
"2000","can touch",0.0485892682309839,35,10,25,9.41799905243618,25.5820009475638
"2000","im running",0.0485892682309839,35,10,25,9.41799905243618,25.5820009475638
"2000","love deep",0.0485892682309839,35,10,25,9.41799905243618,25.5820009475638
"2000","right side",0.0485892682309839,35,10,25,9.41799905243618,25.5820009475638
"1960","can hear",0.0485838875379223,108,7,101,6.45011352643039,101.54988647357
"1980","attitude",0.0485646744596904,50,9,41,8.4117863821789,41.5882136178211
"1980","flight",0.0485646744596904,50,9,41,8.4117863821789,41.5882136178211
"1980","forward",0.0485646744596904,50,9,41,8.4117863821789,41.5882136178211
"1980","go take",0.0485646744596904,50,9,41,8.4117863821789,41.5882136178211
"1980","im really",0.0485646744596904,50,9,41,8.4117863821789,41.5882136178211
"1980","man dont",0.0485646744596904,50,9,41,8.4117863821789,41.5882136178211
"1980","ship",0.0485646744596904,50,9,41,8.4117863821789,41.5882136178211
"1980","whats going",0.0485646744596904,50,9,41,8.4117863821789,41.5882136178211
"1960","get floor",0.0480941649859201,92,6,86,5.4945411521444,86.5054588478556
"1960","nobody else",0.0480941649859201,92,6,86,5.4945411521444,86.5054588478556
"1960","say youre",0.0480941649859201,92,6,86,5.4945411521444,86.5054588478556
"1960","tender",0.0480941649859201,92,6,86,5.4945411521444,86.5054588478556
"1990","changed",0.0478186092526829,155,34,121,32.8824278690774,122.117572130923
"1990","even though",0.0478186092526829,155,34,121,32.8824278690774,122.117572130923
"2000","cant find",0.047704026322767,64,18,46,17.2214839815976,46.7785160184024
"2000","dont even know",0.047704026322767,64,18,46,17.2214839815976,46.7785160184024
"1970","baby lets",0.047284280153516,104,15,89,14.2321807516822,89.7678192483178
"2010","gonna tell",0.0457697309853928,61,10,51,9.39172616268583,51.6082738373142
"2010","see get",0.0457697309853928,61,10,51,9.39172616268583,51.6082738373142
"2010","store",0.0457697309853928,61,10,51,9.39172616268583,51.6082738373142
"1970","see face",0.0452850731235261,97,14,83,13.2742455087805,83.7257544912195
"1980","cause cant",0.0451018246052379,108,19,89,18.1694585855064,89.8305414144936
"2010","really want",0.0450081878456579,188,30,158,28.9449921079498,159.05500789205
"1990","fuckin",0.0450028307780004,183,40,143,38.8224793551043,144.177520644896
"1980","fighting",0.0448922350007455,79,14,65,13.2906224838427,65.7093775161573
"2010","ill tell",0.0445290167670982,118,19,99,18.1676014294578,99.8323985705422
"1990","got keep",0.0440656272402262,49,11,38,10.3950901005471,38.604909899453
"1990","keepin",0.0440656272402262,49,11,38,10.3950901005471,38.604909899453
"1970","wont",0.0439576422428498,2313,320,1993,316.529173833086,1996.47082616691
"2010","want see",0.0439305038421614,99,16,83,15.2423096738672,83.7576903261328
"2010","called love",0.0436415884198993,36,6,30,5.54265806322443,30.4573419367756
"2010","dey",0.0436415884198993,36,6,30,5.54265806322443,30.4573419367756
"2010","gonna keep",0.0436415884198993,36,6,30,5.54265806322443,30.4573419367756
"2010","gonna say",0.0436415884198993,36,6,30,5.54265806322443,30.4573419367756
"2010","got give",0.0436415884198993,36,6,30,5.54265806322443,30.4573419367756
"2010","granted",0.0436415884198993,36,6,30,5.54265806322443,30.4573419367756
"2010","orleans",0.0436415884198993,36,6,30,5.54265806322443,30.4573419367756
"2010","showing",0.0436415884198993,36,6,30,5.54265806322443,30.4573419367756
"2010","strike",0.0436415884198993,36,6,30,5.54265806322443,30.4573419367756
"2010","theres one thing",0.0436415884198993,36,6,30,5.54265806322443,30.4573419367756
"2010","touch like",0.0436415884198993,36,6,30,5.54265806322443,30.4573419367756
"1990","see just",0.0432550179864404,72,16,56,15.2744181069263,56.7255818930737
"1990","just",0.0428939387756877,9577,2040,7537,2031.70975291712,7545.29024708287
"1980","dont know just",0.0426101052953685,33,6,27,5.55177901223807,27.4482209877619
"1980","girl now",0.0426101052953685,33,6,27,5.55177901223807,27.4482209877619
"1980","go youre",0.0426101052953685,33,6,27,5.55177901223807,27.4482209877619
"1980","press",0.0426101052953685,33,6,27,5.55177901223807,27.4482209877619
"1980","shoe",0.0426101052953685,33,6,27,5.55177901223807,27.4482209877619
"2000","come back",0.0424887815969903,240,66,174,64.5805649309909,175.419435069009
"2000","passing",0.0423315290215593,46,13,33,12.3779416117733,33.6220583882267
"2000","say just",0.0423315290215593,46,13,33,12.3779416117733,33.6220583882267
"2000","want hold",0.0423315290215593,46,13,33,12.3779416117733,33.6220583882267
"2000","way go",0.0423315290215593,46,13,33,12.3779416117733,33.6220583882267
"2000","yeah like",0.0423315290215593,46,13,33,12.3779416117733,33.6220583882267
"2000","youve done",0.0423315290215593,46,13,33,12.3779416117733,33.6220583882267
"1990","going",0.0421315928262969,1104,237,867,234.207744306203,869.792255693797
"1980","can still",0.0420746626622943,56,10,46,9.42120074804036,46.5787992519596
"1980","cause thats",0.0420746626622943,56,10,46,9.42120074804036,46.5787992519596
"1980","truly",0.0420746626622943,56,10,46,9.42120074804036,46.5787992519596
"1990","bang",0.0418798828731495,239,52,187,50.7025823271581,188.297417672842
"1980","nothing can",0.0417959704187019,114,20,94,19.1788729513679,94.8211270486321
"2000","knew",0.0414009371518889,712,194,518,191.589009295273,520.410990704727
"1970","makes feel",0.0413446661517092,83,12,71,11.3583750229771,71.6416249770229
"2000","dont understand",0.0412104837028793,108,30,78,29.0612542189459,78.9387457810541
"1980","make feel like",0.0406692584051014,85,15,70,14.3000368497041,70.6999631502959
"1970","someone",0.0405610526510332,862,120,742,117.96288276875,744.03711723125
"2010","dog",0.040012962346164,131,21,110,20.1691168411778,110.830883158822
"1990","makes",0.0399458665566179,739,159,580,156.774930291924,582.225069708076
"1980","two",0.0394926652246985,967,165,802,162.68394863134,804.31605136866
"2010","im still",0.0393602939622073,214,34,180,32.9480229313897,181.05197706861
"1990","back just",0.0389849820421995,40,9,31,8.48578783718126,31.5142121628187
"1990","cause ill",0.0389849820421995,40,9,31,8.48578783718126,31.5142121628187
"1990","drop like hot",0.0389849820421995,40,9,31,8.48578783718126,31.5142121628187
"1990","get around",0.0389849820421995,40,9,31,8.48578783718126,31.5142121628187
"2000","baby youll",0.0388714145847872,28,8,20,7.53439924194894,20.4656007580511
"2000","cause heart",0.0388714145847872,28,8,20,7.53439924194894,20.4656007580511
"2000","dont seem",0.0388714145847872,28,8,20,7.53439924194894,20.4656007580511
"2000","heart tell",0.0388714145847872,28,8,20,7.53439924194894,20.4656007580511
"2000","just cant get enough",0.0388714145847872,28,8,20,7.53439924194894,20.4656007580511
"2000","love said",0.0388714145847872,28,8,20,7.53439924194894,20.4656007580511
"2000","nonstop",0.0388714145847872,28,8,20,7.53439924194894,20.4656007580511
"2010","love say",0.0388571513784759,55,9,46,8.4679498188151,46.5320501811849
"2010","threw",0.0388571513784759,55,9,46,8.4679498188151,46.5320501811849
"1980","one else",0.0388269714370628,120,21,99,20.1882873172294,99.8117126827707
"2000","hardly",0.0387588895498163,57,16,41,15.3378841711103,41.6621158288897
"2000","love aint",0.0387588895498163,57,16,41,15.3378841711103,41.6621158288897
"1990","lets go",0.0387012396262305,202,44,158,42.8532285777654,159.146771422235
"2010","baby baby",0.0383260087484216,786,123,663,121.014701047067,664.985298952933
"1960","things",0.0380657479905713,1560,95,1465,93.1683064928833,1466.83169350712
"2010","low low",0.0376542352955669,74,12,62,11.3932415744058,62.6067584255942
"2010","meyou",0.0376542352955669,74,12,62,11.3932415744058,62.6067584255942
"1970","ill ever",0.0375206782330464,69,10,59,9.44250453717376,59.5574954628262
"1970","oh got",0.0375206782330464,69,10,59,9.44250453717376,59.5574954628262
"1970","must",0.0372246843384052,696,97,599,95.2461327227962,600.753867277204
"1960","everythings",0.0371264198674687,93,6,87,5.55426442553728,87.4457355744627
"1960","thats just",0.0371264198674687,93,6,87,5.55426442553728,87.4457355744627
"2010","gotta get",0.0370178016777087,227,36,191,34.9495383431096,192.05046165689
"1980","ohi",0.0368408146276382,62,11,51,10.4306151139018,51.5693848860982
"1990","letting",0.0365924373935558,100,22,78,21.2144695929532,78.7855304070468
"1960","singing",0.0365321931128511,223,14,209,13.3182899666109,209.681710033389
"2010","save",0.0358346634344864,304,48,256,46.8046680894507,257.195331910549
"1970","got much",0.0356768780299608,62,9,53,8.48456929427207,53.5154307057279
"2000","waited",0.0352010044408237,79,22,57,21.2577692897845,57.7422307102155
"2000","can say",0.034969790472037,189,52,137,50.8571948831554,138.142805116845
"1980","fortune",0.03467656760935,39,7,32,6.56119337809954,32.4388066219005
"1980","loveyou",0.03467656760935,39,7,32,6.56119337809954,32.4388066219005
"1980","nervous",0.03467656760935,39,7,32,6.56119337809954,32.4388066219005
"1980","never come",0.03467656760935,39,7,32,6.56119337809954,32.4388066219005
"1980","wash away",0.03467656760935,39,7,32,6.56119337809954,32.4388066219005
"2000","awake",0.0343420697524395,90,25,65,24.2177118491216,65.7822881508784
"1990","came life",0.0340930461367027,31,7,24,6.57648557381548,24.4235144261845
"1990","credit",0.0340930461367027,31,7,24,6.57648557381548,24.4235144261845
"1990","life time",0.0340930461367027,31,7,24,6.57648557381548,24.4235144261845
"1990","listen baby",0.0340930461367027,31,7,24,6.57648557381548,24.4235144261845
"1990","see tonight",0.0340930461367027,31,7,24,6.57648557381548,24.4235144261845
"1990","take love",0.0340930461367027,31,7,24,6.57648557381548,24.4235144261845
"1990","thats real",0.0340930461367027,31,7,24,6.57648557381548,24.4235144261845
"1990","thing baby",0.0340930461367027,31,7,24,6.57648557381548,24.4235144261845
"1990","together forever",0.0340930461367027,31,7,24,6.57648557381548,24.4235144261845
"1990","want cant",0.0340930461367027,31,7,24,6.57648557381548,24.4235144261845
"1990","fucked",0.0340139417891863,77,17,60,16.3351415865739,60.6648584134261
"2000","ten",0.0339122323269998,156,43,113,41.9773672051441,114.022632794856
"1970","cure",0.0339015702409694,55,8,47,7.52663405137039,47.4733659486296
"1980","lift",0.0338090231629775,97,17,80,16.3188655814271,80.6811344185729
"2010","burnin",0.0332045624599746,157,25,132,24.1721476646176,132.827852335382
"2010","aint nothing",0.0331122052331498,106,17,89,16.3200487417164,89.6799512582836
"2000","hooked",0.0330057346539987,39,11,28,10.494341801286,28.505658198714
"2000","loveyou",0.0330057346539987,39,11,28,10.494341801286,28.505658198714
"2000","never come",0.0330057346539987,39,11,28,10.494341801286,28.505658198714
"2000","order",0.0330057346539987,39,11,28,10.494341801286,28.505658198714
"2000","wanna just",0.0330057346539987,39,11,28,10.494341801286,28.505658198714
"2000","guess",0.0325416675555581,484,132,352,130.237472610832,353.762527389168
"1980","change mind",0.0325354067240631,68,12,56,11.4400294797633,56.5599705202367
"1980","changes",0.0325354067240631,68,12,56,11.4400294797633,56.5599705202367
"1980","wasted",0.0325354067240631,68,12,56,11.4400294797633,56.5599705202367
"1990","youre love",0.0324412634898397,54,12,42,11.4558135801947,42.5441864198053
"1960","gun",0.0322508819148131,191,12,179,11.4071452180389,179.592854781961
"1970","peace mind",0.0322245507054211,48,7,41,6.5686988084687,41.4313011915313
"1970","situation",0.0322245507054211,48,7,41,6.5686988084687,41.4313011915313
"1960","lost",0.0321675787126847,635,39,596,37.924278604475,597.075721395525
"2010","jealous",0.0320334752251461,49,8,41,7.54417347494436,41.4558265250556
"2010","forgot",0.0319356066461927,87,14,73,13.3947569861257,73.6052430138743
"2010","toes",0.0319356066461927,87,14,73,13.3947569861257,73.6052430138743
"2000","standing",0.0319183766929405,307,84,223,82.6093059742259,224.390694025774
"2010","sleep",0.0313876154469983,433,68,365,66.6658594826716,366.334140517328
"2010","bad bad",0.0313492152960164,68,11,57,10.469465230535,57.530534769465
"2000","chance",0.031019281958335,510,139,371,137.233700478356,372.766299521644
"1970","blew",0.030695829723124,41,6,35,5.61076356556702,35.389236434433
"1970","players",0.030695829723124,41,6,35,5.61076356556702,35.389236434433
"1970","world will",0.030695829723124,41,6,35,5.61076356556702,35.389236434433
"2010","let",0.0304704521379513,4927,763,4164,758.574341041854,4168.42565895815
"1960","chorus",0.0303187273832393,224,14,210,13.3780132400038,210.621986759996
"1970","treat",0.0300935440607888,321,45,276,43.9281732816344,277.071826718366
"2000","back dont",0.0300310026750574,50,14,36,13.4542843606231,36.5457156393769
"2000","flight",0.0300310026750574,50,14,36,13.4542843606231,36.5457156393769
"2000","man dont",0.0300310026750574,50,14,36,13.4542843606231,36.5457156393769
"1990","nana",0.0297017350724758,105,23,82,22.2751930726008,82.7248069273992
"1990","seven",0.0297017350724758,105,23,82,22.2751930726008,82.7248069273992
"1960","dont know im",0.0293998735473588,110,7,103,6.56956007321613,103.430439926784
"1960","love youre",0.0293998735473588,110,7,103,6.56956007321613,103.430439926784
"1960","snow",0.0293998735473588,110,7,103,6.56956007321613,103.430439926784
"1990","come back",0.0292114829475962,240,52,188,50.9147270230876,189.085272976912
"2000","come talk",0.0291535609385928,21,6,15,5.65079943146171,15.3492005685383
"2000","county",0.0291535609385928,21,6,15,5.65079943146171,15.3492005685383
"2000","day know",0.0291535609385928,21,6,15,5.65079943146171,15.3492005685383
"2000","dont think youre",0.0291535609385928,21,6,15,5.65079943146171,15.3492005685383
"2000","ever wanna",0.0291535609385928,21,6,15,5.65079943146171,15.3492005685383
"2000","eyes still",0.0291535609385928,21,6,15,5.65079943146171,15.3492005685383
"2000","falter",0.0291535609385928,21,6,15,5.65079943146171,15.3492005685383
"2000","finer",0.0291535609385928,21,6,15,5.65079943146171,15.3492005685383
"2000","first love",0.0291535609385928,21,6,15,5.65079943146171,15.3492005685383
"2000","form",0.0291535609385928,21,6,15,5.65079943146171,15.3492005685383
"2000","haha",0.0291535609385928,21,6,15,5.65079943146171,15.3492005685383
"2000","home let",0.0291535609385928,21,6,15,5.65079943146171,15.3492005685383
"2000","ive trying",0.0291535609385928,21,6,15,5.65079943146171,15.3492005685383
"2000","just man",0.0291535609385928,21,6,15,5.65079943146171,15.3492005685383
"2000","kinds",0.0291535609385928,21,6,15,5.65079943146171,15.3492005685383
"2000","love look",0.0291535609385928,21,6,15,5.65079943146171,15.3492005685383
"2000","make break",0.0291535609385928,21,6,15,5.65079943146171,15.3492005685383
"2000","man get",0.0291535609385928,21,6,15,5.65079943146171,15.3492005685383
"2000","music just",0.0291535609385928,21,6,15,5.65079943146171,15.3492005685383
"2000","never lie",0.0291535609385928,21,6,15,5.65079943146171,15.3492005685383
"2000","now shake",0.0291535609385928,21,6,15,5.65079943146171,15.3492005685383
"2000","rabbit",0.0291535609385928,21,6,15,5.65079943146171,15.3492005685383
"2000","reflection",0.0291535609385928,21,6,15,5.65079943146171,15.3492005685383
"2000","searched",0.0291535609385928,21,6,15,5.65079943146171,15.3492005685383
"2000","special way",0.0291535609385928,21,6,15,5.65079943146171,15.3492005685383
"2000","step right",0.0291535609385928,21,6,15,5.65079943146171,15.3492005685383
"2000","strung",0.0291535609385928,21,6,15,5.65079943146171,15.3492005685383
"2000","tea",0.0291535609385928,21,6,15,5.65079943146171,15.3492005685383
"2000","will one",0.0291535609385928,21,6,15,5.65079943146171,15.3492005685383
"2000","youwhat",0.0291535609385928,21,6,15,5.65079943146171,15.3492005685383
"1960","might",0.0290429543071644,702,43,659,41.9257379217975,660.074262078203
"1980","baby take",0.0288515556383436,45,8,37,7.57060774396101,37.429392256039
"1980","company",0.0288515556383436,45,8,37,7.57060774396101,37.429392256039
"1980","day every",0.0288515556383436,45,8,37,7.57060774396101,37.429392256039
"1980","matter say",0.0288515556383436,45,8,37,7.57060774396101,37.429392256039
"1980","saturday night",0.0288515556383436,45,8,37,7.57060774396101,37.429392256039
"1980","wanna one",0.0288515556383436,45,8,37,7.57060774396101,37.429392256039
"1990","beats",0.0287302480476781,68,15,53,14.4258393232082,53.5741606767919
"1990","change mind",0.0287302480476781,68,15,53,14.4258393232082,53.5741606767919
"1990","turn turn",0.0287302480476781,68,15,53,14.4258393232082,53.5741606767919
"2000","got bad",0.0283899870285185,61,17,44,16.4142269199602,44.5857730800398
"1960","loving",0.0283226497917066,504,31,473,30.1005297900085,473.899470209992
"1960","use",0.0280728845639182,290,18,272,17.3197492839334,272.680250716067
"2000","asleep",0.0274736558019193,72,20,52,19.3741694792973,52.6258305207027
"2000","lovely",0.0271855704442765,127,35,92,34.1738822759827,92.8261177240173
"1990","baby ive",0.0270343862415453,45,10,35,9.54651131682892,35.4534886831711
"1990","dont wanna go",0.0270343862415453,45,10,35,9.54651131682892,35.4534886831711
"1990","raw",0.0270343862415453,45,10,35,9.54651131682892,35.4534886831711
"1990","runaway",0.0270343862415453,45,10,35,9.54651131682892,35.4534886831711
"1990","will take",0.0270343862415453,45,10,35,9.54651131682892,35.4534886831711
"2000","touched",0.0269948106751956,83,23,60,22.3341120386344,60.6658879613656
"2000","trees",0.0269948106751956,83,23,60,22.3341120386344,60.6658879613656
"2000","keeping",0.0268003058559754,94,26,68,25.2940545979715,68.7059454020285
"1970","took",0.0266703809315967,553,77,476,75.6768841892331,477.323115810767
"1990","now cant",0.026409206059832,82,18,64,17.3958650662216,64.6041349337784
"1990","yeah oh yeah",0.026409206059832,82,18,64,17.3958650662216,64.6041349337784
"2010","teach",0.0262246522011511,81,13,68,12.470980642255,68.529019357745
"1980","california",0.0258846476247288,80,14,66,13.4588582114862,66.5411417885138
"1990","looked",0.0256110287820672,203,44,159,43.0653732736949,159.934626726305
"1990","glad",0.0255246708726162,217,47,170,46.0353990167084,170.964600983292
"2010","cause every",0.0253361549382416,43,7,36,6.62039713107362,36.3796028689264
"2010","god knows",0.0253361549382416,43,7,36,6.62039713107362,36.3796028689264
"2010","onto",0.0253361549382416,43,7,36,6.62039713107362,36.3796028689264
"2010","sending",0.0253361549382416,43,7,36,6.62039713107362,36.3796028689264
"2010","washed",0.0253361549382416,43,7,36,6.62039713107362,36.3796028689264
"2010","yeah well",0.0253361549382416,43,7,36,6.62039713107362,36.3796028689264
"1990","im looking",0.0248729767936648,96,21,75,20.365890809235,75.634109190765
"1970","dark",0.0244165512910994,329,46,283,45.0229564163792,283.977043583621
"1980","bedroom",0.0244015550430514,51,9,42,8.58002210982247,42.4199778901775
"1980","cherry",0.0244015550430514,51,9,42,8.58002210982247,42.4199778901775
"1980","got want",0.0244015550430514,51,9,42,8.58002210982247,42.4199778901775
"1980","love cause",0.0244015550430514,51,9,42,8.58002210982247,42.4199778901775
"1980","uh huh uh huh",0.0244015550430514,51,9,42,8.58002210982247,42.4199778901775
"2000","baby night",0.0238520131613835,32,9,23,8.61074199079879,23.3892580092012
"2000","can move",0.0238520131613835,32,9,23,8.61074199079879,23.3892580092012
"2000","help im",0.0238520131613835,32,9,23,8.61074199079879,23.3892580092012
"2000","losin",0.0238520131613835,32,9,23,8.61074199079879,23.3892580092012
"2000","pulling",0.0238520131613835,32,9,23,8.61074199079879,23.3892580092012
"2000","stones",0.0238520131613835,32,9,23,8.61074199079879,23.3892580092012
"2000","want youre",0.0238520131613835,32,9,23,8.61074199079879,23.3892580092012
"1990","instead",0.0238231824514836,110,24,86,23.3359165522485,86.6640834477515
"1960","clean",0.0238218572296879,176,11,165,10.5112961171458,165.488703882854
"1990","wind",0.0235909746163907,348,75,273,73.826354183477,274.173645816523
"1990","found love",0.0234842122426832,59,13,46,12.5165370598424,46.4834629401576
"1990","give damn",0.0234842122426832,59,13,46,12.5165370598424,46.4834629401576
"1990","spit",0.0234842122426832,59,13,46,12.5165370598424,46.4834629401576
"1990","thinks",0.0234842122426832,59,13,46,12.5165370598424,46.4834629401576
"1990","view",0.0234842122426832,59,13,46,12.5165370598424,46.4834629401576
"1990","dont leave",0.0230956890096516,124,27,97,26.3059422952619,97.6940577047381
"1990","spent",0.0230956890096516,124,27,97,26.3059422952619,97.6940577047381
"2000","break",0.0229834474507191,977,265,712,262.896716406576,714.103283593424
"2000","cool",0.0229092859792552,389,106,283,104.674332325648,284.325667674352
"1990","heres",0.0225927410315034,138,30,108,29.2759680382754,108.724031961725
"2010","talkin bout",0.0225040939228289,94,15,79,14.4724960539749,79.5275039460251
"1960","good times",0.0216732167107834,111,7,104,6.62928334660901,104.370716653391
"1960","one two",0.0216732167107834,111,7,104,6.62928334660901,104.370716653391
"1960","small",0.0216732167107834,111,7,104,6.62928334660901,104.370716653391
"1960","wonderful",0.0216732167107834,111,7,104,6.62928334660901,104.370716653391
"1990","boy im",0.0216275089932202,36,8,28,7.63720905346314,28.3627909465369
"1990","laying",0.0216275089932202,36,8,28,7.63720905346314,28.3627909465369
"1990","let make",0.0216275089932202,36,8,28,7.63720905346314,28.3627909465369
"1990","nuttin",0.0216275089932202,36,8,28,7.63720905346314,28.3627909465369
"1990","packed",0.0216275089932202,36,8,28,7.63720905346314,28.3627909465369
"1990","showing",0.0216275089932202,36,8,28,7.63720905346314,28.3627909465369
"1990","talk like",0.0216275089932202,36,8,28,7.63720905346314,28.3627909465369
"1990","well go",0.0216275089932202,36,8,28,7.63720905346314,28.3627909465369
"1990","well well well",0.0216275089932202,36,8,28,7.63720905346314,28.3627909465369
"2000","conversation",0.0216269769274089,43,12,31,11.5706845501359,31.4293154498641
"2000","dinner",0.0216269769274089,43,12,31,11.5706845501359,31.4293154498641
"1990","moved",0.0214345799579696,73,16,57,15.4865628028558,57.5134371971442
"1990","trippin",0.0214345799579696,73,16,57,15.4865628028558,57.5134371971442
"1990","two",0.0212683795278696,967,207,760,205.143920963857,761.856079036143
"2000","wow",0.0212443907984952,120,33,87,32.2902824654955,87.7097175345045
"1970","lives",0.0211966923292117,185,26,159,25.3168599909731,159.683140009027
"2000","finally",0.0210472248753377,201,55,146,54.0862231297049,146.913776870295
"1980","coast",0.0210043422067705,92,16,76,15.4776869432092,76.5223130567908
"1980","im coming",0.0210043422067705,92,16,76,15.4776869432092,76.5223130567908
"1980","pour",0.0210043422067705,92,16,76,15.4776869432092,76.5223130567908
"1980","say youre",0.0210043422067705,92,16,76,15.4776869432092,76.5223130567908
"1980","just cant stop",0.0208979852093509,57,10,47,9.58943647568394,47.4105635243161
"1980","love wanna",0.0208979852093509,57,10,47,9.58943647568394,47.4105635243161
"1980","plain",0.0208979852093509,57,10,47,9.58943647568394,47.4105635243161
"1980","uh huh uh",0.0208979852093509,57,10,47,9.58943647568394,47.4105635243161
"2010","hush",0.0207664965186907,75,12,63,11.5472042983842,63.4527957016158
"2000","baby will",0.0206052418514396,54,15,39,14.530627109473,39.469372890527
"2000","long im",0.0206052418514396,54,15,39,14.530627109473,39.469372890527
"2000","one chance",0.0206052418514396,54,15,39,14.530627109473,39.469372890527
"2000","wanna rock",0.0202061338462531,87,24,63,23.4104547874842,63.5895452125158
"2000","youre going",0.0202061338462531,87,24,63,23.4104547874842,63.5895452125158
"2000","stranger",0.020177784220613,65,18,47,17.49056966881,47.50943033119
"1990","tongue",0.0201643298794763,87,19,68,18.4565885458693,68.5434114541307
"1990","living",0.0201416512532853,517,111,406,109.678807795568,407.321192204432
"1960","plans",0.019608136832608,95,6,89,5.67371097232302,89.326289027677
"1960","together",0.019463832426529,954,58,896,56.9760028168017,897.023997183198
"1970","rather",0.0194042968171391,178,25,153,24.3589247480714,153.641075251929
"1970","just way",0.0193171168399427,106,15,91,14.5058765353684,91.4941234646316
"1970","ocean",0.0193171168399427,106,15,91,14.5058765353684,91.4941234646316
"1970","last forever",0.0190279873515766,63,9,54,8.62141718611517,54.3785828138848
"1980","come take",0.0190269521014619,98,17,81,16.4871013090706,81.5128986909294
"2000","shes got",0.018991104539118,168,46,122,45.2063954516937,122.793604548306
"1990","shed",0.0188272841929396,115,25,90,24.3966400318961,90.6033599681039
"2010","aint seen",0.0188271176477834,37,6,31,5.69662078720288,31.3033792127971
"2010","boyz",0.0188271176477834,37,6,31,5.69662078720288,31.3033792127971
"2010","finish",0.0188271176477834,37,6,31,5.69662078720288,31.3033792127971
"2010","know act",0.0188271176477834,37,6,31,5.69662078720288,31.3033792127971
"2010","theres many",0.0188271176477834,37,6,31,5.69662078720288,31.3033792127971
"2010","theres nothin",0.0188271176477834,37,6,31,5.69662078720288,31.3033792127971
"2010","hood",0.0186577906869239,184,29,155,28.329141212036,155.670858787964
"1980","learn",0.0186425730673896,239,41,198,40.2083389068151,198.791661093185
"1990","please",0.0185104100217486,1038,222,816,220.206194374854,817.793805625146
"1990","proud",0.018311540110318,143,31,112,30.336691517923,112.663308482077
"1990","right baby",0.0182962186967779,50,11,39,10.6072347964766,39.3927652035234
"1990","whoa whoa whoa whoa",0.0182962186967779,50,11,39,10.6072347964766,39.3927652035234
"2000","tried",0.0182948000608802,408,111,297,109.786960382685,298.213039617315
"1980","cant say",0.0180736390733974,63,11,52,10.5988508415454,52.4011491584546
"2010","hop",0.017463633680149,120,19,101,18.4755268774148,101.524473122585
"1960","wings",0.0173249870761634,128,8,120,7.64457899428786,120.355421005712
"1970","want see",0.017314678542848,99,14,85,13.5479412924667,85.4520587075333
"1980","quite",0.0172875677991222,104,18,86,17.4965156749321,86.5034843250679
"1970","long way",0.0169137665347207,56,8,48,7.66348194321348,48.3365180567865
"1980","land",0.016730185542303,151,26,125,25.4035948741803,125.59640512582
"1960","dreams",0.0166971794427686,640,39,601,38.2228949714393,601.777105028561
"1990","didnt want",0.0165819845291039,64,14,50,13.57726053949,50.42273946051
"1990","never seen",0.0165819845291039,64,14,50,13.57726053949,50.42273946051
"1990","just little",0.0165568679894419,274,59,215,58.1276466846917,215.872353315308
"2000","part",0.0165142745585913,338,92,246,90.9509622778123,247.049037722188
"2010","girl dont",0.0164311757617082,165,26,139,25.4038494564453,139.596150543555
"1980","baby im gonna",0.0162677033620315,34,6,28,5.72001473988165,28.2799852601184
"1980","deep heart",0.0162677033620315,34,6,28,5.72001473988165,28.2799852601184
"1980","know feels",0.0162677033620315,34,6,28,5.72001473988165,28.2799852601184
"1980","marvin",0.0162677033620315,34,6,28,5.72001473988165,28.2799852601184
"1980","need dont",0.0162677033620315,34,6,28,5.72001473988165,28.2799852601184
"1980","nowi",0.0162677033620315,34,6,28,5.72001473988165,28.2799852601184
"1980","path",0.0162677033620315,34,6,28,5.72001473988165,28.2799852601184
"1980","right now im",0.0162677033620315,34,6,28,5.72001473988165,28.2799852601184
"1980","think twice",0.0162677033620315,34,6,28,5.72001473988165,28.2799852601184
"1980","us apart",0.0162677033620315,34,6,28,5.72001473988165,28.2799852601184
"1990","around like",0.0162206317449198,27,6,21,5.72790679009735,21.2720932099026
"1990","dont keep",0.0162206317449198,27,6,21,5.72790679009735,21.2720932099026
"1990","ever know",0.0162206317449198,27,6,21,5.72790679009735,21.2720932099026
"1990","fifteen",0.0162206317449198,27,6,21,5.72790679009735,21.2720932099026
"1990","girl dont know",0.0162206317449198,27,6,21,5.72790679009735,21.2720932099026
"1990","oh ohi",0.0162206317449198,27,6,21,5.72790679009735,21.2720932099026
"1990","video",0.0162206317449198,27,6,21,5.72790679009735,21.2720932099026
"1990","wanna talk",0.0162206317449198,27,6,21,5.72790679009735,21.2720932099026
"2000","la la la",0.0161251820408355,1245,337,908,335.011680579516,909.988319420485
"2010","ima",0.0159516131595163,371,58,313,57.1201705960073,313.879829403993
"1970","momma",0.0159023506422251,164,23,141,22.4430542622681,141.556945737732
"2000","oh im",0.0157750623920927,113,31,82,30.4066826550082,82.5933173449918
"1980","spell",0.0157532566550906,69,12,57,11.6082652074069,57.3917347925931
"1980","wanna hear",0.0157532566550906,69,12,57,11.6082652074069,57.3917347925931
"2010","dont forget",0.0156278927814993,69,11,58,10.6234279545135,58.3765720454865
"2010","know cause",0.0156278927814993,69,11,58,10.6234279545135,58.3765720454865
"2010","oh got",0.0156278927814993,69,11,58,10.6234279545135,58.3765720454865
"2010","wanna hear",0.0156278927814993,69,11,58,10.6234279545135,58.3765720454865
"1990","filled",0.0156175666947209,78,17,61,16.5472862825035,61.4527137174965
"1990","oh can",0.0156175666947209,78,17,61,16.5472862825035,61.4527137174965
"1990","youre feeling",0.0156175666947209,78,17,61,16.5472862825035,61.4527137174965
"1960","time time",0.0155366263277807,194,12,182,11.5863150382175,182.413684961782
"2010","aint got",0.0155259239869097,268,42,226,41.2620100262263,226.737989973774
"1990","walked",0.015478118732513,218,47,171,46.2475437126379,171.752456287362
"2010","back back",0.0152565730967105,101,16,85,15.5502351218241,85.4497648781759
"2010","job",0.0152565730967105,101,16,85,15.5502351218241,85.4497648781759
"1960","anymore",0.0152280549710272,227,14,213,13.5571830601824,213.442816939818
"1960","plan",0.0151593636916196,112,7,105,6.68900662000188,105.310993379998
"2000","aint one",0.0150155013375287,25,7,18,6.72714218031156,18.2728578196884
"2000","average",0.0150155013375287,25,7,18,6.72714218031156,18.2728578196884
"2000","dont fuck",0.0150155013375287,25,7,18,6.72714218031156,18.2728578196884
"2000","going way",0.0150155013375287,25,7,18,6.72714218031156,18.2728578196884
"2000","im tellin",0.0150155013375287,25,7,18,6.72714218031156,18.2728578196884
"2000","ive thinking",0.0150155013375287,25,7,18,6.72714218031156,18.2728578196884
"2000","just put",0.0150155013375287,25,7,18,6.72714218031156,18.2728578196884
"2000","like baby baby",0.0150155013375287,25,7,18,6.72714218031156,18.2728578196884
"2000","make fall",0.0150155013375287,25,7,18,6.72714218031156,18.2728578196884
"2000","time look",0.0150155013375287,25,7,18,6.72714218031156,18.2728578196884
"2000","yeah said",0.0150155013375287,25,7,18,6.72714218031156,18.2728578196884
"1970","guess im",0.01479954571789,49,7,42,6.7055467003118,42.2944532996882
"1990","aint nothing",0.0147533198144987,106,23,83,22.4873377685304,83.5126622314696
"2010","day life",0.0138443310124605,50,8,42,7.69813619892281,42.3018638010772
"2010","ive tried",0.0138443310124605,50,8,42,7.69813619892281,42.3018638010772
"2010","make happen",0.0138443310124605,50,8,42,7.69813619892281,42.3018638010772
"1980","baby want",0.013817104823163,75,13,62,12.6176795732683,62.3823204267317
"2000","ill ever",0.0137542345554295,69,19,50,18.5669124176599,50.4330875823401
"2000","ive waiting",0.0137542345554295,69,19,50,18.5669124176599,50.4330875823401
"2000","tell ya",0.0137542345554295,69,19,50,18.5669124176599,50.4330875823401
"2000","cheap",0.0137368279009596,36,10,26,9.68708473964864,26.3129152603514
"2000","drops",0.0137368279009596,36,10,26,9.68708473964864,26.3129152603514
"2000","gonna say",0.0137368279009596,36,10,26,9.68708473964864,26.3129152603514
"2000","harm",0.0137368279009596,36,10,26,9.68708473964864,26.3129152603514
"2000","showing",0.0137368279009596,36,10,26,9.68708473964864,26.3129152603514
"2000","yeah want",0.0137368279009596,36,10,26,9.68708473964864,26.3129152603514
"1990","times",0.0136738291406346,626,134,492,132.802579651887,493.197420348113
"2010","please dont",0.0135006998470029,249,39,210,38.3367182706356,210.663281729364
"2000","heavy",0.0134707558975183,58,16,42,15.6069698583228,42.3930301416772
"2000","imagine",0.0134707558975183,58,16,42,15.6069698583228,42.3930301416772
"2000","hand hand",0.0134001529279877,47,13,34,12.6470272989857,34.3529727010143
"2000","row",0.0134001529279877,47,13,34,12.6470272989857,34.3529727010143
"1970","ease",0.0133652181247683,85,12,73,11.6320708066633,73.3679291933367
"1990","dont afraid",0.013204603029916,41,9,32,8.6979325331108,32.3020674668892
"1990","grace",0.013204603029916,41,9,32,8.6979325331108,32.3020674668892
"1990","tied",0.013204603029916,41,9,32,8.6979325331108,32.3020674668892
"2010","dad",0.0130646059808047,82,13,69,12.6249433662334,69.3750566337666
"1980","grip",0.0129423238123644,40,7,33,6.72942910574312,33.2705708942569
"1980","know heart",0.0129423238123644,40,7,33,6.72942910574312,33.2705708942569
"1980","love theres",0.0129423238123644,40,7,33,6.72942910574312,33.2705708942569
"1970","easier",0.012685324901051,42,6,36,5.74761145741011,36.2523885425899
"1970","every word",0.012685324901051,42,6,36,5.74761145741011,36.2523885425899
"1970","know let",0.012685324901051,42,6,36,5.74761145741011,36.2523885425899
"1970","leads",0.012685324901051,42,6,36,5.74761145741011,36.2523885425899
"1970","learning",0.012685324901051,42,6,36,5.74761145741011,36.2523885425899
"1970","think ive",0.012685324901051,42,6,36,5.74761145741011,36.2523885425899
"1970","wanna kiss",0.012685324901051,42,6,36,5.74761145741011,36.2523885425899
"1970","way get",0.012685324901051,42,6,36,5.74761145741011,36.2523885425899
"1980","stuck",0.0126852600321063,175,30,145,29.4412523376261,145.558747662374
"1990","wanna get",0.012201671170599,195,42,153,41.3682157062587,153.631784293741
"1980","belongs",0.0121805990122679,81,14,67,13.6270939391298,67.3729060608702
"1980","bodys",0.0121805990122679,81,14,67,13.6270939391298,67.3729060608702
"2000","didnt",0.0120235778382884,868,235,633,233.566376500417,634.433623499583
"2010","happen",0.0119320400529506,172,27,145,26.4815885242945,145.518411475706
"1960","theres one",0.0119281059765314,129,8,121,7.70430226768074,121.295697732319
"1990","can turn",0.0119115912257418,55,12,43,11.6679582761242,43.3320417238758
"1990","closed",0.0119115912257418,55,12,43,11.6679582761242,43.3320417238758
"1990","know make",0.0119115912257418,55,12,43,11.6679582761242,43.3320417238758
"1970","nothing can",0.0117589201264822,114,16,98,15.6006596701132,98.3993403298868
"1960","till",0.0115448825565865,692,42,650,41.3285051878688,650.671494812131
"1970","time come",0.0114281784241774,78,11,67,10.6741355637616,67.3258644362384
"1960","lot",0.0113763828293332,410,25,385,24.4865420910783,385.513457908922
"1990","everytime",0.0112963705157517,69,15,54,14.6379840191377,54.3620159808623
"1990","say want",0.0112963705157517,69,15,54,14.6379840191377,54.3620159808623
"1990","worse",0.0112963705157517,69,15,54,14.6379840191377,54.3620159808623
"1990","happened",0.0110672837819934,125,27,98,26.5180869911915,98.4819130088085
"1990","built",0.0110169400795614,83,18,65,17.6080097621511,65.3919902378489
"2010","brighter",0.0109013688615585,63,10,53,9.69965161064275,53.3003483893573
"1980","aint right",0.0105021711033852,46,8,38,7.73884347160458,38.2611565283954
"1980","im losing",0.0105021711033852,46,8,38,7.73884347160458,38.2611565283954
"1980","let hear say",0.0105021711033852,46,8,38,7.73884347160458,38.2611565283954
"1980","said love",0.0105021711033852,46,8,38,7.73884347160458,38.2611565283954
"1980","take slow",0.0105021711033852,46,8,38,7.73884347160458,38.2611565283954
"1980","tune",0.0105021711033852,46,8,38,7.73884347160458,38.2611565283954
"1980","want want want",0.0105021711033852,46,8,38,7.73884347160458,38.2611565283954
"1980","wont let go",0.0105021711033852,46,8,38,7.73884347160458,38.2611565283954
"2000","school",0.010435579195208,202,55,147,54.3553088169174,147.644691183083
"2000","lucky",0.0101777895291471,95,26,69,25.5631402851839,69.4368597148161
"1970","will come",0.0100311813535964,107,15,92,14.6427244272115,92.3572755727885
"1990","smoke",0.00972389934843787,200,43,157,42.4289391859063,157.571060814094
"2010","hoes",0.00969723521102117,269,42,227,41.4159727502047,227.584027249795
"1970","ba ba",0.00952621435039558,71,10,61,9.71620032085995,61.2837996791401
"1970","ever gonna",0.00952621435039558,71,10,61,9.71620032085995,61.2837996791401
"1960","cant wait",0.00949507618388501,146,9,137,8.71959791535959,137.28040208464
"1970","empty",0.00934998097023632,136,19,117,18.6113132906613,117.388686709339
"2010","dis",0.00880400432111872,44,7,37,6.77435985505208,37.2256401449479
"2010","im gonna get",0.00880400432111872,44,7,37,6.77435985505208,37.2256401449479
"2010","keep coming",0.00880400432111872,44,7,37,6.77435985505208,37.2256401449479
"2010","made love",0.00880400432111872,44,7,37,6.77435985505208,37.2256401449479
"2010","names",0.00880400432111872,44,7,37,6.77435985505208,37.2256401449479
"2010","scene",0.00866309272756782,121,19,102,18.6294896013932,102.370510398607
"1980","advice",0.00864378389956111,52,9,43,8.74825783746605,43.251742162534
"1980","burned",0.00864378389956111,52,9,43,8.74825783746605,43.251742162534
"1980","need oh",0.00864378389956111,52,9,43,8.74825783746605,43.251742162534
"1980","wanna feel",0.00864378389956111,52,9,43,8.74825783746605,43.251742162534
"1980","want take",0.00864378389956111,52,9,43,8.74825783746605,43.251742162534
"1980","yeah can",0.00864378389956111,52,9,43,8.74825783746605,43.251742162534
"1980","pride",0.00858120217888336,152,26,126,25.5718306018238,126.428169398176
"1980","hard",0.00855014104083729,1241,210,1031,208.78053800568,1032.21946199432
"1990","dont really",0.00842703596604311,144,31,113,30.5488362138526,113.451163786147
"1970","love never",0.0083578564695449,100,14,86,13.6847891843098,86.3152108156902
"1970","never know",0.0083578564695449,100,14,86,13.6847891843098,86.3152108156902
"1970","strength",0.0083578564695449,100,14,86,13.6847891843098,86.3152108156902
"1990","come come",0.00835431493776273,369,79,290,78.2813927979972,290.718607202003
"2010","mouth",0.00829261678519611,179,28,151,27.5593275921437,151.440672407856
"1990","brush",0.00829099226455193,32,7,25,6.78863026974501,25.211369730255
"1990","fallen",0.00829099226455193,32,7,25,6.78863026974501,25.211369730255
"1990","get chance",0.00829099226455193,32,7,25,6.78863026974501,25.211369730255
"1990","hey girl",0.00829099226455193,32,7,25,6.78863026974501,25.211369730255
"1990","ive heard",0.00829099226455193,32,7,25,6.78863026974501,25.211369730255
"1990","like dream",0.00829099226455193,32,7,25,6.78863026974501,25.211369730255
"1990","now say",0.00829099226455193,32,7,25,6.78863026974501,25.211369730255
"2000","mile",0.00819205564683201,62,17,45,16.6833126071727,45.3166873928273
"2000","dont stop",0.00784206229000883,317,86,231,85.3001628463505,231.699837153649
"1970","theres one",0.0078419236108499,129,18,111,17.6533780477596,111.34662195224
"2010","im gon",0.00776296199345483,134,21,113,20.6310050131131,113.368994986887
"2010","midnight",0.00776296199345483,134,21,113,20.6310050131131,113.368994986887
"1970","girl oh",0.00767088592351811,64,9,55,8.75826507795827,55.2417349220417
"1970","pulled",0.00767088592351811,64,9,55,8.75826507795827,55.2417349220417
"1990","desire",0.00762363031051605,102,22,80,21.6387589848122,80.3612410151878
"1960","cried",0.00761370508223891,163,10,153,9.73489356303845,153.265106436962
"1980","survive",0.00761115601928319,105,18,87,17.6647514025757,87.3352485974243
"1990","better better",0.0075309136771553,46,10,36,9.75865601275846,36.2413439872415
"1990","im losing",0.0075309136771553,46,10,36,9.75865601275846,36.2413439872415
"2000","instead",0.00739583353537199,110,30,80,29.5994255933708,80.4005744066291
"1990","hah",0.00730554417448925,74,16,58,15.6987074987853,58.3012925012147
"1990","never see",0.00730554417448925,74,16,58,15.6987074987853,58.3012925012147
"1990","gray",0.00730287073689906,60,13,47,12.7286817557719,47.2713182442281
"1990","just give",0.00730287073689906,60,13,47,12.7286817557719,47.2713182442281
"1990","wed",0.00720741407928627,191,41,150,40.5196369225405,150.480363077459
"1990","lets",0.00720602149253047,1662,354,1308,352.584484634882,1309.41551536512
"1980","girl look",0.0071881909757503,58,10,48,9.75767220332752,48.2423277966725
"1980","gotta make",0.0071881909757503,58,10,48,9.75767220332752,48.2423277966725
"2000","back just",0.00708146359949835,40,11,29,10.7634274884985,29.2365725115015
"2000","go love",0.00708146359949835,40,11,29,10.7634274884985,29.2365725115015
"2000","ill let",0.00708146359949835,40,11,29,10.7634274884985,29.2365725115015
"2000","know heart",0.00708146359949835,40,11,29,10.7634274884985,29.2365725115015
"2000","represent",0.00708146359949835,40,11,29,10.7634274884985,29.2365725115015
"1990","come baby",0.00683692697364102,177,38,139,37.5496111795271,139.450388820473
"1980","just another",0.0068037856019022,111,19,92,18.6741657684371,92.3258342315629
"2000","cant come",0.00673537794875917,29,8,21,7.80348492916141,21.1965150708386
"2000","colder",0.00673537794875917,29,8,21,7.80348492916141,21.1965150708386
"2000","gonna leave",0.00673537794875917,29,8,21,7.80348492916141,21.1965150708386
"2000","got everything",0.00673537794875917,29,8,21,7.80348492916141,21.1965150708386
"2000","gotta give",0.00673537794875917,29,8,21,7.80348492916141,21.1965150708386
"2000","im holding",0.00673537794875917,29,8,21,7.80348492916141,21.1965150708386
"2000","know hard",0.00673537794875917,29,8,21,7.80348492916141,21.1965150708386
"2000","plain see",0.00673537794875917,29,8,21,7.80348492916141,21.1965150708386
"2000","said want",0.00673537794875917,29,8,21,7.80348492916141,21.1965150708386
"2000","say things",0.00673537794875917,29,8,21,7.80348492916141,21.1965150708386
"2010","everybody wants",0.00671899939395559,57,9,48,8.77587526677201,48.224124733228
"2010","shows",0.00671899939395559,57,9,48,8.77587526677201,48.224124733228
"1970","anywhere",0.006403912544241,122,17,105,16.6954428048579,105.304557195142
"1970","id rather",0.006403912544241,122,17,105,16.6954428048579,105.304557195142
"1980","like hot",0.00608945338516831,117,20,97,19.6835801342986,97.3164198657014
"1980","cares",0.00602300802528144,64,11,53,10.767086569189,53.232913430811
"1980","give give give",0.00602300802528144,64,11,53,10.767086569189,53.232913430811
"1980","want got",0.00602300802528144,64,11,53,10.767086569189,53.232913430811
"1980","wont tell",0.00602300802528144,64,11,53,10.767086569189,53.232913430811
"2000","ran",0.00591666682828706,88,24,64,23.6795404746967,64.3204595253033
"1970","love wanna",0.00587946006324108,57,8,49,7.80032983505658,49.1996701649434
"1970","signs",0.00587946006324108,57,8,49,7.80032983505658,49.1996701649434
"2010","really need",0.00575549472790993,115,18,97,17.7057132575225,97.2942867424775
"2010","bow",0.00540451549408993,70,11,59,10.7773906784919,59.2226093215081
"2010","freaky",0.00540451549408993,70,11,59,10.7773906784919,59.2226093215081
"2010","youre looking",0.00540451549408993,70,11,59,10.7773906784919,59.2226093215081
"2000","happened",0.00538567293046677,125,34,91,33.6357109015578,91.3642890984422
"1980","along",0.00513728420885262,401,68,333,67.4625267850747,333.537473214925
"1980","folks",0.00507410401282959,70,12,58,11.7765009350505,58.2234990649496
"1980","ill",0.00500074632343006,4216,711,3505,709.281827745324,3506.71817225468
"1990","love can",0.00497932546823265,182,39,143,38.6103346591748,143.389665340825
"2010","playin",0.00467658216220213,212,33,179,32.6400974834327,179.359902516567
"2010","wanna know",0.00467658216220213,212,33,179,32.6400974834327,179.359902516567
"1960","cant take",0.00455055313169905,164,10,154,9.79461683643133,154.205383163569
"2000","bit",0.00452681869917049,540,146,394,145.30627109473,394.69372890527
"2010","dogg",0.0044793329293108,38,6,32,5.85058351118134,32.1494164888187
"2010","hit hard",0.0044793329293108,38,6,32,5.85058351118134,32.1494164888187
"2010","im tell",0.0044793329293108,38,6,32,5.85058351118134,32.1494164888187
"2010","reaching",0.0044793329293108,38,6,32,5.85058351118134,32.1494164888187
"2010","screen",0.0044793329293108,38,6,32,5.85058351118134,32.1494164888187
"2010","vip",0.0044793329293108,38,6,32,5.85058351118134,32.1494164888187
"2000","bills",0.00443750012122318,66,18,48,17.7596553560225,48.2403446439775
"2000","daddys",0.00443750012122318,66,18,48,17.7596553560225,48.2403446439775
"1980","flying",0.00429060108944168,76,13,63,12.7859153009119,63.2140846990881
"1990","baby oh",0.00421327539618233,154,33,121,32.6702831731479,121.329716826852
"1970","flower",0.00417892823477245,50,7,43,6.8423945921549,43.1576054078451
"1970","lyrics",0.00417892823477245,50,7,43,6.8423945921549,43.1576054078451
"1970","man dont",0.00417892823477245,50,7,43,6.8423945921549,43.1576054078451
"1970","right baby",0.00417892823477245,50,7,43,6.8423945921549,43.1576054078451
"1970","picture",0.0040775035902898,166,23,143,22.7167500459543,143.283249954046
"1960","blind",0.00397771469867514,214,13,201,12.780780506075,201.219219493925
"1960","later",0.00390242841422822,98,6,92,5.85288079250165,92.1471192074984
"1960","mans",0.00390242841422822,98,6,92,5.85288079250165,92.1471192074984
"2010","doin",0.00390116725641287,348,54,294,53.5790279445028,294.420972055497
"1990","bags",0.00381181515525802,51,11,40,10.8193794924061,40.1806205075939
"1990","stack",0.00381181515525802,51,11,40,10.8193794924061,40.1806205075939
"1990","uh huh uh huh",0.00381181515525802,51,11,40,10.8193794924061,40.1806205075939
"1970","try try",0.00381005441880988,79,11,68,10.8109834556047,68.1890165443953
"1990","baby think",0.00365277208724463,37,8,29,7.84935374939267,29.1506462506073
"1990","calm",0.00365277208724463,37,8,29,7.84935374939267,29.1506462506073
"1990","can show",0.00365277208724463,37,8,29,7.84935374939267,29.1506462506073
"1960","can tell",0.00364689266457063,264,16,248,15.7669441757187,248.233055824281
"1980","forgive",0.00363641977118723,82,14,68,13.7953296667734,68.2046703332266
"1980","ive ever",0.00363641977118723,82,14,68,13.7953296667734,68.2046703332266
"1960","door",0.00354384168131971,597,36,561,35.6547942155457,561.345205784454
"1990","room",0.00347579391443031,389,83,306,82.5242867165878,306.475713283412
"2010","whisper",0.00333734887300985,109,17,92,16.7819369136517,92.2180630863483
"2010","cherry",0.00327606750007609,51,8,43,7.85209892290127,43.1479010770987
"2010","couldnt get",0.00327606750007609,51,8,43,7.85209892290127,43.1479010770987
"2010","gonna change",0.00327606750007609,51,8,43,7.85209892290127,43.1479010770987
"2010","love cause",0.00327606750007609,51,8,43,7.85209892290127,43.1479010770987
"2010","stack",0.00327606750007609,51,8,43,7.85209892290127,43.1479010770987
"2010","table",0.00327606750007609,51,8,43,7.85209892290127,43.1479010770987
"1960","cant go",0.0031910310815475,231,14,217,13.7960761537539,217.203923846246
"1980","love one",0.00308526315028085,88,15,73,14.8047440326349,73.1952559673651
"2000","cant stay",0.00295833341414353,44,12,32,11.8397702373483,32.1602297626517
"2000","high school",0.00295833341414353,44,12,32,11.8397702373483,32.1602297626517
"2000","im missing",0.00295833341414353,44,12,32,11.8397702373483,32.1602297626517
"2000","names",0.00295833341414353,44,12,32,11.8397702373483,32.1602297626517
"1970","love just",0.00287397218591712,290,40,250,39.6858886344984,250.314111365502
"1970","job",0.0026570390942991,101,14,87,13.8216370761529,87.1783629238471
"2000","quit",0.00264340558920556,118,32,86,31.7521110910705,86.2478889089295
"1970","away take",0.00261397453695258,43,6,37,5.88445934925321,37.1155406507468
"1970","baby one",0.00261397453695258,43,6,37,5.88445934925321,37.1155406507468
"1970","claim",0.00261397453695258,43,6,37,5.88445934925321,37.1155406507468
"1970","like child",0.00261397453695258,43,6,37,5.88445934925321,37.1155406507468
"1970","waking",0.00261397453695258,43,6,37,5.88445934925321,37.1155406507468
"1970","weight",0.00261397453695258,43,6,37,5.88445934925321,37.1155406507468
"1970","youve gotta",0.00261397453695258,43,6,37,5.88445934925321,37.1155406507468
"2000","teach",0.00260866611914035,81,22,59,21.7959406642094,59.2040593357906
"2010","feelin like",0.00256013428420782,64,10,54,9.8536143346212,54.1463856653788
"2010","never seen",0.00256013428420782,64,10,54,9.8536143346212,54.1463856653788
"1980","backs",0.0025370520064148,35,6,29,5.88825046752523,29.1117495324748
"1980","can count",0.0025370520064148,35,6,29,5.88825046752523,29.1117495324748
"1980","dizzy",0.0025370520064148,35,6,29,5.88825046752523,29.1117495324748
"1980","ever get",0.0025370520064148,35,6,29,5.88825046752523,29.1117495324748
"1980","just thought",0.0025370520064148,35,6,29,5.88825046752523,29.1117495324748
"1980","kicked",0.0025370520064148,35,6,29,5.88825046752523,29.1117495324748
"1980","lonely lonely",0.0025370520064148,35,6,29,5.88825046752523,29.1117495324748
"1980","love call",0.0025370520064148,35,6,29,5.88825046752523,29.1117495324748
"1980","now like",0.0025370520064148,35,6,29,5.88825046752523,29.1117495324748
"1980","sing along",0.0025370520064148,35,6,29,5.88825046752523,29.1117495324748
"1980","theres nowhere",0.0025370520064148,35,6,29,5.88825046752523,29.1117495324748
"1980","wishes",0.0025370520064148,35,6,29,5.88825046752523,29.1117495324748
"1970","clock",0.00252862899925194,72,10,62,9.85304821270305,62.146951787297
"1970","everybody everybody",0.00252862899925194,72,10,62,9.85304821270305,62.146951787297
"1960","doin",0.00238633880267625,348,21,327,20.7836991407201,327.21630085928
"1960","ask",0.00237027507960585,498,30,468,29.7421901496512,468.257809850349
"2000","dyin",0.00221875006061159,33,9,24,8.87982767801125,24.1201723219887
"2000","feel pain",0.00221875006061159,33,9,24,8.87982767801125,24.1201723219887
"2000","laughin",0.00221875006061159,33,9,24,8.87982767801125,24.1201723219887
"2000","los",0.00221875006061159,33,9,24,8.87982767801125,24.1201723219887
"2000","mean thing",0.00221875006061159,33,9,24,8.87982767801125,24.1201723219887
"2000","now take",0.00221875006061159,33,9,24,8.87982767801125,24.1201723219887
"2000","promise ill",0.00221875006061159,33,9,24,8.87982767801125,24.1201723219887
"2000","sets",0.00221875006061159,33,9,24,8.87982767801125,24.1201723219887
"2000","touch touch",0.00221875006061159,33,9,24,8.87982767801125,24.1201723219887
"1990","trust",0.00221125094022678,239,51,188,50.7025823271581,188.297417672842
"2000","mess",0.00219729207846131,207,56,151,55.7007372529797,151.29926274702
"2000","cant stand",0.00204938661248982,107,29,78,28.7921685317335,78.2078314682665
"1990","yesterday",0.00199221303311004,131,28,103,27.7909551667686,103.209044833231
"2000","distance",0.00195006767749462,70,19,51,18.8359981048724,51.1640018951276
"2000","somehow",0.00194912316747786,170,46,124,45.7445668261186,124.255433173881
"1990","faded",0.00191512518008952,70,15,55,14.8501287150672,55.1498712849328
"1990","jumpin",0.00191512518008952,70,15,55,14.8501287150672,55.1498712849328
"1980","aside",0.00181820988559361,41,7,34,6.8976648333867,34.1023351666133
"1980","gonna alright",0.00181820988559361,41,7,34,6.8976648333867,34.1023351666133
"1980","lets take",0.00181820988559361,41,7,34,6.8976648333867,34.1023351666133
"1980","now shes",0.00181820988559361,41,7,34,6.8976648333867,34.1023351666133
"1980","oh come",0.00181820988559361,41,7,34,6.8976648333867,34.1023351666133
"1980","say word",0.00181820988559361,41,7,34,6.8976648333867,34.1023351666133
"1980","take breath",0.00181820988559361,41,7,34,6.8976648333867,34.1023351666133
"1980","tell dont",0.00181820988559361,41,7,34,6.8976648333867,34.1023351666133
"1980","word",0.00181246650985456,343,58,285,57.7048545817472,285.295145418253
"1990","one love",0.00163690368648545,117,25,92,24.8209294237552,92.1790705762448
"1990","alright",0.00162685925584849,705,150,555,149.56201063032,555.43798936968
"1990","building",0.0015321001440663,56,12,44,11.8801029720538,44.1198970279462
"1990","go baby",0.0015321001440663,56,12,44,11.8801029720538,44.1198970279462
"1990","gotta go",0.0015321001440663,56,12,44,11.8801029720538,44.1198970279462
"1990","guns",0.0015321001440663,56,12,44,11.8801029720538,44.1198970279462
"1990","hed",0.0015321001440663,56,12,44,11.8801029720538,44.1198970279462
"1990","nose",0.0015321001440663,56,12,44,11.8801029720538,44.1198970279462
"2000","banging",0.00147916670707177,22,6,16,5.91988511867417,16.0801148813258
"2000","cause id",0.00147916670707177,22,6,16,5.91988511867417,16.0801148813258
"2000","cigarette",0.00147916670707177,22,6,16,5.91988511867417,16.0801148813258
"2000","cry dont cry",0.00147916670707177,22,6,16,5.91988511867417,16.0801148813258
"2000","day without",0.00147916670707177,22,6,16,5.91988511867417,16.0801148813258
"2000","dont care say",0.00147916670707177,22,6,16,5.91988511867417,16.0801148813258
"2000","facts",0.00147916670707177,22,6,16,5.91988511867417,16.0801148813258
"2000","feel just",0.00147916670707177,22,6,16,5.91988511867417,16.0801148813258
"2000","find words",0.00147916670707177,22,6,16,5.91988511867417,16.0801148813258
"2000","girl knew",0.00147916670707177,22,6,16,5.91988511867417,16.0801148813258
"2000","goin home",0.00147916670707177,22,6,16,5.91988511867417,16.0801148813258
"2000","hey love",0.00147916670707177,22,6,16,5.91988511867417,16.0801148813258
"2000","im dreaming",0.00147916670707177,22,6,16,5.91988511867417,16.0801148813258
"2000","la da da da",0.00147916670707177,22,6,16,5.91988511867417,16.0801148813258
"2000","like baby baby baby",0.00147916670707177,22,6,16,5.91988511867417,16.0801148813258
"2000","like new",0.00147916670707177,22,6,16,5.91988511867417,16.0801148813258
"2000","love til",0.00147916670707177,22,6,16,5.91988511867417,16.0801148813258
"2000","meets",0.00147916670707177,22,6,16,5.91988511867417,16.0801148813258
"2000","need im",0.00147916670707177,22,6,16,5.91988511867417,16.0801148813258
"2000","one life",0.00147916670707177,22,6,16,5.91988511867417,16.0801148813258
"2000","phase",0.00147916670707177,22,6,16,5.91988511867417,16.0801148813258
"2000","time around",0.00147916670707177,22,6,16,5.91988511867417,16.0801148813258
"2000","towards",0.00147916670707177,22,6,16,5.91988511867417,16.0801148813258
"2000","treat good",0.00147916670707177,22,6,16,5.91988511867417,16.0801148813258
"2000","yeah oh oh",0.00147916670707177,22,6,16,5.91988511867417,16.0801148813258
"1960","deeper",0.00136758474923465,99,6,93,5.91260406589452,93.0873959341055
"1980","wanna take",0.00132722153934378,118,20,98,19.8518158619422,98.1481841380578
"2000","baby need",0.00132170279460278,59,16,43,15.8760555455353,43.1239444544647
"2000","bones",0.00132170279460278,59,16,43,15.8760555455353,43.1239444544647
"2000","go cause",0.00132170279460278,59,16,43,15.8760555455353,43.1239444544647
"2000","view",0.00132170279460278,59,16,43,15.8760555455353,43.1239444544647
"2010","learn",0.00132052880975625,239,37,202,36.7970910308511,202.202908969149
"1980","gotta take",0.00130875586203097,47,8,39,7.90707919924816,39.0929208007518
"1980","hand hand",0.00130875586203097,47,8,39,7.90707919924816,39.0929208007518
"1980","stopped",0.00130875586203097,47,8,39,7.90707919924816,39.0929208007518
"2010","sense",0.00130038908544911,116,18,98,17.8596759815009,98.1403240184991
"1990","downtown",0.00128913463349895,103,22,81,21.8509036807418,81.1490963192582
"1990","drop like",0.00114907510806103,42,9,33,8.91007722904033,33.0899227709597
"1990","jumped",0.00114907510806103,42,9,33,8.91007722904033,33.0899227709597
"1990","leads",0.00114907510806103,42,9,33,8.91007722904033,33.0899227709597
"1990","note",0.00114907510806103,42,9,33,8.91007722904033,33.0899227709597
"1990","thing like",0.00114907510806103,42,9,33,8.91007722904033,33.0899227709597
"1960","gave",0.00108876348117054,466,28,438,27.8310454010793,438.168954598921
"2000","fit",0.000974561583738931,85,23,62,22.8722834130593,62.1277165869407
"1990","dont like",0.000966600880000279,136,29,107,28.8516786464163,107.148321353584
"1980","calls",0.000937924604014068,53,9,44,8.91649356510963,44.0835064348904
"1980","know right",0.000937924604014068,53,9,44,8.91649356510963,44.0835064348904
"1980","need somebody",0.000937924604014068,53,9,44,8.91649356510963,44.0835064348904
"1980","say know",0.000937924604014068,53,9,44,8.91649356510963,44.0835064348904
"1980","tonight baby",0.000937924604014068,53,9,44,8.91649356510963,44.0835064348904
"2010","aint got time",0.000874031042858853,45,7,38,6.92832257903053,38.0716774209695
"2010","bleeding",0.000874031042858853,45,7,38,6.92832257903053,38.0716774209695
"2010","dont wanna go",0.000874031042858853,45,7,38,6.92832257903053,38.0716774209695
"2010","ive done",0.000874031042858853,45,7,38,6.92832257903053,38.0716774209695
"2010","matter say",0.000874031042858853,45,7,38,6.92832257903053,38.0716774209695
"2010","take higher",0.000874031042858853,45,7,38,6.92832257903053,38.0716774209695
"1970","starting",0.000862191655753158,87,12,75,11.9057665903495,75.0942334096505
"1970","heres",0.000809808950266638,138,19,119,18.8850090743475,119.114990925652
"2010","tell",0.000797771251270785,3445,531,2914,530.401584105782,2914.59841589422
"1960","died",0.000795446267582989,116,7,109,6.92789971357338,109.072100286427
"2010","every time",0.000771793840776414,356,55,301,54.8107297363304,301.18927026367
"1990","baby hold",0.000766050072033148,28,6,22,5.94005148602689,22.0599485139731
"1990","baby youll",0.000766050072033148,28,6,22,5.94005148602689,22.0599485139731
"1990","brown eyes",0.000766050072033148,28,6,22,5.94005148602689,22.0599485139731
"1990","cause heart",0.000766050072033148,28,6,22,5.94005148602689,22.0599485139731
"1990","devotion",0.000766050072033148,28,6,22,5.94005148602689,22.0599485139731
"1990","dont seem",0.000766050072033148,28,6,22,5.94005148602689,22.0599485139731
"1990","far im",0.000766050072033148,28,6,22,5.94005148602689,22.0599485139731
"1990","heart attack",0.000766050072033148,28,6,22,5.94005148602689,22.0599485139731
"1990","high high",0.000766050072033148,28,6,22,5.94005148602689,22.0599485139731
"1990","let dont",0.000766050072033148,28,6,22,5.94005148602689,22.0599485139731
"1990","look look",0.000766050072033148,28,6,22,5.94005148602689,22.0599485139731
"1990","love said",0.000766050072033148,28,6,22,5.94005148602689,22.0599485139731
"1990","replace",0.000766050072033148,28,6,22,5.94005148602689,22.0599485139731
"1990","sad sad",0.000766050072033148,28,6,22,5.94005148602689,22.0599485139731
"1990","see will",0.000766050072033148,28,6,22,5.94005148602689,22.0599485139731
"1990","take night",0.000766050072033148,28,6,22,5.94005148602689,22.0599485139731
"1990","tan",0.000766050072033148,28,6,22,5.94005148602689,22.0599485139731
"1990","youd never",0.000766050072033148,28,6,22,5.94005148602689,22.0599485139731
"2000","kitchen",0.000744387419854886,48,13,35,12.9161129861982,35.0838870138018
"2000","time think",0.000744387419854886,48,13,35,12.9161129861982,35.0838870138018
"1990","live life",0.000686110359348957,122,26,96,25.8816529034029,96.1183470965971
"1980","breeze",0.000663610769671891,59,10,49,9.9259079309711,49.0740920690289
"1980","gonna come",0.000663610769671891,59,10,49,9.9259079309711,49.0740920690289
"1980","hiding",0.000663610769671891,59,10,49,9.9259079309711,49.0740920690289
"1980","know go",0.000663610769671891,59,10,49,9.9259079309711,49.0740920690289
"1990","cause baby",0.000633125957917618,75,16,59,15.9108521947149,59.0891478052851
"1990","heartache",0.000633125957917618,75,16,59,15.9108521947149,59.0891478052851
"2000","cried",0.000602561717247319,163,44,119,43.8609670156314,119.139032984369
"1970","shining",0.000575247010129371,160,22,138,21.8956626948957,138.104337305104
"1970","daughter",0.000574794437183418,58,8,50,7.93717772689968,50.0628222731003
"1970","lets dance",0.000574794437183418,58,8,50,7.93717772689968,50.0628222731003
"1970","ooh oh",0.000574794437183418,58,8,50,7.93717772689968,50.0628222731003
"1970","like know",0.000541713278786132,109,15,94,14.9164202108977,94.0835797891023
"2000","saved",0.000527477457807318,74,20,54,19.9123408537222,54.0876591462778
"1980","hurts",0.000493127952449685,148,25,123,24.8988876912495,123.10111230875
"2000","rest",0.000476669502856519,241,65,176,64.8496506182034,176.150349381797
"1980","know say",0.000459193647445649,65,11,54,10.9353222968326,54.0646777031674
"1980","want can",0.000459193647445649,65,11,54,10.9353222968326,54.0646777031674
"1990","brain",0.000432242905085312,108,23,85,22.9116271603894,85.0883728396106
"1970","sorry",0.000428789852339906,306,42,264,41.875454903988,264.124545096012
"1970","whenever",0.000407824715990185,182,25,157,24.9063163154438,157.093683684556
"1990","action",0.000343055179674479,61,13,48,12.9408264517014,48.0591735482986
"1990","dont play",0.000343055179674479,61,13,48,12.9408264517014,48.0591735482986
"1990","one another",0.000343055179674479,61,13,48,12.9408264517014,48.0591735482986
"1980","cause ive",0.000307018146849775,71,12,59,11.944736662694,59.055263337306
"1980","happiness",0.000307018146849775,71,12,59,11.944736662694,59.055263337306
"2000","rather",0.000301419220975402,178,48,130,47.8972523238183,130.102747676182
"1970","find love",0.000287623505064685,80,11,69,10.9478313474478,69.0521686525522
"1970","now get",0.000287623505064685,80,11,69,10.9478313474478,69.0521686525522
"2000","bells",0.000263738728903659,37,10,27,9.9561704268611,27.0438295731389
"2000","horny",0.000263738728903659,37,10,27,9.9561704268611,27.0438295731389
"2000","just walk",0.000263738728903659,37,10,27,9.9561704268611,27.0438295731389
"2000","theres nothin",0.000263738728903659,37,10,27,9.9561704268611,27.0438295731389
"2000","well just",0.000263738728903659,37,10,27,9.9561704268611,27.0438295731389
"2010","call name",0.000244252360041691,123,19,104,18.9374150493501,104.06258495065
"1980","got got",0.0002284338900988,166,28,138,27.9271307888339,138.072869211166
"2010","supposed",0.000182610295212243,149,23,126,22.94044587279,126.05955412721
"1980","happen",0.000167197435915561,172,29,143,28.9365451546954,143.063454845305
"2000","wants",0.000129835544714574,557,150,407,149.880727777341,407.119272222659
"1990","street",0.000121398238628972,339,72,267,71.9170519201112,267.082948079889
"2000","want want",0.00011633764390509,193,52,141,51.9335376320052,141.066462367995
"1990","gotta take",0.000108457283727659,47,10,37,9.97080070868799,37.029199291312
"1990","pillow",0.000108457283727659,47,10,37,9.97080070868799,37.029199291312
"1990","stopped",0.000108457283727659,47,10,37,9.97080070868799,37.029199291312
"2010","uh uh",8.60837514682911e-05,227,35,192,34.9495383431096,192.05046165689
"1970","youre never gonna",7.1464975402856e-05,51,7,44,6.97924248399799,44.020757516002
"1980","else can",5.85951460498405e-05,89,15,74,14.9729797602784,74.0270202397216
"2010","tomorrow",5.42293619502227e-05,279,43,236,42.9555999899893,236.044400010011
"1980","looks",2.42597532325792e-05,196,33,163,32.9742026181413,163.025797381859
"1980","need need",2.33101954091319e-05,95,16,79,15.9823941261399,79.0176058738601
"1960","searching",2.33027169791525e-05,117,7,110,6.98762298696625,110.012377013034
"1970","moved",1.18360345579202e-05,73,10,63,9.98989610454615,63.0101038954538
"2000","darkness",1.11289488542651e-05,104,28,76,27.9849114700961,76.0150885299039
"2000","im afraid",5.56447442713257e-06,52,14,38,13.992455735048,38.007544264952
"1980","rule",4.74714163034226e-06,101,17,84,16.9918084920014,84.0081915079986
"2000","downi",2.78223721356628e-06,26,7,19,6.99622786752402,19.003772132476
"2000","get can",2.78223721356628e-06,26,7,19,6.99622786752402,19.003772132476
"2000","real just",2.78223721356628e-06,26,7,19,6.99622786752402,19.003772132476
"2000","said aint",2.78223721356628e-06,26,7,19,6.99622786752402,19.003772132476
"2000","swimming",2.78223721356628e-06,26,7,19,6.99622786752402,19.003772132476
"2000","without babe",2.78223721356628e-06,26,7,19,6.99622786752402,19.003772132476
"1960","heard",1.42011249673786e-07,586,35,551,34.9978382082241,551.002161791776
"1990","always something",-1.08889019043244e-07,33,7,26,7.00077496567454,25.9992250343255
"1990","coffee",-1.08889019043244e-07,33,7,26,7.00077496567454,25.9992250343255
"1990","famous",-1.08889019043244e-07,33,7,26,7.00077496567454,25.9992250343255
"1990","platinum",-1.08889019043244e-07,33,7,26,7.00077496567454,25.9992250343255
"1990","red light",-1.08889019043244e-07,33,7,26,7.00077496567454,25.9992250343255
"1990","said youre",-1.08889019043244e-07,33,7,26,7.00077496567454,25.9992250343255
"1990","sisters",-1.08889019043244e-07,33,7,26,7.00077496567454,25.9992250343255
"1990","think im gonna",-1.08889019043244e-07,33,7,26,7.00077496567454,25.9992250343255
"1990","trunk",-1.08889019043244e-07,33,7,26,7.00077496567454,25.9992250343255
"2000","please dont",-1.11438569201476e-07,249,67,182,67.0023361159031,181.997663884097
"1990","emotion",-2.17778038086487e-07,66,14,52,14.0015499313491,51.9984500686509
"1990","happens",-2.17778038086487e-07,66,14,52,14.0015499313491,51.9984500686509
"1990","just cant get",-2.17778038086487e-07,66,14,52,14.0015499313491,51.9984500686509
"1990","wash",-3.26667061793101e-07,99,21,78,21.0023248970236,77.9976751029764
"2010","around cause",-4.06933822221824e-06,39,6,33,6.0045462351598,32.9954537648402
"2010","loveyou",-4.06933822221824e-06,39,6,33,6.0045462351598,32.9954537648402
"2010","prince",-4.06933822221824e-06,39,6,33,6.0045462351598,32.9954537648402
"2010","well thats",-4.06933822221824e-06,39,6,33,6.0045462351598,32.9954537648402
"2010","beginning",-5.42578427675279e-06,52,8,44,8.00606164687973,43.9939383531203
"2010","hall",-5.42578427675279e-06,52,8,44,8.00606164687973,43.9939383531203
"2010","help help",-5.42578427675279e-06,52,8,44,8.00606164687973,43.9939383531203
"2010","will go",-6.78223036814155e-06,65,10,55,10.0075770585997,54.9924229414003
"2010","message",-8.13867644443647e-06,78,12,66,12.0090924703196,65.9909075296804
"2010","youre feeling",-8.13867644443647e-06,78,12,66,12.0090924703196,65.9909075296804
"2010","beg",-9.49512251850748e-06,91,14,77,14.0106078820395,76.9893921179605
"2010","gas",-9.49512251850748e-06,91,14,77,14.0106078820395,76.9893921179605
"2010","point",-1.22080146626562e-05,117,18,99,18.0136387054794,98.9863612945206
"2010","im going",-1.62773528888729e-05,156,24,132,24.0181849406392,131.981815059361
"1990","tellin",-4.54098551664339e-05,151,32,119,32.0338490853593,118.966150914641
"1980","just want",-7.18371782287702e-05,244,41,203,41.049517545033,202.950482454967
"1990","fit",-7.34639628928863e-05,85,18,67,18.0322991540102,66.9677008459898
"1990","hands air",-7.34639628928863e-05,85,18,67,18.0322991540102,66.9677008459898
"1990","like love",-7.34639628928863e-05,85,18,67,18.0322991540102,66.9677008459898
"1970","cant read",-8.74395556840699e-05,44,6,38,6.02130724109631,37.9786927589037
"1970","got feelin",-8.74395556840699e-05,44,6,38,6.02130724109631,37.9786927589037
"1970","names",-8.74395556840699e-05,44,6,38,6.02130724109631,37.9786927589037
"1970","say cant",-8.74395556840699e-05,44,6,38,6.02130724109631,37.9786927589037
"1960","giving",-9.27349605766431e-05,235,14,221,14.0349692473254,220.965030752675
"1990","heart cant",-0.000114421729008843,52,11,41,11.0315241883356,40.9684758116644
"1990","hills",-0.000114421729008843,52,11,41,11.0315241883356,40.9684758116644
"1990","never go",-0.000114421729008843,52,11,41,11.0315241883356,40.9684758116644
"1970","outside",-0.00011967594733521,205,28,177,28.0538178278351,176.946182172165
"2000","safe",-0.000125414895468995,134,36,98,36.0574820864699,97.9425179135301
"1970","cadillac",-0.000131159333555425,66,9,57,9.03196086164446,56.9680391383555
"1970","got need",-0.000131159333555425,66,9,57,9.03196086164446,56.9680391383555
"1970","ill go",-0.000131159333555425,66,9,57,9.03196086164446,56.9680391383555
"2000","cause theres",-0.000131174018897215,41,11,30,11.032513175711,29.9674868242891
"2000","go want",-0.000131174018897215,41,11,30,11.032513175711,29.9674868242891
"2000","yeahyou",-0.000131174018897215,41,11,30,11.032513175711,29.9674868242891
"1990","walk away",-0.000146927925785773,170,36,134,36.0645983080204,133.93540169198
"2000","forget",-0.000151822367144533,491,132,359,132.121072421319,358.878927578681
"1970","whole life",-0.00017487911136814,88,12,76,12.0426144821926,75.9573855178074
"1970","love let",-0.000218598889255683,110,15,95,15.0532681027408,94.9467318972592
"2000","dad",-0.00026234803779443,82,22,60,22.0650263514219,59.9349736485781
"1980","dont mind",-0.000270296820316401,155,26,129,26.0765377847546,128.923462215245
"1980","ill never",-0.00033307393129467,286,48,238,48.1154181060633,237.884581893937
"1960","kisses",-0.000339002571109553,118,7,111,7.04734626035913,110.952653739641
"2000","careful",-0.000430161185020289,56,15,41,15.0687984838979,40.9312015161021
"2000","cause thats",-0.000430161185020289,56,15,41,15.0687984838979,40.9312015161021
"2000","drug",-0.000430161185020289,56,15,41,15.0687984838979,40.9312015161021
"2000","go baby",-0.000430161185020289,56,15,41,15.0687984838979,40.9312015161021
"2000","keep movin",-0.000430161185020289,56,15,41,15.0687984838979,40.9312015161021
"2000","truly",-0.000430161185020289,56,15,41,15.0687984838979,40.9312015161021
"2000","words say",-0.000430161185020289,56,15,41,15.0687984838979,40.9312015161021
"1980","thousand",-0.000453958187203451,173,29,144,29.104780882339,143.895219117661
"2000","bomb",-0.000538450508437788,97,26,71,26.1013116596088,70.8986883403912
"2010","week",-0.000559308647103102,111,17,94,17.0898623616086,93.9101376383913
"1990","checkin",-0.000596589590992833,38,8,30,8.0614984453222,29.9385015546778
"1990","dont know like",-0.000596589590992833,38,8,30,8.0614984453222,29.9385015546778
"1990","look way",-0.000596589590992833,38,8,30,8.0614984453222,29.9385015546778
"1990","nothings gonna",-0.000596589590992833,38,8,30,8.0614984453222,29.9385015546778
"1990","pretty baby",-0.000596589590992833,38,8,30,8.0614984453222,29.9385015546778
"1990","understand im",-0.000596589590992833,38,8,30,8.0614984453222,29.9385015546778
"2010","gonna give",-0.000612416540559546,98,15,83,15.0883469498887,82.9116530501113
"2010","secrets",-0.000612416540559546,98,15,83,15.0883469498887,82.9116530501113
"1980","closing",-0.000634957539570741,36,6,30,6.05648619516881,29.9435138048312
"1980","dont know can",-0.000634957539570741,36,6,30,6.05648619516881,29.9435138048312
"1980","know wrong",-0.000634957539570741,36,6,30,6.05648619516881,29.9435138048312
"1980","little things",-0.000634957539570741,36,6,30,6.05648619516881,29.9435138048312
"1980","love anything",-0.000634957539570741,36,6,30,6.05648619516881,29.9435138048312
"1980","strike",-0.000634957539570741,36,6,30,6.05648619516881,29.9435138048312
"1980","talk like",-0.000634957539570741,36,6,30,6.05648619516881,29.9435138048312
"1980","wait till",-0.000634957539570741,36,6,30,6.05648619516881,29.9435138048312
"2010","glory",-0.0006822109871438,85,13,72,13.0868315381688,71.9131684618312
"2000","worth",-0.000684502117709707,272,73,199,73.1913069217897,198.80869307821
"1980","leads",-0.00074078379618453,42,7,35,7.06590056103027,34.9340994389697
"1980","make life",-0.00074078379618453,42,7,35,7.06590056103027,34.9340994389697
"1980","make see",-0.00074078379618453,42,7,35,7.06590056103027,34.9340994389697
"1980","never really",-0.00074078379618453,42,7,35,7.06590056103027,34.9340994389697
"1980","night get",-0.00074078379618453,42,7,35,7.06590056103027,34.9340994389697
"1980","tearing",-0.00074078379618453,42,7,35,7.06590056103027,34.9340994389697
"1980","things say",-0.00074078379618453,42,7,35,7.06590056103027,34.9340994389697
"1970","just go",-0.000751063526167217,81,11,70,11.0846792392909,69.9153207607091
"1970","never leave",-0.000751063526167217,81,11,70,11.0846792392909,69.9153207607091
"1970","dont make",-0.000762117575010018,125,17,108,17.1059864803872,107.894013519613
"1970","cloud",-0.00078832866019754,59,8,51,8.07402561874278,50.9259743812572
"1970","hold close",-0.00078832866019754,59,8,51,8.07402561874278,50.9259743812572
"1970","torn",-0.00078832866019754,59,8,51,8.07402561874278,50.9259743812572
"1980","looked",-0.00081272750846817,203,34,169,34.1518527116463,168.848147288354
"1970","laugh",-0.000812968404587056,169,23,146,23.1272937214836,145.872706278516
"1970","mei",-0.000812968404587056,169,23,146,23.1272937214836,145.872706278516
"1980","ecstasy",-0.000846610052778723,48,8,40,8.07531492689174,39.9246850731083
"1980","get im",-0.000846610052778723,48,8,40,8.07531492689174,39.9246850731083
"1980","machine",-0.000846610052778723,48,8,40,8.07531492689174,39.9246850731083
"1980","peace mind",-0.000846610052778723,48,8,40,8.07531492689174,39.9246850731083
"2000","back get",-0.00089427136097131,30,8,22,8.07257061637387,21.9274293836261
"2000","crashing",-0.00089427136097131,30,8,22,8.07257061637387,21.9274293836261
"2000","flat",-0.00089427136097131,30,8,22,8.07257061637387,21.9274293836261
"2000","floor dont",-0.00089427136097131,30,8,22,8.07257061637387,21.9274293836261
"2000","know youd",-0.00089427136097131,30,8,22,8.07257061637387,21.9274293836261
"2000","man love",-0.00089427136097131,30,8,22,8.07257061637387,21.9274293836261
"2000","nineteen",-0.00089427136097131,30,8,22,8.07257061637387,21.9274293836261
"2000","take good",-0.00089427136097131,30,8,22,8.07257061637387,21.9274293836261
"2000","things will",-0.00089427136097131,30,8,22,8.07257061637387,21.9274293836261
"2000","waves",-0.00089427136097131,30,8,22,8.07257061637387,21.9274293836261
"1990","baby give",-0.000894884386491906,57,12,45,12.0922476679833,44.9077523320167
"1990","go just",-0.000894884386491906,57,12,45,12.0922476679833,44.9077523320167
"1990","letting go",-0.000894884386491906,57,12,45,12.0922476679833,44.9077523320167
"2010","mister",-0.000916082736500651,59,9,50,9.08380071472892,49.9161992852711
"1980","bear",-0.00095243630937808,54,9,45,9.08472929275321,44.9152707072468
"1980","better run",-0.00095243630937808,54,9,45,9.08472929275321,44.9152707072468
"1980","youre love",-0.00095243630937808,54,9,45,9.08472929275321,44.9152707072468
"1980","evening",-0.00105826256595126,60,10,50,10.0941436586147,49.9058563413853
"1980","gray",-0.00105826256595126,60,10,50,10.0941436586147,49.9058563413853
"1980","just give",-0.00105826256595126,60,10,50,10.0941436586147,49.9058563413853
"1980","winter",-0.00105826256595126,60,10,50,10.0941436586147,49.9058563413853
"2000","cause youre",-0.00107690101687558,194,52,142,52.2026233192177,141.797376680782
"1990","took",-0.00108118991639861,553,117,436,117.316016849031,435.683983150969
"2010","said love",-0.00113360999280845,46,7,39,7.08228530300899,38.917714696991
"2010","say just",-0.00113360999280845,46,7,39,7.08228530300899,38.917714696991
"2010","tune",-0.00113360999280845,46,7,39,7.08228530300899,38.917714696991
"2010","yeah like",-0.00113360999280845,46,7,39,7.08228530300899,38.917714696991
"1980","times",-0.001137712850377,626,105,521,105.31556550488,520.68443449512
"1980","can make",-0.00118169023244508,370,62,308,62.2472192281238,307.752780771876
"2000","drinks",-0.00118307961987441,86,23,63,23.1413691002718,62.8586308997282
"2000","im alone",-0.00118307961987441,86,23,63,23.1413691002718,62.8586308997282
"1990","bridge",-0.00119317918198567,76,16,60,16.1229968906444,59.8770031093556
"1990","ill show",-0.00119317918198567,76,16,60,16.1229968906444,59.8770031093556
"2000","guys",-0.00121175955028929,127,34,93,34.1738822759827,92.8261177240173
"2010","without",-0.00122575706785233,1367,210,1157,210.46704367855,1156.53295632145
"1970","thought",-0.00123652387448581,799,109,690,109.341465582635,689.658534417365
"1980","poor",-0.00126991507914148,72,12,60,12.1129723903376,59.8870276096624
"2010","wear",-0.00128956551794857,183,28,155,28.1751784880575,154.824821511943
"2000","aint got time",-0.00134140704147426,45,12,33,12.1088559245608,32.8911440754392
"2000","liquor",-0.00134140704147426,45,12,33,12.1088559245608,32.8911440754392
"2000","serious",-0.00134140704147426,45,12,33,12.1088559245608,32.8911440754392
"2000","thing youre",-0.00134140704147426,45,12,33,12.1088559245608,32.8911440754392
"1980","see eyes",-0.00137574133576834,78,13,65,13.1223867561991,64.8776132438009
"1980","somethings",-0.00137574133576834,78,13,65,13.1223867561991,64.8776132438009
"1960","gold",-0.00142707918843971,304,18,286,18.1558751114337,285.844124888566
"1960","desire",-0.00147737893415034,102,6,96,6.09177388607314,95.9082261139269
"1960","lifes",-0.00147737893415034,102,6,96,6.09177388607314,95.9082261139269
"1960","never find",-0.00147737893415034,102,6,96,6.09177388607314,95.9082261139269
"1970","trouble",-0.00150212705233443,162,22,140,22.1693584785819,139.830641521418
"2010","last night",-0.0015554955661356,144,22,122,22.1706322528977,121.829367747102
"1980","go oh",-0.0015873938489635,90,15,75,15.141215487922,74.858784512078
"1980","thats",-0.00159029280237921,2727,458,2269,458.778829284037,2268.22117071596
"2000","swing",-0.00159101188922522,101,27,74,27.1776544084587,73.8223455915413
"2000","now youre",-0.00163800205564896,183,49,134,49.2426807598806,133.757319240119
"1970","become",-0.00166970875326805,96,13,83,13.1373976169374,82.8626023830626
"1970","grass",-0.00166970875326805,96,13,83,13.1373976169374,82.8626023830626
"2010","see im",-0.00167993892789964,131,20,111,20.1691168411778,110.830883158822
"1960","coming back",-0.00172360875645902,119,7,112,7.107069533752,111.892930466248
"1970","babe",-0.00174065044841787,675,92,583,92.3723269940911,582.627673005909
"2000","ahh",-0.00178854272194262,60,16,44,16.1451412327477,43.8548587672523
"2000","gray",-0.00178854272194262,60,16,44,16.1451412327477,43.8548587672523
"1980","seems like",-0.00179904636215861,102,17,85,17.1600442196449,84.8399557803551
"1970","feel right",-0.00184429083406029,74,10,64,10.1267439963892,63.8732560036107
"1970","never see",-0.00184429083406029,74,10,64,10.1267439963892,63.8732560036107
"1970","record",-0.00184429083406029,74,10,64,10.1267439963892,63.8732560036107
"1960","held",-0.00196983857880853,136,8,128,8.12236518143086,127.877634818569
"1990","way want",-0.0020853388985223,43,9,34,9.12222192496986,33.8777780750301
"1990","knowing",-0.00208806356848112,133,28,105,28.2152445586277,104.784755441372
"1970","burned",-0.00220426155663669,52,7,45,7.11609037584109,44.8839096241589
"1970","disappear",-0.00220426155663669,52,7,45,7.11609037584109,44.8839096241589
"1970","saving",-0.00220426155663669,52,7,45,7.11609037584109,44.8839096241589
"1970","yeah youre",-0.00220426155663669,52,7,45,7.11609037584109,44.8839096241589
"1980","father",-0.00222235138855365,126,21,105,21.1977016830908,104.802298316909
"2000","side side",-0.00223567840243272,75,20,55,20.1814265409347,54.8185734590653
"1990","go know",-0.00226456693879257,62,13,49,13.152971147631,48.847028852369
"1990","just aint",-0.00226456693879257,62,13,49,13.152971147631,48.847028852369
"1990","time will",-0.00226456693879257,62,13,49,13.152971147631,48.847028852369
"1990","tip",-0.00226456693879257,62,13,49,13.152971147631,48.847028852369
"2010","get floor",-0.00226721998561691,92,14,78,14.164570606018,77.835429393982
"1970","one time",-0.00230978925349162,199,27,172,27.2327304767765,171.767269523223
"1980","girl youre",-0.00232817764514148,132,22,110,22.2071160489523,109.792883951048
"1990","pride",-0.00238635836397133,152,32,120,32.2459937812888,119.754006218711
"1990","long",-0.00249184160541738,1918,406,1512,406.893526792842,1511.10647320716
"1990","cant deny",-0.00249969579785442,81,17,64,17.1837203702921,63.8162796297079
"1980","didnt know",-0.00253983015828296,144,24,120,24.2259447806752,119.774055219325
"2010","foot",-0.00259318107546436,79,12,67,12.163055194298,66.8369448057019
"2010","neck",-0.00259318107546436,79,12,67,12.163055194298,66.8369448057019
"2010","now just",-0.00259318107546436,79,12,67,12.163055194298,66.8369448057019
"1980","im going",-0.00275148267153669,156,26,130,26.2447735123982,129.755226487602
"1990","love right",-0.00275884243328273,100,21,79,21.2144695929532,78.7855304070468
"1980","doesnt",-0.00284885292348092,341,57,284,57.3683831264601,283.63161687354
"2000","faith",-0.00286312416940093,146,39,107,39.2865103330195,106.71348966698
"1960","one thing",-0.00295475786830068,204,12,192,12.1835477721463,191.816452227854
"1980","know ill",-0.00296313518473812,168,28,140,28.2636022441211,139.736397755879
"1970","youd",-0.00299370176140823,412,56,356,56.3813314393564,355.618668560644
"2010","cadillac",-0.00304862565073921,66,10,56,10.1615397825781,55.8384602174219
"1980","feel way",-0.00317478769792701,180,30,150,30.282430975844,149.717569024156
"1990","brown",-0.00330948984832491,138,29,109,29.2759680382754,108.724031961725
"2000","blaze",-0.00332761020189148,34,9,25,9.14891336522372,24.8510866347763
"2000","let put",-0.00332761020189148,34,9,25,9.14891336522372,24.8510866347763
"2000","need dont",-0.00332761020189148,34,9,25,9.14891336522372,24.8510866347763
"2000","said goodbye",-0.00332761020189148,34,9,25,9.14891336522372,24.8510866347763
"2000","true dont",-0.00332761020189148,34,9,25,9.14891336522372,24.8510866347763
"2000","wanted",-0.00344128948016231,448,120,328,120.550387871183,327.449612128817
"1980","need",-0.00354324909959569,3735,627,3108,628.360442748764,3106.63955725124
"2000","back love",-0.00356957486084808,49,13,36,13.1851986734107,35.8148013265894
"1970","back im",-0.00361949532482786,67,9,58,9.16880875348756,57.8311912465124
"2010","just love",-0.00372933396041614,53,8,45,8.16002437085818,44.8399756291418
"2010","tell feel",-0.00372933396041614,53,8,45,8.16002437085818,44.8399756291418
"2000","shadow",-0.00390779370476668,64,17,47,17.2214839815976,46.7785160184024
"1990","makin",-0.00402281255984183,318,67,251,67.4620133055911,250.537986694409
"2000","first time",-0.00402422112437895,135,36,99,36.3265677736824,98.6734322263176
"1990","back im",-0.0040929314558571,67,14,53,14.2136946272786,52.7863053727214
"1990","twist",-0.0040929314558571,67,14,53,14.2136946272786,52.7863053727214
"1970","minute",-0.00411573576461421,251,34,217,34.3488208526176,216.651179147382
"1990","prayer",-0.00417067779704461,86,18,68,18.2444438499397,67.7555561500603
"1990","way know",-0.0041902349270434,48,10,38,10.1829454046175,37.8170545953825
"2000","fair",-0.00428740128843541,79,21,58,21.2577692897845,57.7422307102155
"2000","try try",-0.00428740128843541,79,21,58,21.2577692897845,57.7422307102155
"1960","feel good",-0.00433995783765939,137,8,129,8.18208845482373,128.817911545176
"1960","rush",-0.00433995783765939,137,8,129,8.18208845482373,128.817911545176
"1990","cause know",-0.00445974642245039,214,45,169,45.3989649289198,168.60103507108
"1990","im still",-0.00445974642245039,214,45,169,45.3989649289198,168.60103507108
"2000","faces",-0.00468857260402922,94,25,69,25.2940545979715,68.7059454020285
"1970","course",-0.00474010058765345,45,6,39,6.15815513293941,38.8418448670606
"1970","gonna rock",-0.00474010058765345,45,6,39,6.15815513293941,38.8418448670606
"1970","ill gone",-0.00474010058765345,45,6,39,6.15815513293941,38.8418448670606
"1970","realized",-0.00474010058765345,45,6,39,6.15815513293941,38.8418448670606
"1970","simply",-0.00474010058765345,45,6,39,6.15815513293941,38.8418448670606
"1970","take higher",-0.00474010058765345,45,6,39,6.15815513293941,38.8418448670606
"1970","woo woo",-0.00474010058765345,45,6,39,6.15815513293941,38.8418448670606
"1990","erase",-0.00480812616558424,29,6,23,6.15219618195642,22.8478038180436
"1990","ill know",-0.00480812616558424,29,6,23,6.15219618195642,22.8478038180436
"1990","like crazy",-0.00480812616558424,29,6,23,6.15219618195642,22.8478038180436
"1990","meso",-0.00480812616558424,29,6,23,6.15219618195642,22.8478038180436
"1990","sticks",-0.00480812616558424,29,6,23,6.15219618195642,22.8478038180436
"1990","sunset",-0.00480812616558424,29,6,23,6.15219618195642,22.8478038180436
"1990","tom",-0.00480812616558424,29,6,23,6.15219618195642,22.8478038180436
"1990","way cause",-0.00480812616558424,29,6,23,6.15219618195642,22.8478038180436
"2010","handle",-0.00483543694281074,171,26,145,26.327625800316,144.672374199684
"2010","way feel",-0.00483543694281074,171,26,145,26.327625800316,144.672374199684
"2010","im black",-0.00485647315782767,40,6,34,6.15850895913825,33.8414910408617
"2010","love theres",-0.00485647315782767,40,6,34,6.15850895913825,33.8414910408617
"2010","nothing like",-0.00485647315782767,40,6,34,6.15850895913825,33.8414910408617
"2010","see girl",-0.00485647315782767,40,6,34,6.15850895913825,33.8414910408617
"2010","wedding",-0.00485647315782767,40,6,34,6.15850895913825,33.8414910408617
"1970","can give",-0.00509491872690876,82,11,71,11.221527131134,70.778472868866
"1970","now cant",-0.00509491872690876,82,11,71,11.221527131134,70.778472868866
"2010","ill make",-0.00518636215092871,158,24,134,24.3261103885961,133.673889611404
"1990","behind",-0.00536930631893529,342,72,270,72.5534860078998,269.4465139921
"2000","cant stop",-0.00548660886102326,236,63,173,63.5042221821411,172.495777817859
"2000","dont leave",-0.00552429078520067,124,33,91,33.3666252143453,90.6333747856547
"2000","sing",-0.00569810730227638,620,166,454,166.833126071727,453.166873928273
"1980","music",-0.00598506769566409,700,117,583,117.765009350505,582.234990649495
"2000","til",-0.00600180602736722,594,159,435,159.836898204203,434.163101795797
"2010","time get",-0.00605651258814183,73,11,62,11.2392788504273,61.7607211495727
"1990","thunder",-0.00614666616229709,91,19,72,19.3051673295874,71.6948326704126
"1990","hour",-0.00615919099401108,110,23,87,23.3359165522485,86.6640834477515
"1990","clock",-0.00628535239053996,72,15,57,15.2744181069263,56.7255818930737
"1970","babys",-0.00632013411684645,60,8,52,8.21087351058588,51.7891264894141
"1970","stayed",-0.00632013411684645,60,8,52,8.21087351058588,51.7891264894141
"1970","youre ready",-0.00632013411684645,60,8,52,8.21087351058588,51.7891264894141
"1990","dont go",-0.00658734983624021,167,35,132,35.4281642202318,131.571835779768
"2000","beggin",-0.00658780986898855,53,14,39,14.2615414222605,38.7384585777395
"2000","calls",-0.00658780986898855,53,14,39,14.2615414222605,38.7384585777395
"2000","drive crazy",-0.00658780986898855,53,14,39,14.2615414222605,38.7384585777395
"2000","headed",-0.00658780986898855,53,14,39,14.2615414222605,38.7384585777395
"2000","know right",-0.00658780986898855,53,14,39,14.2615414222605,38.7384585777395
"2000","brothers",-0.00665522040378297,68,18,50,18.2978267304474,49.7021732695526
"2000","change mind",-0.00665522040378297,68,18,50,18.2978267304474,49.7021732695526
"1990","decide",-0.00673844424486708,53,11,42,11.2436688842652,41.7563311157348
"1990","sunny",-0.00673844424486708,53,11,42,11.2436688842652,41.7563311157348
"2000","game play",-0.00682103131775602,38,10,28,10.2252561140736,27.7747438859264
"2000","need just",-0.00682103131775602,38,10,28,10.2252561140736,27.7747438859264
"2000","pretty baby",-0.00682103131775602,38,10,28,10.2252561140736,27.7747438859264
"2000","shape",-0.00682103131775602,38,10,28,10.2252561140736,27.7747438859264
"2000","time go",-0.00682103131775602,38,10,28,10.2252561140736,27.7747438859264
"2000","understand im",-0.00682103131775602,38,10,28,10.2252561140736,27.7747438859264
"2000","west coast",-0.00682103131775602,38,10,28,10.2252561140736,27.7747438859264
"2000","older",-0.00686005817590585,83,22,61,22.3341120386344,60.6658879613656
"1970","past",-0.00705065417355366,215,29,186,29.4222967462661,185.577703253734
"1970","callin",-0.00723899064965572,134,18,116,18.3376175069751,115.662382493025
"1970","know cant",-0.00723899064965572,134,18,116,18.3376175069751,115.662382493025
"2010","naked",-0.0072847097367395,60,9,51,9.23776343870738,50.7622365612926
"2010","oh now",-0.0072847097367395,60,9,51,9.23776343870738,50.7622365612926
"2010","winter",-0.0072847097367395,60,9,51,9.23776343870738,50.7622365612926
"2010","youre mine",-0.0072847097367395,60,9,51,9.23776343870738,50.7622365612926
"2010","just way",-0.00745866792083227,106,16,90,16.3200487417164,89.6799512582836
"1990","guy",-0.00749908739356342,243,51,192,51.5511611108762,191.448838889124
"1980","gonna love",-0.00751354171615271,109,18,91,18.33769431315,90.66230568685
"1980","holdin",-0.00751514289829547,103,17,86,17.3282799472885,85.6717200527115
"1980","sunday",-0.00751514289829547,103,17,86,17.3282799472885,85.6717200527115
"1980","wave",-0.00753007098815983,97,16,81,16.3188655814271,80.6811344185729
"1980","hundred",-0.00754237232807142,121,20,101,20.3565230448729,100.643476955127
"1980","leave alone",-0.00754237232807142,121,20,101,20.3565230448729,100.643476955127
"1980","itll",-0.00760426006746029,133,22,111,22.3753517765959,110.624648223404
"1980","like love",-0.00761123247208551,85,14,71,14.3000368497041,70.6999631502959
"1980","fair",-0.00768528577833383,79,13,66,13.2906224838427,65.7093775161573
"1980","go crazy",-0.00768528577833383,79,13,66,13.2906224838427,65.7093775161573
"1980","seat",-0.00768528577833383,79,13,66,13.2906224838427,65.7093775161573
"1980","like one",-0.00778901781823171,73,12,61,12.2812081179812,60.7187918820188
"1970","heartache",-0.00790016764608914,75,10,65,10.2635918882323,64.7364081117677
"1970","youand",-0.00790016764608914,75,10,65,10.2635918882323,64.7364081117677
"1980","feel feel",-0.0079304342865022,67,11,56,11.2717937521197,55.7282062478803
"2000","away ive",-0.0079458585143487,23,6,17,6.18897080588663,16.8110291941134
"2000","call mr",-0.0079458585143487,23,6,17,6.18897080588663,16.8110291941134
"2000","dance want",-0.0079458585143487,23,6,17,6.18897080588663,16.8110291941134
"2000","else dont",-0.0079458585143487,23,6,17,6.18897080588663,16.8110291941134
"2000","every breath",-0.0079458585143487,23,6,17,6.18897080588663,16.8110291941134
"2000","fills",-0.0079458585143487,23,6,17,6.18897080588663,16.8110291941134
"2000","get close",-0.0079458585143487,23,6,17,6.18897080588663,16.8110291941134
"2000","get inside",-0.0079458585143487,23,6,17,6.18897080588663,16.8110291941134
"2000","goodbyes",-0.0079458585143487,23,6,17,6.18897080588663,16.8110291941134
"2000","head like",-0.0079458585143487,23,6,17,6.18897080588663,16.8110291941134
"2000","im every",-0.0079458585143487,23,6,17,6.18897080588663,16.8110291941134
"2000","ive love",-0.0079458585143487,23,6,17,6.18897080588663,16.8110291941134
"2000","keep head",-0.0079458585143487,23,6,17,6.18897080588663,16.8110291941134
"2000","never loved",-0.0079458585143487,23,6,17,6.18897080588663,16.8110291941134
"2000","one just",-0.0079458585143487,23,6,17,6.18897080588663,16.8110291941134
"2000","pouring rain",-0.0079458585143487,23,6,17,6.18897080588663,16.8110291941134
"2000","say anything",-0.0079458585143487,23,6,17,6.18897080588663,16.8110291941134
"2000","stop cause",-0.0079458585143487,23,6,17,6.18897080588663,16.8110291941134
"2000","thing ill",-0.0079458585143487,23,6,17,6.18897080588663,16.8110291941134
"2000","thing want",-0.0079458585143487,23,6,17,6.18897080588663,16.8110291941134
"2000","way im feeling",-0.0079458585143487,23,6,17,6.18897080588663,16.8110291941134
"2000","way take",-0.0079458585143487,23,6,17,6.18897080588663,16.8110291941134
"2000","whispers",-0.0079458585143487,23,6,17,6.18897080588663,16.8110291941134
"1990","baby im gonna",-0.00803593941706138,34,7,27,7.21291966160408,26.7870803383959
"1990","cared",-0.00803593941706138,34,7,27,7.21291966160408,26.7870803383959
"1990","got let",-0.00803593941706138,34,7,27,7.21291966160408,26.7870803383959
"1990","guess ill",-0.00803593941706138,34,7,27,7.21291966160408,26.7870803383959
"1990","life baby",-0.00803593941706138,34,7,27,7.21291966160408,26.7870803383959
"1990","now hold",-0.00803593941706138,34,7,27,7.21291966160408,26.7870803383959
"1990","rescue",-0.00803593941706138,34,7,27,7.21291966160408,26.7870803383959
"1990","seas",-0.00803593941706138,34,7,27,7.21291966160408,26.7870803383959
"1980","action",-0.00812070474099247,61,10,51,10.2623793862583,50.7376206137417
"1980","im just",-0.00814862175799513,462,77,385,77.724906171333,384.275093828667
"1990","really need",-0.00821766631205634,115,24,91,24.3966400318961,90.6033599681039
"1990","stronger",-0.00821766631205634,115,24,91,24.3966400318961,90.6033599681039
"1960","isnt",-0.00831734913345539,240,14,226,14.3335856142897,225.66641438571
"2010","dont dont",-0.00842711442731414,93,14,79,14.3185333299964,78.6814666700036
"2000","youre one",-0.00849557792921019,285,76,209,76.6894208555518,208.310579144448
"1990","heat",-0.00865667040801155,210,44,166,44.5503861452016,165.449613854798
"1980","chose",-0.00871999260752987,49,8,41,8.24355065453532,40.7564493454647
"1980","gods",-0.00871999260752987,49,8,41,8.24355065453532,40.7564493454647
"1980","love keep",-0.00871999260752987,49,8,41,8.24355065453532,40.7564493454647
"1980","mind im",-0.00871999260752987,49,8,41,8.24355065453532,40.7564493454647
"1980","right wrong",-0.00871999260752987,49,8,41,8.24355065453532,40.7564493454647
"1980","want girl",-0.00871999260752987,49,8,41,8.24355065453532,40.7564493454647
"1990","baby please",-0.00877156025150372,77,16,61,16.3351415865739,60.6648584134261
"2000","second",-0.00901117810865681,244,65,179,65.6569076798408,178.343092320159
"1980","aim",-0.00919044413401954,43,7,36,7.23413628867385,35.7658637113261
"1980","cost",-0.00919044413401954,43,7,36,7.23413628867385,35.7658637113261
"1980","gotta know",-0.00919044413401954,43,7,36,7.23413628867385,35.7658637113261
"1980","im real",-0.00919044413401954,43,7,36,7.23413628867385,35.7658637113261
"1980","know girl",-0.00919044413401954,43,7,36,7.23413628867385,35.7658637113261
"1980","mess around",-0.00919044413401954,43,7,36,7.23413628867385,35.7658637113261
"1980","settle",-0.00919044413401954,43,7,36,7.23413628867385,35.7658637113261
"1980","want ride",-0.00919044413401954,43,7,36,7.23413628867385,35.7658637113261
"2010","life im",-0.00919917495734346,47,7,40,7.23624802698745,39.7637519730126
"2010","make hot",-0.00919917495734346,47,7,40,7.23624802698745,39.7637519730126
"1970","pick",-0.00941673157353107,186,25,161,25.4537078828162,160.546292117184
"1970","awake",-0.0094802011753069,90,12,78,12.3163102658788,77.6836897341212
"1980","bit",-0.00952436309378069,540,90,450,90.8472929275321,449.152707072468
"1990","express",-0.00961625233116847,58,12,46,12.3043923639128,45.6956076360872
"1990","go cant",-0.00961625233116847,58,12,46,12.3043923639128,45.6956076360872
"2010","question",-0.00971294631565534,80,12,68,12.3170179182765,67.6829820817235
"2010","twenty",-0.00971294631565534,80,12,68,12.3170179182765,67.6829820817235
"1980","aint love",-0.00984917865694707,37,6,31,6.22472192281238,30.7752780771876
"1980","found someone",-0.00984917865694707,37,6,31,6.22472192281238,30.7752780771876
"1980","island",-0.00984917865694707,37,6,31,6.22472192281238,30.7752780771876
"1980","know ill never",-0.00984917865694707,37,6,31,6.22472192281238,30.7752780771876
"1980","let love let",-0.00984917865694707,37,6,31,6.22472192281238,30.7752780771876
"1980","lightning",-0.00984917865694707,37,6,31,6.22472192281238,30.7752780771876
"1980","like fool",-0.00984917865694707,37,6,31,6.22472192281238,30.7752780771876
"1980","love songs",-0.00984917865694707,37,6,31,6.22472192281238,30.7752780771876
"1980","nobody wants",-0.00984917865694707,37,6,31,6.22472192281238,30.7752780771876
"2010","stop",-0.009859524049737,1555,238,1317,239.4120357865,1315.5879642135
"2000","oh just",-0.00988262457442357,87,23,64,23.4104547874842,63.5895452125158
"2000","clock",-0.00992729600729714,72,19,53,19.3741694792973,52.6258305207027
"2000","see can",-0.00998283060564142,102,27,75,27.4467400956712,74.5532599043289
"2000","point",-0.0101721151476188,117,31,86,31.4830254038581,85.5169745961419
"2000","thats love",-0.0102315469766154,57,15,42,15.3378841711103,41.6621158288897
"2000","wheres",-0.0102315469766154,57,15,42,15.3378841711103,41.6621158288897
"1990","voice",-0.0102474859225976,177,37,140,37.5496111795271,139.450388820473
"1970","baby tonight",-0.0103212518147765,53,7,46,7.25293826768419,45.7470617323158
"1970","beggin",-0.0103212518147765,53,7,46,7.25293826768419,45.7470617323158
"1970","everybody get",-0.0103212518147765,53,7,46,7.25293826768419,45.7470617323158
"1970","like ive",-0.0103212518147765,53,7,46,7.25293826768419,45.7470617323158
"1970","ooh love",-0.0103212518147765,53,7,46,7.25293826768419,45.7470617323158
"2000","speak",-0.0107087245825921,147,39,108,39.555596020232,107.444403979768
"1970","dust",-0.011060234704528,105,14,91,14.3690286435253,90.6309713564747
"1970","seven",-0.011060234704528,105,14,91,14.3690286435253,90.6309713564747
"1970","survive",-0.011060234704528,105,14,91,14.3690286435253,90.6309713564747
"2000","cruise",-0.0110745768628812,42,11,31,11.3015988629234,30.6984011370766
"2000","every word",-0.0110745768628812,42,11,31,11.3015988629234,30.6984011370766
"2000","got go",-0.0110745768628812,42,11,31,11.3015988629234,30.6984011370766
"2000","just gonna",-0.0110745768628812,42,11,31,11.3015988629234,30.6984011370766
"2000","make see",-0.0110745768628812,42,11,31,11.3015988629234,30.6984011370766
"1960","ways",-0.0114231578473032,207,12,195,12.3627175923249,194.637282407675
"1990","completely",-0.011581769556264,39,8,31,8.27364314125173,30.7263568587483
"1990","feel can",-0.011581769556264,39,8,31,8.27364314125173,30.7263568587483
"1990","gonna play",-0.011581769556264,39,8,31,8.27364314125173,30.7263568587483
"1990","page",-0.011581769556264,39,8,31,8.27364314125173,30.7263568587483
"1990","please take",-0.011581769556264,39,8,31,8.27364314125173,30.7263568587483
"1990","wash away",-0.011581769556264,39,8,31,8.27364314125173,30.7263568587483
"1970","id never",-0.0117404439006826,68,9,59,9.30565664533066,58.6943433546693
"1980","sleep",-0.0118509650582435,433,72,361,72.8460700696692,360.153929930331
"1980","said",-0.0118667464329953,2163,362,1801,363.893878893059,1799.10612110694
"1960","live life",-0.012108750040687,122,7,115,7.28623935393062,114.713760646069
"1960","youre just",-0.012108750040687,122,7,115,7.28623935393062,114.713760646069
"2000","dance",-0.012295834977075,1542,413,1129,414.930129681617,1127.06987031838
"1990","im sorry",-0.0125707047810799,144,30,114,30.5488362138526,113.451163786147
"1970","hop",-0.0126402682336929,120,16,104,16.4217470211718,103.578252978828
"1970","sounds",-0.0126402682336929,120,16,104,16.4217470211718,103.578252978828
"1990","bright",-0.0126503718851885,277,58,219,58.7640807724803,218.23591922752
"1990","well never",-0.0127457756928612,63,13,50,13.3651158435605,49.6348841564395
"1970","believe",-0.0128970996429532,1245,169,1076,170.375625344657,1074.62437465534
"1960","ive",-0.0129365822423622,2652,157,2495,158.386121037902,2493.6138789621
"2000","wanna say",-0.0131756197379771,106,28,78,28.523082844521,77.476917155479
"2000","hundred",-0.0131958734240496,121,32,89,32.5593681527079,88.4406318472921
"1970","older",-0.0132178709209879,83,11,72,11.3583750229771,71.6416249770229
"2000","around like",-0.0133598194993295,27,7,20,7.26531355473648,19.7346864452635
"2000","card",-0.0133598194993295,27,7,20,7.26531355473648,19.7346864452635
"2000","grey",-0.0133598194993295,27,7,20,7.26531355473648,19.7346864452635
"2000","im head",-0.0133598194993295,27,7,20,7.26531355473648,19.7346864452635
"2000","long gone",-0.0133598194993295,27,7,20,7.26531355473648,19.7346864452635
"2000","lookin girl",-0.0133598194993295,27,7,20,7.26531355473648,19.7346864452635
"2000","night will",-0.0133598194993295,27,7,20,7.26531355473648,19.7346864452635
"2000","oh ive",-0.0133598194993295,27,7,20,7.26531355473648,19.7346864452635
"2000","pro",-0.0133598194993295,27,7,20,7.26531355473648,19.7346864452635
"2000","still see",-0.0133598194993295,27,7,20,7.26531355473648,19.7346864452635
"2000","stoned",-0.0133598194993295,27,7,20,7.26531355473648,19.7346864452635
"2000","things just",-0.0133598194993295,27,7,20,7.26531355473648,19.7346864452635
"2000","whats gonna",-0.0133598194993295,27,7,20,7.26531355473648,19.7346864452635
"2000","zero",-0.0133598194993295,27,7,20,7.26531355473648,19.7346864452635
"2000","take back",-0.013642062635512,76,20,56,20.4505122281471,55.5494877718529
"1970","care",-0.0137785752046868,702,95,607,96.0672200738548,605.932779926145
"2010","gonna find",-0.0138632597701469,87,13,74,13.3947569861257,73.6052430138743
"2010","buy",-0.0141178194813996,225,34,191,34.6416128951527,190.358387104847
"2010","cant tell",-0.0141632569224787,54,8,46,8.31398709483664,45.6860129051634
"2010","ever want",-0.0141632569224787,54,8,46,8.31398709483664,45.6860129051634
"2010","every girl",-0.0141632569224787,54,8,46,8.31398709483664,45.6860129051634
"2010","get lets get",-0.0141632569224787,54,8,46,8.31398709483664,45.6860129051634
"1970","never knew",-0.0142203017629086,135,18,117,18.4744653988182,116.525534601182
"1980","cant take",-0.0152899156143393,164,27,137,27.5906593335468,136.409340666453
"1990","cant stay",-0.0153377946205171,44,9,35,9.33436662089939,34.6656333791006
"1990","got baby",-0.0153377946205171,44,9,35,9.33436662089939,34.6656333791006
"1990","hypnotized",-0.0153377946205171,44,9,35,9.33436662089939,34.6656333791006
"1990","time well",-0.0153377946205171,44,9,35,9.33436662089939,34.6656333791006
"1980","one day",-0.0153705715566677,158,26,132,26.5812449676853,131.418755032315
"2000","blown",-0.0158917170286974,46,12,34,12.3779416117733,33.6220583882267
"1960","youd",-0.0159955820865929,412,24,388,24.6059886378641,387.394011362136
"1980","wings",-0.0160372007076379,128,21,107,21.534173138378,106.465826861622
"1990","know ive",-0.0160718788341228,68,14,54,14.4258393232082,53.5741606767919
"1990","notice",-0.0160718788341228,68,14,54,14.4258393232082,53.5741606767919
"1990","squeeze",-0.0160718788341228,68,14,54,14.4258393232082,53.5741606767919
"2010","dont matter",-0.0161966234887037,74,11,63,11.3932415744058,62.6067584255942
"2010","get head",-0.0161966234887037,74,11,63,11.3932415744058,62.6067584255942
"1970","much better",-0.0162323305688081,46,6,40,6.29500302478251,39.7049969752175
"1970","needing",-0.0162323305688081,46,6,40,6.29500302478251,39.7049969752175
"1970","never met",-0.0162323305688081,46,6,40,6.29500302478251,39.7049969752175
"1970","oh baby baby",-0.0162323305688081,46,6,40,6.29500302478251,39.7049969752175
"1970","yeah like",-0.0162323305688081,46,6,40,6.29500302478251,39.7049969752175
"1990","cant see",-0.0164723535793554,306,64,242,64.9162769544367,241.083723045563
"2000","dont make",-0.016504316759703,125,33,92,33.6357109015578,91.3642890984422
"1970","can take",-0.0167841891424558,261,35,226,35.7172997710486,225.282700228951
"2010","fame",-0.016997656052397,140,21,119,21.5547813569839,118.445218643016
"2010","spend",-0.0171015598992672,291,44,247,44.8031526777308,246.196847322269
"1980","welcome",-0.0174399852150597,98,16,82,16.4871013090706,81.5128986909294
"1990","surprise",-0.0175176050813286,92,19,73,19.5173120255169,72.4826879744831
"2000","dance night",-0.0177337912909319,80,21,59,21.526854976997,58.473145023003
"1970","find another",-0.0180590322723241,76,10,66,10.4004397800754,65.5995602199246
"1970","im trying",-0.0180590322723241,76,10,66,10.4004397800754,65.5995602199246
"1970","married",-0.0180590322723241,76,10,66,10.4004397800754,65.5995602199246
"1980","deserve",-0.0183808882680391,86,14,72,14.4682725773477,71.5317274226523
"1980","highway",-0.0183808882680391,86,14,72,14.4682725773477,71.5317274226523
"2010","back want back",-0.0185356805902767,41,6,35,6.31247168311671,34.6875283168833
"2010","now look",-0.0185356805902767,41,6,35,6.31247168311671,34.6875283168833
"2010","say can",-0.0185356805902767,41,6,35,6.31247168311671,34.6875283168833
"2010","time just",-0.0185356805902767,41,6,35,6.31247168311671,34.6875283168833
"2010","time time time",-0.0185356805902767,41,6,35,6.31247168311671,34.6875283168833
"2010","want back want back",-0.0185356805902767,41,6,35,6.31247168311671,34.6875283168833
"1990","needs",-0.0186465429849296,235,49,186,49.8540035434399,185.14599645656
"1960","another day",-0.0186762292388346,106,6,100,6.33066697964464,99.6693330203554
"1960","lose",-0.0189653425794454,684,40,644,40.8507190007258,643.149280999274
"1960","came",-0.0191759890466865,701,41,660,41.8660146484046,659.133985351595
"1990","fake",-0.0192325046623369,116,24,92,24.6087847278257,91.3912152721743
"1990","sock",-0.0192399866728803,49,10,39,10.3950901005471,38.604909899453
"1990","well take",-0.0192399866728803,49,10,39,10.3950901005471,38.604909899453
"2010","funk",-0.0192416026526712,206,31,175,31.716321139562,174.283678860438
"2000","appeal",-0.0193145685301316,31,8,23,8.34165630358633,22.6583436964137
"2000","come alive",-0.0193145685301316,31,8,23,8.34165630358633,22.6583436964137
"2000","eternity",-0.0193145685301316,31,8,23,8.34165630358633,22.6583436964137
"2000","fine youre",-0.0193145685301316,31,8,23,8.34165630358633,22.6583436964137
"2000","gonna know",-0.0193145685301316,31,8,23,8.34165630358633,22.6583436964137
"2000","lets start",-0.0193145685301316,31,8,23,8.34165630358633,22.6583436964137
"2000","love hate",-0.0193145685301316,31,8,23,8.34165630358633,22.6583436964137
"2000","sucker",-0.0193145685301316,31,8,23,8.34165630358633,22.6583436964137
"1960","everyday",-0.0194833887596935,243,14,229,14.5127554344684,228.487244565532
"2010","now oh",-0.0195366595428803,61,9,52,9.39172616268583,51.6082738373142
"1980","will will",-0.0196983573138941,74,12,62,12.4494438456248,61.5505561543752
"2000","one night",-0.019763429607017,159,42,117,42.7846242667815,116.215375733218
"1980","notice",-0.0205611091277291,68,11,57,11.4400294797633,56.5599705202367
"1980","squeeze",-0.0205611091277291,68,11,57,11.4400294797633,56.5599705202367
"2000","forward",-0.0211383042642679,50,13,37,13.4542843606231,36.5457156393769
"2000","ill get",-0.0211383042642679,50,13,37,13.4542843606231,36.5457156393769
"2000","next time",-0.0211383042642679,50,13,37,13.4542843606231,36.5457156393769
"2000","whoa whoa whoa whoa",-0.0211383042642679,50,13,37,13.4542843606231,36.5457156393769
"2010","summer",-0.0215606810812432,331,50,281,50.961661636869,280.038338363131
"1980","mountains",-0.0216129924811406,62,10,52,10.4306151139018,51.5693848860982
"1980","sorrow",-0.0216129924811406,62,10,52,10.4306151139018,51.5693848860982
"2010","car",-0.0216183650727197,390,59,331,60.045462351598,329.954537648402
"1990","scene",-0.0223068388417051,121,25,96,25.6695082074733,95.3304917925267
"1990","treat",-0.0225783941111031,321,67,254,68.0984473933797,252.90155260662
"1980","guns",-0.0229154035316194,56,9,47,9.42120074804036,46.5787992519596
"1980","love heart",-0.0229154035316194,56,9,47,9.42120074804036,46.5787992519596
"1980","natural",-0.0229154035316194,56,9,47,9.42120074804036,46.5787992519596
"1980","naughty",-0.0229154035316194,56,9,47,9.42120074804036,46.5787992519596
"1980","pictures",-0.0229154035316194,56,9,47,9.42120074804036,46.5787992519596
"1980","tell whats",-0.0229154035316194,56,9,47,9.42120074804036,46.5787992519596
"2000","say goodbye",-0.0230877630430479,178,47,131,47.8972523238183,130.102747676182
"1990","pimp",-0.023163539112528,78,16,62,16.5472862825035,61.4527137174965
"2010","dont go",-0.0234680676967169,167,25,142,25.7117749044022,141.288225095598
"1960","ground",-0.0235656118815744,278,16,262,16.603070003219,261.396929996781
"1970","til",-0.0237368672602587,594,80,514,81.2876477548002,512.7123522452
"2000","another one",-0.023837575543046,69,18,51,18.5669124176599,50.4330875823401
"2000","riding",-0.023837575543046,69,18,51,18.5669124176599,50.4330875823401
"2000","thought id",-0.023837575543046,69,18,51,18.5669124176599,50.4330875823401
"1960","pretend",-0.0240508421725222,124,7,117,7.40568590071637,116.594314099284
"1990","dont try",-0.0241078182512198,102,21,81,21.6387589848122,80.3612410151878
"1970","breaks",-0.0241818397934829,54,7,47,7.38978615952729,46.6102138404727
"1970","dont remember",-0.0241818397934829,54,7,47,7.38978615952729,46.6102138404727
"1970","electric",-0.0241818397934829,54,7,47,7.38978615952729,46.6102138404727
"1970","ever since",-0.0241818397934829,54,7,47,7.38978615952729,46.6102138404727
"1970","one chance",-0.0241818397934829,54,7,47,7.38978615952729,46.6102138404727
"1990","lovin",-0.0242855871594192,625,131,494,132.590434955957,492.409565044043
"1980","shore",-0.0245595402843324,50,8,42,8.4117863821789,41.5882136178211
"1980","softly",-0.0245595402843324,50,8,42,8.4117863821789,41.5882136178211
"1980","want give",-0.0245595402843324,50,8,42,8.4117863821789,41.5882136178211
"1970","cause aint",-0.0250225254793638,84,11,73,11.4952229148202,72.5047770851798
"2000","eight",-0.0254339489116699,103,27,76,27.7158257828836,75.2841742171164
"2000","rough",-0.0254339489116699,103,27,76,27.7158257828836,75.2841742171164
"2000","compare",-0.0256258040928501,35,9,26,9.41799905243618,25.5820009475638
"1960","sitting",-0.0258629245347809,107,6,101,6.39039025303751,100.609609746962
"1960","will come",-0.0258629245347809,107,6,101,6.39039025303751,100.609609746962
"1980","theyll",-0.0265810997970397,141,23,118,23.7212375977445,117.278762402256
"1980","cries",-0.0266869854063807,44,7,37,7.40237201631743,36.5976279836826
"1980","everything need",-0.0266869854063807,44,7,37,7.40237201631743,36.5976279836826
"1980","get baby",-0.0266869854063807,44,7,37,7.40237201631743,36.5976279836826
"1980","throwing",-0.0266869854063807,44,7,37,7.40237201631743,36.5976279836826
"1980","want need",-0.0266869854063807,44,7,37,7.40237201631743,36.5976279836826
"2000","couldnt see",-0.026719638998659,54,14,40,14.530627109473,39.469372890527
"2000","life dont",-0.026719638998659,54,14,40,14.530627109473,39.469372890527
"2000","wanna love",-0.0268444292464121,88,23,65,23.6795404746967,64.3204595253033
"1990","always will",-0.026854950134876,30,6,24,6.36434087788595,23.6356591221141
"1990","can leave",-0.026854950134876,30,6,24,6.36434087788595,23.6356591221141
"1990","everything alright",-0.026854950134876,30,6,24,6.36434087788595,23.6356591221141
"1990","floor dont",-0.026854950134876,30,6,24,6.36434087788595,23.6356591221141
"1990","just much",-0.026854950134876,30,6,24,6.36434087788595,23.6356591221141
"1990","let love let love",-0.026854950134876,30,6,24,6.36434087788595,23.6356591221141
"1990","mike",-0.026854950134876,30,6,24,6.36434087788595,23.6356591221141
"1990","sounds like",-0.026854950134876,30,6,24,6.36434087788595,23.6356591221141
"1990","vibe",-0.026854950134876,30,6,24,6.36434087788595,23.6356591221141
"1990","wouldve",-0.026854950134876,30,6,24,6.36434087788595,23.6356591221141
"1970","drink",-0.0268788031756606,292,39,253,39.9595844181846,252.040415581815
"1980","never knew",-0.0270493455293901,135,22,113,22.711823231883,112.288176768117
"1990","ooh baby",-0.0271033796683271,150,31,119,31.8217043894297,118.17829561057
"2000","pride",-0.0272841252710241,152,40,112,40.9010244562943,111.098975543706
"1990","girl aint",-0.0273348391122898,59,12,47,12.5165370598424,46.4834629401576
"1990","waiting waiting",-0.0273348391122898,59,12,47,12.5165370598424,46.4834629401576
"1980","love need",-0.0275713324020539,129,21,108,21.7024088660216,107.297591133978
"2010","cause cant",-0.0283265138449573,108,16,92,16.6279741896733,91.3720258103267
"2000","id rather",-0.0287579305915504,122,32,90,32.8284538399204,89.1715461600796
"2000","youre just",-0.0287579305915504,122,32,90,32.8284538399204,89.1715461600796
"1960","love will",-0.0288713958692832,262,15,247,15.647497628933,246.352502371067
"1980","gonna fall",-0.0295300858279545,38,6,32,6.39295765045596,31.607042349544
"1980","look way",-0.0295300858279545,38,6,32,6.39295765045596,31.607042349544
"1980","love little",-0.0295300858279545,38,6,32,6.39295765045596,31.607042349544
"1980","match",-0.0295300858279545,38,6,32,6.39295765045596,31.607042349544
"1980","smart",-0.0295300858279545,38,6,32,6.39295765045596,31.607042349544
"1980","oh love",-0.029547535970796,111,18,93,18.6741657684371,92.3258342315629
"2000","thinking",-0.0298515876956325,452,120,332,121.626730620033,330.373269379967
"2010","give one",-0.0310397117519063,55,8,47,8.4679498188151,46.5320501811849
"2010","know make",-0.0310397117519063,55,8,47,8.4679498188151,46.5320501811849
"2010","love gonna",-0.0310397117519063,55,8,47,8.4679498188151,46.5320501811849
"2010","ticket",-0.0310397117519063,55,8,47,8.4679498188151,46.5320501811849
"2010","worry bout",-0.0310397117519063,55,8,47,8.4679498188151,46.5320501811849
"1960","makes",-0.0313219768823463,739,43,696,44.1354990373338,694.864500962666
"1990","babe dont",-0.0313307751573677,35,7,28,7.42506435753361,27.5749356424664
"1990","buzz",-0.0313307751573677,35,7,28,7.42506435753361,27.5749356424664
"1990","can count",-0.0313307751573677,35,7,28,7.42506435753361,27.5749356424664
"1990","feel know",-0.0313307751573677,35,7,28,7.42506435753361,27.5749356424664
"1990","gang",-0.0313307751573677,35,7,28,7.42506435753361,27.5749356424664
"1990","just long",-0.0313307751573677,35,7,28,7.42506435753361,27.5749356424664
"1990","oh thats",-0.0313307751573677,35,7,28,7.42506435753361,27.5749356424664
"1990","romeo",-0.0313307751573677,35,7,28,7.42506435753361,27.5749356424664
"1990","walk door",-0.0313307751573677,35,7,28,7.42506435753361,27.5749356424664
"1990","whyd",-0.0313307751573677,35,7,28,7.42506435753361,27.5749356424664
"1990","without dont",-0.0313307751573677,35,7,28,7.42506435753361,27.5749356424664
"1980","aint nothin",-0.0313322304963972,99,16,83,16.6553370367142,82.3446629632858
"1980","like dont",-0.0313322304963972,99,16,83,16.6553370367142,82.3446629632858
"1960","love want",-0.0314775319377892,125,7,118,7.46540917410924,117.534590825891
"1990","give just",-0.0314822865772271,64,13,51,13.57726053949,50.42273946051
"1990","know wont",-0.0314822865772271,64,13,51,13.57726053949,50.42273946051
"2010","gonna let",-0.0320932393974545,95,14,81,14.6264587779533,80.3735412220467
"2010","ride ride",-0.0320932393974545,95,14,81,14.6264587779533,80.3735412220467
"2000","cab",-0.0321844323586408,39,10,29,10.494341801286,28.505658198714
"2000","feel can",-0.0321844323586408,39,10,29,10.494341801286,28.505658198714
"2000","fifty",-0.0321844323586408,39,10,29,10.494341801286,28.505658198714
"2000","gonna play",-0.0321844323586408,39,10,29,10.494341801286,28.505658198714
"2000","ill right",-0.0321844323586408,39,10,29,10.494341801286,28.505658198714
"2000","like uh",-0.0321844323586408,39,10,29,10.494341801286,28.505658198714
"2000","never change",-0.0321844323586408,39,10,29,10.494341801286,28.505658198714
"2010","yeah oh",-0.0324985783219487,214,32,182,32.9480229313897,181.05197706861
"2000","night can",-0.0325669611180559,58,15,43,15.6069698583228,42.3930301416772
"1970","need baby",-0.0325915449440686,62,8,54,8.48456929427207,53.5154307057279
"1970","sunlight",-0.0325915449440686,62,8,54,8.48456929427207,53.5154307057279
"2010","new",-0.0332138241935418,1223,186,1037,188.296411425652,1034.70358857435
"2000","slowly",-0.033223730588636,126,33,93,33.9047965887702,92.0952034112297
"1970","baby wont",-0.0342480841050488,47,6,41,6.4318509166256,40.5681490833744
"1970","gonna die",-0.0342480841050488,47,6,41,6.4318509166256,40.5681490833744
"1970","makes want",-0.0342480841050488,47,6,41,6.4318509166256,40.5681490833744
"1970","pop pop",-0.0342480841050488,47,6,41,6.4318509166256,40.5681490833744
"1970","say oh",-0.0342480841050488,47,6,41,6.4318509166256,40.5681490833744
"1970","werent",-0.0342480841050488,47,6,41,6.4318509166256,40.5681490833744
"2010","feels like",-0.0345679486841584,168,25,143,25.8657376283807,142.134262371619
"1960","maybe",-0.0346710936930812,740,43,697,44.1952223107267,695.804777689273
"1970","call",-0.0348660240620475,1553,210,1343,212.524776032331,1340.47522396767
"1980","know feel",-0.0351296942955637,81,13,68,13.6270939391298,67.3729060608702
"1980","will see",-0.0351296942955637,81,13,68,13.6270939391298,67.3729060608702
"2010","first time",-0.0354081423061967,135,20,115,20.7849677370916,114.215032262908
"1990","holds",-0.0356771555156514,69,14,55,14.6379840191377,54.3620159808623
"1990","lived",-0.0356771555156514,69,14,55,14.6379840191377,54.3620159808623
"1990","spell",-0.0356771555156514,69,14,55,14.6379840191377,54.3620159808623
"1990","therell",-0.0356771555156514,69,14,55,14.6379840191377,54.3620159808623
"1990","cause want",-0.0358066001798488,40,8,32,8.48578783718126,31.5142121628187
"1990","get mind",-0.0358066001798488,40,8,32,8.48578783718126,31.5142121628187
"1990","ill let",-0.0358066001798488,40,8,32,8.48578783718126,31.5142121628187
"1990","rest life",-0.0358066001798488,40,8,32,8.48578783718126,31.5142121628187
"1990","see girl",-0.0358066001798488,40,8,32,8.48578783718126,31.5142121628187
"1990","suit",-0.0358066001798488,40,8,32,8.48578783718126,31.5142121628187
"1990","wanna play",-0.0358066001798488,40,8,32,8.48578783718126,31.5142121628187
"1990","want let",-0.0358066001798488,40,8,32,8.48578783718126,31.5142121628187
"1990","way just",-0.0358066001798488,40,8,32,8.48578783718126,31.5142121628187
"1980","know whats",-0.0368393104264986,75,12,63,12.6176795732683,62.3823204267317
"2010","carry",-0.0368559647167124,221,33,188,34.0257619992388,186.974238000761
"2000","mary",-0.0369359640729958,96,25,71,25.8322259723964,70.1677740276036
"2000","worlds",-0.0369359640729958,96,25,71,25.8322259723964,70.1677740276036
"2010","treat like",-0.0370713611805533,82,12,70,12.6249433662334,69.3750566337666
"1990","miss",-0.0371974996990927,717,150,567,152.107746981474,564.892253018526
"2010","know gotta",-0.0374641648627736,62,9,53,9.54568888666429,52.4543111133357
"2010","fix",-0.0377909484869361,102,15,87,15.7041978458025,86.2958021541975
"1980","whoa oh",-0.0379637764964926,160,26,134,26.9177164229725,133.082283577028
"1980","room",-0.0385171869617893,389,64,325,65.4436980533518,323.556301946648
"2000","busy",-0.0386291370602632,62,16,46,16.6833126071727,45.3166873928273
"2000","surrender",-0.0386291370602632,62,16,46,16.6833126071727,45.3166873928273
"1980","know cause",-0.0388684785026752,69,11,58,11.6082652074069,57.3917347925931
"1980","sang",-0.0388684785026752,69,11,58,11.6082652074069,57.3917347925931
"2000","gonna stand",-0.0389217546667915,43,11,32,11.5706845501359,31.4293154498641
"2000","hands hands",-0.0389217546667915,43,11,32,11.5706845501359,31.4293154498641
"2000","oh god",-0.0389217546667915,43,11,32,11.5706845501359,31.4293154498641
"1990","candy",-0.0391088676119937,146,30,116,30.9731256057116,115.026874394288
"1990","type",-0.0391088676119937,146,30,116,30.9731256057116,115.026874394288
"2000","jump jump",-0.0397292925717436,115,30,85,30.9448540294332,84.0551459705668
"1980","kick",-0.0398207531643,329,54,275,55.3495543947371,273.650445605263
"1960","raise",-0.0398534064572349,126,7,119,7.52513244750212,118.474867552498
"1990","dont matter",-0.0399098652668359,74,15,59,15.6987074987853,58.3012925012147
"1990","feel right",-0.0399098652668359,74,15,59,15.6987074987853,58.3012925012147
"2000","cant deny",-0.0400794584979884,81,21,60,21.7959406642094,59.2040593357906
"2000","never leave",-0.0400794584979884,81,21,60,21.7959406642094,59.2040593357906
"1990","depend",-0.0402824252023322,45,9,36,9.54651131682892,35.4534886831711
"1990","night away",-0.0402824252023322,45,9,36,9.54651131682892,35.4534886831711
"1990","wanna ride",-0.0402824252023322,45,9,36,9.54651131682892,35.4534886831711
"1990","worries",-0.0402824252023322,45,9,36,9.54651131682892,35.4534886831711
"2010","don",-0.0405801968323662,42,6,36,6.46643440709516,35.5335655929048
"2010","never really",-0.0405801968323662,42,6,36,6.46643440709516,35.5335655929048
"2010","thing like",-0.0405801968323662,42,6,36,6.46643440709516,35.5335655929048
"2010","whether",-0.0405801968323662,42,6,36,6.46643440709516,35.5335655929048
"1970","come let",-0.0413049025032994,70,9,61,9.57935242901686,60.4206475709831
"1970","thatll",-0.0413049025032994,70,9,61,9.57935242901686,60.4206475709831
"1980","bigger",-0.0413097263961346,63,10,53,10.5988508415454,52.4011491584546
"1980","doo doo doo",-0.0413097263961346,63,10,53,10.5988508415454,52.4011491584546
"1980","ghost",-0.0413097263961346,63,10,53,10.5988508415454,52.4011491584546
"1970","dont get",-0.0419916781271734,145,19,126,19.8429443172492,125.157055682751
"1990","sunday",-0.0424653078625867,103,21,82,21.8509036807418,81.1490963192582
"1990","sweet love",-0.0424653078625867,103,21,82,21.8509036807418,81.1490963192582
"1970","sound",-0.0426609052888809,405,54,351,55.4233961964547,349.576603803545
"2000","know cant",-0.0426979275149839,134,35,99,36.0574820864699,97.9425179135301
"1990","babe",-0.0429711195521678,675,141,534,143.197669752434,531.802330247566
"1990","follow",-0.0429994940552159,218,45,173,46.2475437126379,171.752456287362
"1990","turn around",-0.0429994940552159,218,45,173,46.2475437126379,171.752456287362
"1990","used",-0.0430149808738518,732,153,579,155.289917420417,576.710082579583
"2010","crib",-0.0432034580736949,89,13,76,13.7026824340826,75.2973175659174
"1980","pretend",-0.0432259849622811,124,20,104,20.8612302278037,103.138769772196
"1970","threw",-0.0435596762219701,55,7,48,7.52663405137039,47.4733659486296
"2010","come around",-0.0439571103877376,69,10,59,10.6234279545135,58.3765720454865
"2010","news",-0.0439571103877376,69,10,59,10.6234279545135,58.3765720454865
"2010","say want",-0.0439571103877376,69,10,59,10.6234279545135,58.3765720454865
"2010","throw hands",-0.0439571103877376,69,10,59,10.6234279545135,58.3765720454865
"1980","away im",-0.0442951287419295,57,9,48,9.58943647568394,47.4105635243161
"1980","cant sleep",-0.0442951287419295,57,9,48,9.58943647568394,47.4105635243161
"1980","hardly",-0.0442951287419295,57,9,48,9.58943647568394,47.4105635243161
"1980","letting go",-0.0442951287419295,57,9,48,9.58943647568394,47.4105635243161
"1980","shake body",-0.0442951287419295,57,9,48,9.58943647568394,47.4105635243161
"1980","signs",-0.0442951287419295,57,9,48,9.58943647568394,47.4105635243161
"1980","lock",-0.0444561198706928,118,19,99,19.8518158619422,98.1481841380578
"2010","trip",-0.0446711078542632,129,19,110,19.8611913932209,109.138808606779
"1990","girl got",-0.0447582502248136,50,10,40,10.6072347964766,39.3927652035234
"1990","grew",-0.0447582502248136,50,10,40,10.6072347964766,39.3927652035234
"1990","long ago",-0.0447582502248136,50,10,40,10.6072347964766,39.3927652035234
"1990","cant help",-0.044832179369759,199,41,158,42.2167944899768,156.783205510023
"2000","shines",-0.0448673514383229,66,17,49,17.7596553560225,48.2403446439775
"2000","way dont",-0.0448673514383229,66,17,49,17.7596553560225,48.2403446439775
"1980","deep",-0.0451111233513961,606,100,506,101.950850952008,504.049149047992
"2000","girl gonna",-0.0451436114483343,24,6,18,6.45805649309909,17.5419435069009
"2000","good bad",-0.0451436114483343,24,6,18,6.45805649309909,17.5419435069009
"2000","keisha",-0.0451436114483343,24,6,18,6.45805649309909,17.5419435069009
"2000","l o",-0.0451436114483343,24,6,18,6.45805649309909,17.5419435069009
"2000","like girls",-0.0451436114483343,24,6,18,6.45805649309909,17.5419435069009
"2000","little boy",-0.0451436114483343,24,6,18,6.45805649309909,17.5419435069009
"2000","loud im",-0.0451436114483343,24,6,18,6.45805649309909,17.5419435069009
"2000","love last",-0.0451436114483343,24,6,18,6.45805649309909,17.5419435069009
"2000","nerve",-0.0451436114483343,24,6,18,6.45805649309909,17.5419435069009
"2000","oh aint",-0.0451436114483343,24,6,18,6.45805649309909,17.5419435069009
"2000","screams",-0.0451436114483343,24,6,18,6.45805649309909,17.5419435069009
"2000","take breath away",-0.0451436114483343,24,6,18,6.45805649309909,17.5419435069009
"2000","thats want",-0.0451436114483343,24,6,18,6.45805649309909,17.5419435069009
"2000","touch sky",-0.0451436114483343,24,6,18,6.45805649309909,17.5419435069009
"2000","turn head",-0.0451436114483343,24,6,18,6.45805649309909,17.5419435069009
"2000","want everything",-0.0451436114483343,24,6,18,6.45805649309909,17.5419435069009
"2000","wop",-0.0451436114483343,24,6,18,6.45805649309909,17.5419435069009
"2000","youno",-0.0451436114483343,24,6,18,6.45805649309909,17.5419435069009
"1960","dont really",-0.0455467502368361,144,8,136,8.60015136857385,135.399848631426
"2000","began",-0.0457923541838252,47,12,35,12.6470272989857,34.3529727010143
"2000","ill see",-0.0457923541838252,47,12,35,12.6470272989857,34.3529727010143
"2000","tricks",-0.0457923541838252,47,12,35,12.6470272989857,34.3529727010143
"2000","wanna hold",-0.0457923541838252,47,12,35,12.6470272989857,34.3529727010143
"1980","plan",-0.0458308070632387,112,18,94,18.8424014960807,93.1575985039193
"1960","win",-0.0461328654746147,196,11,185,11.7057615850033,184.294238414997
"1990","gonna make",-0.0463148081440563,266,55,211,56.4304891172554,209.569510882745
"1990","cause cant",-0.046495852388402,108,22,86,22.9116271603894,85.0883728396106
"1990","thought",-0.0471065230302141,799,167,632,169.503612047696,629.496387952304
"1970","dont let",-0.0472310094013841,324,43,281,44.3387169571637,279.661283042836
"2010","lets get lets get",-0.0473435629710923,49,7,42,7.54417347494436,41.4558265250556
"2010","now aint",-0.0473435629710923,49,7,42,7.54417347494436,41.4558265250556
"2010","right wrong",-0.0473435629710923,49,7,42,7.54417347494436,41.4558265250556
"2010","want girl",-0.0473435629710923,49,7,42,7.54417347494436,41.4558265250556
"2010","youre always",-0.0473435629710923,49,7,42,7.54417347494436,41.4558265250556
"1980","another day",-0.0473748519635144,106,17,89,17.8329871302193,88.1670128697807
"2000","king",-0.047675151086092,138,36,102,37.1338248353198,100.86617516468
"1990","ready",-0.0479518372929295,571,119,452,121.134621375763,449.865378624237
"1980","gonna stay",-0.0480199686614362,51,8,43,8.58002210982247,42.4199778901775
"1980","nation",-0.0480199686614362,51,8,43,8.58002210982247,42.4199778901775
"1980","spirit",-0.0480199686614362,51,8,43,8.58002210982247,42.4199778901775
"1980","will let",-0.0480199686614362,51,8,43,8.58002210982247,42.4199778901775
"1990","sand",-0.0484618569756172,84,17,67,17.8201544580807,66.1798455419193
"1970","king",-0.048696991706477,138,18,120,18.8850090743475,119.114990925652
"1970","tears",-0.0489442136438685,502,67,435,68.6976417052352,433.302358294765
"1990","blessed",-0.0492340752472946,55,11,44,11.6679582761242,43.3320417238758
"1990","love oh",-0.0495242910959073,228,47,181,48.3689906719332,179.631009328067
"1990","get away",-0.0498739286126963,137,28,109,29.0638233423458,107.936176657654
"1970","bye bye",-0.0502291419739707,78,10,68,10.6741355637616,67.3258644362384
"1970","whoa",-0.0503134892410086,687,92,595,94.0145016962083,592.985498303792
"2010","im trying",-0.0504996907048512,76,11,65,11.7011670223627,64.2988329776373
"1990","just get",-0.0505656314546237,113,23,90,23.9723506400371,89.0276493599629
"1970","bye",-0.0509429169842859,183,24,159,25.0431642072869,157.956835792713
"1970","now youre",-0.0509429169842859,183,24,159,25.0431642072869,157.956835792713
"2000","hours",-0.0512516081857002,70,18,52,18.8359981048724,51.1640018951276
"1960","cause know",-0.0517258490695618,214,12,202,12.780780506075,201.219219493925
"2000","dont ya",-0.0526675466897235,28,7,21,7.53439924194894,20.4656007580511
"2000","killin",-0.0526675466897235,28,7,21,7.53439924194894,20.4656007580511
"2000","lettin",-0.0526675466897235,28,7,21,7.53439924194894,20.4656007580511
"2000","thing can",-0.0526675466897235,28,7,21,7.53439924194894,20.4656007580511
"2000","tour",-0.0526675466897235,28,7,21,7.53439924194894,20.4656007580511
"2010","whats",-0.0527542964631449,847,128,719,130.406427209752,716.593572790248
"2000","gonna change",-0.0527650032742661,51,13,38,13.7233700478356,37.2766299521644
"2000","table",-0.0527650032742661,51,13,38,13.7233700478356,37.2766299521644
"1990","sweet sweet",-0.0527714385636504,89,18,71,18.8808779377283,70.1191220622717
"1980","baby ive",-0.0527857040175943,45,7,38,7.57060774396101,37.429392256039
"1980","night away",-0.0527857040175943,45,7,38,7.57060774396101,37.429392256039
"1980","stop now",-0.0527857040175943,45,7,38,7.57060774396101,37.429392256039
"1990","nice",-0.0528642402720951,233,48,185,49.4297141515809,183.570285848419
"1970","just gotta",-0.0529818084791511,63,8,55,8.62141718611517,54.3785828138848
"1970","yeah now",-0.0529818084791511,63,8,55,8.62141718611517,54.3785828138848
"2000","now got",-0.0534392779973181,108,28,80,29.0612542189459,78.9387457810541
"1990","lane",-0.0537099002697521,60,12,48,12.7286817557719,47.2713182442281
"1990","see want",-0.0537099002697521,60,12,48,12.7286817557719,47.2713182442281
"1990","winter",-0.0537099002697521,60,12,48,12.7286817557719,47.2713182442281
"1990","ya got",-0.0537099002697521,60,12,48,12.7286817557719,47.2713182442281
"1960","know really",-0.0540019867306887,110,6,104,6.56956007321613,103.430439926784
"1960","take take",-0.0540019867306887,110,6,104,6.56956007321613,103.430439926784
"1980","even though",-0.0540324812028574,155,25,130,26.0765377847546,128.923462215245
"2010","careful",-0.0541069291098215,56,8,48,8.62191254279355,47.3780874572064
"2010","cause thats",-0.0541069291098215,56,8,48,8.62191254279355,47.3780874572064
"1980","hanging",-0.0552490421854497,149,24,125,25.0671234188931,123.932876581107
"2010","one can",-0.0557237031508424,103,15,88,15.858160569781,87.141839430219
"1980","angels",-0.0559983399646915,82,13,69,13.7953296667734,68.2046703332266
"2010","crying",-0.0566530276899146,216,32,184,33.2559483793466,182.744051620653
"1960","feel way",-0.0569334377960495,180,10,170,10.7501892107173,169.249810789283
"1990","finger",-0.0570986591707963,94,19,75,19.941601417376,74.058398582624
"2010","belong",-0.0574568887503291,302,45,257,46.4967426414938,255.503257358506
"2000","tall",-0.0577583602368716,74,19,55,19.9123408537222,54.0876591462778
"2000","death",-0.05794370559037,93,24,69,25.024968910759,67.975031089241
"1990","bus",-0.0581857252922315,65,13,52,13.7894052354196,51.2105947645804
"1990","stranger",-0.0581857252922315,65,13,52,13.7894052354196,51.2105947645804
"1970","time think",-0.0584927603893586,48,6,42,6.5686988084687,41.4313011915313
"1970","want tell",-0.0584927603893586,48,6,42,6.5686988084687,41.4313011915313
"1970","youbaby",-0.0584927603893586,48,6,42,6.5686988084687,41.4313011915313
"1960","time",-0.0588618027650192,5176,305,4871,309.127663081515,4866.87233691848
"1960","can make",-0.0589045295359463,370,21,349,22.0976111553634,347.902388844637
"1980","girl love",-0.0590601716559089,76,12,64,12.7859153009119,63.2140846990881
"1980","rock rock rock",-0.0590835141263482,39,6,33,6.56119337809954,32.4388066219005
"1980","youre doin",-0.0590835141263482,39,6,33,6.56119337809954,32.4388066219005
"2000","mic",-0.0598175235507639,55,14,41,14.7997127966854,40.2002872033146
"2000","worry bout",-0.0598175235507639,55,14,41,14.7997127966854,40.2002872033146
"2000","feeling like",-0.0601914819311127,32,8,24,8.61074199079879,23.3892580092012
"2000","glue",-0.0601914819311127,32,8,24,8.61074199079879,23.3892580092012
"2000","miami",-0.0601914819311127,32,8,24,8.61074199079879,23.3892580092012
"2000","need want",-0.0601914819311127,32,8,24,8.61074199079879,23.3892580092012
"2000","things dont",-0.0601914819311127,32,8,24,8.61074199079879,23.3892580092012
"2000","though im",-0.0601914819311127,32,8,24,8.61074199079879,23.3892580092012
"2000","time cant",-0.0601914819311127,32,8,24,8.61074199079879,23.3892580092012
"2000","games",-0.0607308078117437,165,43,122,44.3991383900563,120.600861609944
"2010","just gotta",-0.0608702952485494,63,9,54,9.69965161064275,53.3003483893573
"2010","now want",-0.0608702952485494,63,9,54,9.69965161064275,53.3003483893573
"1990","leaving",-0.0615933305378209,200,41,159,42.4289391859063,157.571060814094
"1970","blow",-0.0619275108886583,318,42,276,43.5176296061051,274.482370393895
"2010","go home",-0.0620794235038127,110,16,94,16.9358996376302,93.0641003623698
"1960","enough",-0.062109531565131,798,46,752,47.6591721675134,750.340827832487
"1990","fell",-0.062233965385917,224,46,178,47.5204118882151,176.479588111785
"1970","baby hey",-0.0624772626407883,71,9,62,9.71620032085995,61.2837996791401
"1970","just say",-0.0624772626407883,71,9,62,9.71620032085995,61.2837996791401
"1990","crime",-0.0626615503147354,70,14,56,14.8501287150672,55.1498712849328
"1990","hours",-0.0626615503147354,70,14,56,14.8501287150672,55.1498712849328
"1980","single",-0.0626644609927944,198,32,166,33.3106740734284,164.689325926572
"1980","blowing",-0.0626737931047379,70,11,59,11.7765009350505,58.2234990649496
"1980","never get",-0.0626737931047379,70,11,59,11.7765009350505,58.2234990649496
"1990","dont mean",-0.0629645731544541,128,26,102,27.15452107898,100.84547892102
"1990","came",-0.0631228387613731,701,146,555,148.713431846602,552.286568153398
"2010","jack",-0.0636875706026465,90,13,77,13.8566451580611,76.1433548419389
"2000","falling love",-0.0641555852303823,97,25,72,26.1013116596088,70.8986883403912
"2000","see face",-0.0641555852303823,97,25,72,26.1013116596088,70.8986883403912
"2000","well well",-0.0641555852303823,97,25,72,26.1013116596088,70.8986883403912
"2000","can find",-0.0643688647172815,78,20,58,20.9886836025721,57.0113163974279
"2000","love forever",-0.0643688647172815,78,20,58,20.9886836025721,57.0113163974279
"1990","darlin",-0.0652060882026082,181,37,144,38.3981899632452,142.601810036755
"1990","baby true",-0.0655802190164119,31,6,25,6.57648557381548,24.4235144261845
"1990","love youi",-0.0655802190164119,31,6,25,6.57648557381548,24.4235144261845
"1990","months",-0.0655802190164119,31,6,25,6.57648557381548,24.4235144261845
"1990","night let",-0.0655802190164119,31,6,25,6.57648557381548,24.4235144261845
"1990","say aint",-0.0655802190164119,31,6,25,6.57648557381548,24.4235144261845
"1990","shoulda",-0.0655802190164119,31,6,25,6.57648557381548,24.4235144261845
"1990","smiled",-0.0655802190164119,31,6,25,6.57648557381548,24.4235144261845
"1990","spill",-0.0655802190164119,31,6,25,6.57648557381548,24.4235144261845
"1990","square",-0.0655802190164119,31,6,25,6.57648557381548,24.4235144261845
"1970","dont feel",-0.0663894464537247,109,14,95,14.9164202108977,94.0835797891023
"1970","rules",-0.0663894464537247,109,14,95,14.9164202108977,94.0835797891023
"2000","hard find",-0.0669337293323113,59,15,44,15.8760555455353,43.1239444544647
"1980","yet",-0.0673457538544611,174,28,146,29.2730166099826,144.726983390017
"2000","got best",-0.0677154171724994,36,9,27,9.68708473964864,26.3129152603514
"2000","laying",-0.0677154171724994,36,9,27,9.68708473964864,26.3129152603514
"2000","mehow",-0.0677154171724994,36,9,27,9.68708473964864,26.3129152603514
"1980","ah ah ah",-0.0679714856009193,107,17,90,18.0012228578628,88.9987771421372
"1970","im right",-0.0682415537875849,56,7,49,7.66348194321348,48.3365180567865
"1970","kicks",-0.0682415537875849,56,7,49,7.66348194321348,48.3365180567865
"1970","pictures",-0.0682415537875849,56,7,49,7.66348194321348,48.3365180567865
"1970","shall",-0.0682415537875849,56,7,49,7.66348194321348,48.3365180567865
"1990","came along",-0.0689187405030913,36,7,29,7.63720905346314,28.3627909465369
"1990","can read",-0.0689187405030913,36,7,29,7.63720905346314,28.3627909465369
"1990","gonna keep",-0.0689187405030913,36,7,29,7.63720905346314,28.3627909465369
"1990","james",-0.0689187405030913,36,7,29,7.63720905346314,28.3627909465369
"1990","say never",-0.0689187405030913,36,7,29,7.63720905346314,28.3627909465369
"1990","things can",-0.0689187405030913,36,7,29,7.63720905346314,28.3627909465369
"1980","loved",-0.0693681061947902,398,65,333,66.957819602144,331.042180397856
"1990","like know",-0.0701619360833825,109,22,87,23.1237718563189,85.8762281436811
"1960","trip",-0.0705235294973308,129,7,122,7.70430226768074,121.295697732319
"2010","black white",-0.0705638675324387,43,6,37,6.62039713107362,36.3796028689264
"2010","dale",-0.0705638675324387,43,6,37,6.62039713107362,36.3796028689264
"2010","good thing",-0.0705638675324387,43,6,37,6.62039713107362,36.3796028689264
"2010","im bad",-0.0705638675324387,43,6,37,6.62039713107362,36.3796028689264
"2010","take clothes",-0.0705638675324387,43,6,37,6.62039713107362,36.3796028689264
"1980","dance dance dance",-0.0707156835299232,101,16,85,16.9918084920014,84.0081915079986
"1980","east",-0.0707156835299232,101,16,85,16.9918084920014,84.0081915079986
"2000","turned",-0.0710552077257058,256,67,189,68.8859359263903,187.11406407361
"2000","aint nobody",-0.0710680171313527,82,21,61,22.0650263514219,59.9349736485781
"2000","nine",-0.0710680171313527,82,21,61,22.0650263514219,59.9349736485781
"1990","baby yeah",-0.0716132003596976,80,16,64,16.9715756743625,63.0284243256375
"1990","find love",-0.0716132003596976,80,16,64,16.9715756743625,63.0284243256375
"1990","now get",-0.0716132003596976,80,16,64,16.9715756743625,63.0284243256375
"1970","late night",-0.0720238428788271,79,10,69,10.8109834556047,68.1890165443953
"1980","ceiling",-0.072255015780174,58,9,49,9.75767220332752,48.2423277966725
"1980","find somebody",-0.072255015780174,58,9,49,9.75767220332752,48.2423277966725
"1980","huh uh huh",-0.072255015780174,58,9,49,9.75767220332752,48.2423277966725
"1980","now come",-0.072255015780174,58,9,49,9.75767220332752,48.2423277966725
"1980","oh want",-0.072255015780174,58,9,49,9.75767220332752,48.2423277966725
"1980","seasons",-0.072255015780174,58,9,49,9.75767220332752,48.2423277966725
"1980","turn light",-0.072255015780174,58,9,49,9.75767220332752,48.2423277966725
"1980","slow",-0.072458889229666,567,93,474,95.3896575739087,471.610342426091
"1990","cause theres",-0.0725363976693223,41,8,33,8.6979325331108,32.3020674668892
"1990","girl need",-0.0725363976693223,41,8,33,8.6979325331108,32.3020674668892
"1990","oh come",-0.0725363976693223,41,8,33,8.6979325331108,32.3020674668892
"1990","panties",-0.0725363976693223,41,8,33,8.6979325331108,32.3020674668892
"1990","pity",-0.0725363976693223,41,8,33,8.6979325331108,32.3020674668892
"1990","say will",-0.0725363976693223,41,8,33,8.6979325331108,32.3020674668892
"1990","say word",-0.0725363976693223,41,8,33,8.6979325331108,32.3020674668892
"1990","size",-0.0725363976693223,41,8,33,8.6979325331108,32.3020674668892
"1990","way home",-0.0725363976693223,41,8,33,8.6979325331108,32.3020674668892
"1990","yeahyou",-0.0725363976693223,41,8,33,8.6979325331108,32.3020674668892
"1990","youve never",-0.0725363976693223,41,8,33,8.6979325331108,32.3020674668892
"1980","dont know",-0.0725949149330347,1641,272,1369,276.074829063111,1364.92517093689
"2010","everywhere",-0.0726511907828558,237,35,202,36.4891655828941,200.510834417106
"2000","hair",-0.0727808150454239,369,97,272,99.2926185813986,269.707381418601
"1970","mess",-0.0730454875596358,207,27,180,28.3275136115213,178.672486388479
"1990","hand",-0.0730870670123567,859,179,680,182.232293803468,676.767706196532
"1990","cant get",-0.0736034330882767,330,68,262,70.0077496567454,259.992250343255
"2000","resist",-0.0741015316111757,63,16,47,16.9523982943851,46.0476017056149
"1960","ill never",-0.0742238357836595,286,16,270,17.0808561903619,268.919143809638
"2010","baby tell",-0.0743970275260022,77,11,66,11.8551297463411,65.1448702536589
"2010","weather",-0.0743970275260022,77,11,66,11.8551297463411,65.1448702536589
"2010","roll",-0.0745759901186833,804,121,683,123.786030078679,680.213969921321
"2010","youre gone",-0.0749283297255472,124,18,106,19.0913777733286,104.908622226671
"2000","breath away",-0.0752393524138908,40,10,30,10.7634274884985,29.2365725115015
"2000","cant shake",-0.0752393524138908,40,10,30,10.7634274884985,29.2365725115015
"2000","fall apart",-0.0752393524138908,40,10,30,10.7634274884985,29.2365725115015
"2000","get now",-0.0752393524138908,40,10,30,10.7634274884985,29.2365725115015
"2000","im leaving",-0.0752393524138908,40,10,30,10.7634274884985,29.2365725115015
"2000","rest life",-0.0752393524138908,40,10,30,10.7634274884985,29.2365725115015
"2000","see girl",-0.0752393524138908,40,10,30,10.7634274884985,29.2365725115015
"2000","wedding",-0.0752393524138908,40,10,30,10.7634274884985,29.2365725115015
"2000","wouldnt change",-0.0752393524138908,40,10,30,10.7634274884985,29.2365725115015
"1980","yeah baby",-0.0756177978676056,144,23,121,24.2259447806752,119.774055219325
"1990","phone",-0.0757505099505025,311,64,247,65.9770004340843,245.022999565916
"1990","keep waiting",-0.0763416548896736,46,9,37,9.75865601275846,36.2413439872415
"1990","life like",-0.0763416548896736,46,9,37,9.75865601275846,36.2413439872415
"1990","nothing else",-0.0763416548896736,46,9,37,9.75865601275846,36.2413439872415
"1990","passing",-0.0763416548896736,46,9,37,9.75865601275846,36.2413439872415
"1990","said love",-0.0763416548896736,46,9,37,9.75865601275846,36.2413439872415
"1990","yeah ooh",-0.0763416548896736,46,9,37,9.75865601275846,36.2413439872415
"1960","whole",-0.0763916471075285,613,35,578,36.6103665898317,576.389633410168
"2010","lets get lets",-0.076777966552146,50,7,43,7.69813619892281,42.3018638010772
"2010","now never",-0.076777966552146,50,7,43,7.69813619892281,42.3018638010772
"2000","country",-0.0768774122785905,105,27,78,28.2539971573085,76.7460028426915
"1980","im sure",-0.0773751524859587,89,14,75,14.9729797602784,74.0270202397216
"1980","well im",-0.0773751524859587,89,14,75,14.9729797602784,74.0270202397216
"1990","moon",-0.0774231125491194,268,55,213,56.8547785091145,211.145221490886
"1960","treat",-0.0775887736043468,321,18,303,19.1711707591125,301.828829240887
"1970","dont cry",-0.0777736585520459,102,13,89,13.958484967996,88.041515032004
"1970","mood",-0.0779903471858114,64,8,56,8.75826507795827,55.2417349220417
"2000","say dont",-0.0784471914764455,143,37,106,38.4792532713821,104.520746728618
"1980","around im",-0.0787780188351095,52,8,44,8.74825783746605,43.251742162534
"1980","biggest",-0.0787780188351095,52,8,44,8.74825783746605,43.251742162534
"1980","dance dance dance dance",-0.0787780188351095,52,8,44,8.74825783746605,43.251742162534
"1980","disappear",-0.0787780188351095,52,8,44,8.74825783746605,43.251742162534
"1980","plenty",-0.0787780188351095,52,8,44,8.74825783746605,43.251742162534
"1990","bedroom",-0.0802790563191509,51,10,41,10.8193794924061,40.1806205075939
"1990","color",-0.0805648504046643,90,18,72,19.0930226336578,70.9069773663421
"2010","breathe",-0.0806209513899812,191,28,163,29.4068802798852,161.593119720115
"1970","get back",-0.080763366746007,215,28,187,29.4222967462661,185.577703253734
"1960","games",-0.0810029800960288,165,9,156,9.8543401098242,155.145659890176
"2000","can never",-0.0813117190541448,67,17,50,18.028741043235,48.971258956765
"2000","girl want",-0.0813117190541448,67,17,50,18.028741043235,48.971258956765
"2000","promised",-0.0813117190541448,67,17,50,18.028741043235,48.971258956765
"1980","monday",-0.0814626591557528,83,13,70,13.963565394417,69.036434605583
"1980","older",-0.0814626591557528,83,13,70,13.963565394417,69.036434605583
"2000","good life",-0.0827632876552771,44,11,33,11.8397702373483,32.1602297626517
"2000","throwing",-0.0827632876552771,44,11,33,11.8397702373483,32.1602297626517
"2010","go just",-0.0831276437025041,57,8,49,8.77587526677201,48.224124733228
"2000","baby got",-0.0833656105334226,109,28,81,29.3303399061584,79.6696600938416
"1960","seems",-0.0840430315747493,477,27,450,28.4880014084009,448.511998591599
"1990","pictures",-0.0843130435268011,56,11,45,11.8801029720538,44.1198970279462
"1990","time got",-0.0843130435268011,56,11,45,11.8801029720538,44.1198970279462
"2000","memory",-0.0844090027811721,147,38,109,39.555596020232,107.444403979768
"1980","better",-0.0851070144977832,1655,274,1381,278.430129250121,1376.56987074988
"1990","belong",-0.0853789162152125,302,62,240,64.0676981707186,237.932301829281
"1990","truth",-0.0853789162152125,302,62,240,64.0676981707186,237.932301829281
"1980","choose",-0.0854481205626731,120,19,101,20.1882873172294,99.8117126827707
"1980","weather",-0.086215755706035,77,12,65,12.9541510285555,64.0458489714445
"1970","hell",-0.0862167534642984,402,53,349,55.0128525209254,346.987147479075
"1960","inside",-0.0868571275692718,991,57,934,59.1857639323381,931.814236067662
"1980","away come",-0.0870739748570228,46,7,39,7.73884347160458,38.2611565283954
"1980","im saying",-0.0870739748570228,46,7,39,7.73884347160458,38.2611565283954
"1980","im thinkin",-0.0870739748570228,46,7,39,7.73884347160458,38.2611565283954
"1980","love take",-0.0870739748570228,46,7,39,7.73884347160458,38.2611565283954
"1980","meand",-0.0870739748570228,46,7,39,7.73884347160458,38.2611565283954
"1980","passing",-0.0870739748570228,46,7,39,7.73884347160458,38.2611565283954
"1960","walked",-0.0870931498777876,218,12,206,13.0196735996465,204.980326400354
"2010","heres",-0.0879142207754753,138,20,118,21.246855909027,116.753144090973
"1970","guess",-0.0881668393380659,484,64,420,66.2343796520594,417.765620347941
"1990","lose mind",-0.0884197659843819,61,12,49,12.9408264517014,48.0591735482986
"1990","position",-0.0884197659843819,61,12,49,12.9408264517014,48.0591735482986
"2000","want one",-0.0885571498295508,71,18,53,19.1050837920848,51.8949162079152
"1970","poppa",-0.0886913031955641,49,6,43,6.7055467003118,42.2944532996882
"1970","regret",-0.0886913031955641,49,6,43,6.7055467003118,42.2944532996882
"1970","whos gonna",-0.0886913031955641,49,6,43,6.7055467003118,42.2944532996882
"2010","theres just",-0.0895682148846539,64,9,55,9.8536143346212,54.1463856653788
"2000","just get",-0.0899267178353269,113,29,84,30.4066826550082,82.5933173449918
"2000","peace mind",-0.0902872228966687,48,12,36,12.9161129861982,35.0838870138018
"2010","quit",-0.0903039852377612,118,17,101,18.1676014294578,99.8323985705422
"1970","boss",-0.0912188704124315,95,12,83,13.0005497250943,81.9994502749057
"1970","set",-0.0914880089004848,395,52,343,54.0549172780237,340.945082721976
"1960","just get",-0.0915853277241554,113,6,107,6.74872989339476,106.251270106605
"1960","brother",-0.0918089564408922,201,11,190,12.0043779519677,188.995622048032
"1990","children",-0.0921149226325371,134,27,107,28.4273892545572,105.572610745443
"1990","child",-0.0921913906105685,288,59,229,61.0976724277051,226.902327572295
"1990","beneath",-0.0925826288159988,66,13,53,14.0015499313491,51.9984500686509
"1990","make em",-0.0925826288159988,66,13,53,14.0015499313491,51.9984500686509
"2000","ask",-0.0926151571933032,498,131,367,134.004672231806,363.995327768194
"1960","cant stop",-0.0927037129563817,236,13,223,14.0946925207183,221.905307479282
"1990","crazy",-0.0933695195311914,861,179,682,182.656583195327,678.343416804673
"1980","groove",-0.0939966914891919,297,48,249,49.9660111101426,247.033988889857
"2010","great",-0.0944461827502607,145,21,124,22.3245949768762,122.675405023124
"1980","tellin",-0.0946479499325594,151,24,127,25.4035948741803,125.59640512582
"2000","business",-0.0958322013162567,75,19,56,20.1814265409347,54.8185734590653
"2000","cause baby",-0.0958322013162567,75,19,56,20.1814265409347,54.8185734590653
"1990","somethin",-0.0959499448702985,293,60,233,62.1583959073528,230.841604092647
"2010","cause ive",-0.0960726886334393,71,10,61,10.9313534024704,60.0686465975296
"2010","got something",-0.0960726886334393,71,10,61,10.9313534024704,60.0686465975296
"1970","thoughts",-0.0965194436993193,118,15,103,16.1480512374856,101.851948762514
"1970","cant go",-0.0966166136257813,231,30,201,31.6118630157556,199.388136984244
"1990","day day",-0.0967897286828272,71,14,57,15.0622734109967,55.9377265890033
"1990","yeah thats",-0.0967897286828272,71,14,57,15.0622734109967,55.9377265890033
"1970","finally",-0.0970926451036322,201,26,175,27.5064262604627,173.493573739537
"1960","just dont",-0.0974649440100597,184,10,174,10.9890823042888,173.010917695711
"2000","life just",-0.0978111581380547,52,13,39,13.992455735048,38.007544264952
"2000","need oh",-0.0978111581380547,52,13,39,13.992455735048,38.007544264952
"2000","one want",-0.0978111581380547,52,13,39,13.992455735048,38.007544264952
"2000","way love",-0.0978451482373872,227,59,168,61.0824509972289,165.917549002771
"1980","dice",-0.097964609835433,40,6,34,6.72942910574312,33.2705708942569
"1980","flames",-0.097964609835433,40,6,34,6.72942910574312,33.2705708942569
"1970","baby give",-0.0980264076054176,57,7,50,7.80032983505658,49.1996701649434
"1970","get girl",-0.0980264076054176,57,7,50,7.80032983505658,49.1996701649434
"1970","got hold",-0.0980264076054176,57,7,50,7.80032983505658,49.1996701649434
"1970","hold back",-0.0980264076054176,57,7,50,7.80032983505658,49.1996701649434
"1970","see baby",-0.0980264076054176,57,7,50,7.80032983505658,49.1996701649434
"1970","sir",-0.0980264076054176,57,7,50,7.80032983505658,49.1996701649434
"1980","baby get",-0.098472523543887,65,10,55,10.9353222968326,54.0646777031674
"1980","know know know know",-0.098472523543887,65,10,55,10.9353222968326,54.0646777031674
"2000","confused",-0.0985349553516142,98,25,73,26.3703973468213,71.6296026531787
"1960","cause got",-0.099748593162942,149,8,141,8.89876773553822,140.101232264462
"1970","brought",-0.100851537011856,103,13,90,14.0953328598391,88.9046671401609
"1990","trying",-0.101966205542889,504,104,400,106.920926748484,397.079073251516
"2000","scene",-0.103238889431243,121,31,90,32.5593681527079,88.4406318472921
"2000","swear",-0.103296160686419,299,78,221,80.4566204765262,218.543379523474
"1980","hes",-0.103962145499656,841,138,703,141.486246948249,699.513753051751
"1990","bite",-0.105303768163128,81,16,65,17.1837203702921,63.8162796297079
"2000","screaming",-0.105335093379447,56,14,42,15.0687984838979,40.9312015161021
"1980","jack",-0.105571408035189,90,14,76,15.141215487922,74.858784512078
"1980","let tell",-0.105571408035189,90,14,76,15.141215487922,74.858784512078
"1980","rise",-0.105571408035189,90,14,76,15.141215487922,74.858784512078
"1970","baby let",-0.105963616958302,126,16,110,17.2428343722303,108.75716562777
"1980","mister",-0.106549595863423,59,9,50,9.9259079309711,49.0740920690289
"1980","little bit",-0.106825008193316,419,68,351,70.4907698826592,348.509230117341
"1990","choose",-0.107419800539504,120,24,96,25.4573635115438,94.5426364884562
"1970","doi",-0.107463798239634,65,8,57,8.89511296980137,56.1048870301986
"2010","got baby",-0.108092353615347,44,6,38,6.77435985505208,37.2256401449479
"2010","say cant",-0.108092353615347,44,6,38,6.77435985505208,37.2256401449479
"2010","wont go",-0.108092353615347,44,6,38,6.77435985505208,37.2256401449479
"1960","want love",-0.10917732577989,185,10,175,11.0488055776817,173.951194422318
"1960","earth",-0.109202044875984,132,7,125,7.88347208785936,124.116527912141
"2010","pack",-0.109209983051573,85,12,73,13.0868315381688,71.9131684618312
"1990","people",-0.10936784631736,972,202,770,206.204644443505,765.795355556495
"1990","dope",-0.109599064126532,86,17,69,18.2444438499397,67.7555561500603
"1990","go way",-0.109599064126532,86,17,69,18.2444438499397,67.7555561500603
"1990","im alone",-0.109599064126532,86,17,69,18.2444438499397,67.7555561500603
"1990","like baby",-0.109599064126532,86,17,69,18.2444438499397,67.7555561500603
"2000","got back",-0.110152239346415,25,6,19,6.72714218031156,18.2728578196884
"2000","hiphop",-0.110152239346415,25,6,19,6.72714218031156,18.2728578196884
"2000","im done",-0.110152239346415,25,6,19,6.72714218031156,18.2728578196884
"2000","leave now",-0.110152239346415,25,6,19,6.72714218031156,18.2728578196884
"2000","life got",-0.110152239346415,25,6,19,6.72714218031156,18.2728578196884
"2000","love best",-0.110152239346415,25,6,19,6.72714218031156,18.2728578196884
"2000","lower",-0.110152239346415,25,6,19,6.72714218031156,18.2728578196884
"2000","never turned",-0.110152239346415,25,6,19,6.72714218031156,18.2728578196884
"2000","oh yeah yeah yeah",-0.110152239346415,25,6,19,6.72714218031156,18.2728578196884
"2000","run around",-0.110152239346415,25,6,19,6.72714218031156,18.2728578196884
"2000","theres nothing left",-0.110152239346415,25,6,19,6.72714218031156,18.2728578196884
"2000","time cause",-0.110152239346415,25,6,19,6.72714218031156,18.2728578196884
"2000","time now",-0.110152239346415,25,6,19,6.72714218031156,18.2728578196884
"2000","true know",-0.110152239346415,25,6,19,6.72714218031156,18.2728578196884
"2000","way got",-0.110152239346415,25,6,19,6.72714218031156,18.2728578196884
"2000","whispered",-0.110152239346415,25,6,19,6.72714218031156,18.2728578196884
"2000","wont say",-0.110152239346415,25,6,19,6.72714218031156,18.2728578196884
"2010","sweat",-0.110381618189587,139,20,119,21.4008186330054,117.599181366995
"1990","kept",-0.111895625562022,125,25,100,26.5180869911915,98.4819130088085
"1990","thang",-0.111895625562022,125,25,100,26.5180869911915,98.4819130088085
"2010","date",-0.112725524356937,51,7,44,7.85209892290127,43.1479010770987
"2010","got nothing",-0.112725524356937,51,7,44,7.85209892290127,43.1479010770987
"2000","just give",-0.112859028620836,60,15,45,16.1451412327477,43.8548587672523
"2000","lane",-0.112859028620836,60,15,45,16.1451412327477,43.8548587672523
"2000","youre ready",-0.112859028620836,60,15,45,16.1451412327477,43.8548587672523
"1990","go away",-0.113914253661433,91,18,73,19.3051673295874,71.6948326704126
"1990","see light",-0.113914253661433,91,18,73,19.3051673295874,71.6948326704126
"2010","crazy",-0.113965057027393,861,129,732,132.561905345451,728.438094654549
"1970","woo",-0.11407040730424,217,28,189,29.6959925299523,187.304007470048
"1980","world",-0.114805833348976,2103,348,1755,353.799735234444,1749.20026476556
"1990","blow",-0.115079236990553,318,65,253,67.4620133055911,250.537986694409
"1970","rich",-0.115444009969389,134,17,117,18.3376175069751,115.662382493025
"2000","away now",-0.115805631211699,29,7,22,7.80348492916141,21.1965150708386
"2000","erase",-0.115805631211699,29,7,22,7.80348492916141,21.1965150708386
"2000","especially",-0.115805631211699,29,7,22,7.80348492916141,21.1965150708386
"2000","finds",-0.115805631211699,29,7,22,7.80348492916141,21.1965150708386
"2000","id make",-0.115805631211699,29,7,22,7.80348492916141,21.1965150708386
"2000","just takes",-0.115805631211699,29,7,22,7.80348492916141,21.1965150708386
"2000","make sense",-0.115805631211699,29,7,22,7.80348492916141,21.1965150708386
"2000","man like",-0.115805631211699,29,7,22,7.80348492916141,21.1965150708386
"2000","mean im",-0.115805631211699,29,7,22,7.80348492916141,21.1965150708386
"2000","meso",-0.115805631211699,29,7,22,7.80348492916141,21.1965150708386
"2000","quit playin",-0.115805631211699,29,7,22,7.80348492916141,21.1965150708386
"2000","shooting",-0.115805631211699,29,7,22,7.80348492916141,21.1965150708386
"2000","stay night",-0.115805631211699,29,7,22,7.80348492916141,21.1965150708386
"2000","string",-0.115805631211699,29,7,22,7.80348492916141,21.1965150708386
"2000","swim",-0.115805631211699,29,7,22,7.80348492916141,21.1965150708386
"2000","takes time",-0.115805631211699,29,7,22,7.80348492916141,21.1965150708386
"2000","toy",-0.115805631211699,29,7,22,7.80348492916141,21.1965150708386
"1980","right get",-0.11653061890076,53,8,45,8.91649356510963,44.0835064348904
"1980","time say",-0.11653061890076,53,8,45,8.91649356510963,44.0835064348904
"1980","wanting",-0.11653061890076,53,8,45,8.91649356510963,44.0835064348904
"1980","without cant",-0.11653061890076,53,8,45,8.91649356510963,44.0835064348904
"1970","shouldnt",-0.116985520778717,96,12,84,13.1373976169374,82.8626023830626
"1960","new york",-0.117060674179157,168,9,159,10.0335099300028,157.966490069997
"2000","maybe",-0.117337805093872,740,195,545,199.123408537222,540.876591462778
"1980","catch",-0.117728707154519,347,56,291,58.3777974923215,288.622202507678
"1980","filled",-0.118167028252696,78,12,66,13.1223867561991,64.8776132438009
"1970","eat",-0.11861158325496,172,22,150,23.5378373970128,148.462162602987
"2000","tell im",-0.119635047101528,110,28,82,29.5994255933708,80.4005744066291
"1990","cmon cmon",-0.11979951214264,32,6,26,6.78863026974501,25.211369730255
"1990","dropped",-0.11979951214264,32,6,26,6.78863026974501,25.211369730255
"1990","feeling like",-0.11979951214264,32,6,26,6.78863026974501,25.211369730255
"1990","hottest",-0.11979951214264,32,6,26,6.78863026974501,25.211369730255
"1990","im sick",-0.11979951214264,32,6,26,6.78863026974501,25.211369730255
"1990","like go",-0.11979951214264,32,6,26,6.78863026974501,25.211369730255
"1990","lisa",-0.11979951214264,32,6,26,6.78863026974501,25.211369730255
"1990","long know",-0.11979951214264,32,6,26,6.78863026974501,25.211369730255
"1990","losin",-0.11979951214264,32,6,26,6.78863026974501,25.211369730255
"1990","might say",-0.11979951214264,32,6,26,6.78863026974501,25.211369730255
"1990","never give",-0.11979951214264,32,6,26,6.78863026974501,25.211369730255
"1990","soldiers",-0.11979951214264,32,6,26,6.78863026974501,25.211369730255
"1990","stairs",-0.11979951214264,32,6,26,6.78863026974501,25.211369730255
"1990","will keep",-0.11979951214264,32,6,26,6.78863026974501,25.211369730255
"1990","wont please",-0.11979951214264,32,6,26,6.78863026974501,25.211369730255
"1990","worked",-0.11979951214264,32,6,26,6.78863026974501,25.211369730255
"1990","just look",-0.119923194706879,37,7,30,7.84935374939267,29.1506462506073
"1990","lasts",-0.119923194706879,37,7,30,7.84935374939267,29.1506462506073
"2000","desert",-0.120382963862225,64,16,48,17.2214839815976,46.7785160184024
"2000","give just",-0.120382963862225,64,16,48,17.2214839815976,46.7785160184024
"2000","hole",-0.120382963862225,64,16,48,17.2214839815976,46.7785160184024
"2000","rub",-0.120382963862225,64,16,48,17.2214839815976,46.7785160184024
"1980","turned",-0.120987725857653,256,41,215,43.0683462767559,212.931653723244
"1990","cant fight",-0.121096209253555,42,8,34,8.91007722904033,33.0899227709597
"1990","don",-0.121096209253555,42,8,34,8.91007722904033,33.0899227709597
"1990","drown",-0.121096209253555,42,8,34,8.91007722904033,33.0899227709597
"1990","got go",-0.121096209253555,42,8,34,8.91007722904033,33.0899227709597
"1990","im walking",-0.121096209253555,42,8,34,8.91007722904033,33.0899227709597
"1990","tell one",-0.121096209253555,42,8,34,8.91007722904033,33.0899227709597
"1990","way get",-0.121096209253555,42,8,34,8.91007722904033,33.0899227709597
"2000","cant just",-0.121915681578483,33,8,25,8.87982767801125,24.1201723219887
"2000","go got",-0.121915681578483,33,8,25,8.87982767801125,24.1201723219887
"2000","go youre",-0.121915681578483,33,8,25,8.87982767801125,24.1201723219887
"2000","home know",-0.121915681578483,33,8,25,8.87982767801125,24.1201723219887
"2000","im beggin",-0.121915681578483,33,8,25,8.87982767801125,24.1201723219887
"2000","let rain",-0.121915681578483,33,8,25,8.87982767801125,24.1201723219887
"2000","live like",-0.121915681578483,33,8,25,8.87982767801125,24.1201723219887
"2000","look eye",-0.121915681578483,33,8,25,8.87982767801125,24.1201723219887
"2000","stole",-0.121915681578483,33,8,25,8.87982767801125,24.1201723219887
"2000","suppose",-0.121915681578483,33,8,25,8.87982767801125,24.1201723219887
"2000","way aint",-0.121915681578483,33,8,25,8.87982767801125,24.1201723219887
"2000","wednesday",-0.121915681578483,33,8,25,8.87982767801125,24.1201723219887
"2010","wash",-0.122457734113415,99,14,85,15.2423096738672,83.7576903261328
"1990","forget",-0.122830277718551,491,101,390,104.1630457014,386.8369542986
"1990","come know",-0.122979835196257,47,9,38,9.97080070868799,37.029199291312
"1990","oh yeah oh yeah",-0.122979835196257,47,9,38,9.97080070868799,37.029199291312
"1990","yeah cause",-0.122979835196257,47,9,38,9.97080070868799,37.029199291312
"2010","know name",-0.123380502965532,65,9,56,10.0075770585997,54.9924229414003
"1970","know know",-0.123554334268973,390,51,339,53.3706778188082,336.629322181192
"1960","itll",-0.123809840958028,133,7,126,7.94319536125223,125.056804638748
"1970","cant explain",-0.124586507029626,50,6,44,6.8423945921549,43.1576054078451
"1970","forward",-0.124586507029626,50,6,44,6.8423945921549,43.1576054078451
"1970","gone im",-0.124586507029626,50,6,44,6.8423945921549,43.1576054078451
"1980","dirty",-0.124702971218089,244,39,205,41.049517545033,202.950482454967
"1980","ive never",-0.125012371903718,103,16,87,17.3282799472885,85.6717200527115
"1990","everybody knows",-0.125366988304258,52,10,42,11.0315241883356,40.9684758116644
"1990","paint",-0.125366988304258,52,10,42,11.0315241883356,40.9684758116644
"1990","raised",-0.125366988304258,52,10,42,11.0315241883356,40.9684758116644
"1990","saving",-0.125366988304258,52,10,42,11.0315241883356,40.9684758116644
"1990","till",-0.12592090274629,692,143,549,146.804129583236,545.195870416764
"1960","dead",-0.126176346258677,204,11,193,12.1835477721463,191.816452227854
"1980","wear",-0.126709075971189,183,29,154,30.7871381587748,152.212861841225
"2000","can feel",-0.126829825585608,300,78,222,80.7257061637387,219.274293836261
"1990","sea",-0.127494041565119,174,35,139,36.9131770917385,137.086822908261
"2000","drivin",-0.127906899103614,68,17,51,18.2978267304474,49.7021732695526
"2000","turn turn",-0.127906899103614,68,17,51,18.2978267304474,49.7021732695526
"1990","im telling",-0.128123930915392,57,11,46,12.0922476679833,44.9077523320167
"1990","kissin",-0.128123930915392,57,11,46,12.0922476679833,44.9077523320167
"1990","oh yeah yeah",-0.128123930915392,57,11,46,12.0922476679833,44.9077523320167
"1990","thighs",-0.128123930915392,57,11,46,12.0922476679833,44.9077523320167
"2000","baby think",-0.128333346461394,37,9,28,9.9561704268611,27.0438295731389
"2000","bless",-0.128333346461394,37,9,28,9.9561704268611,27.0438295731389
"2000","calm",-0.128333346461394,37,9,28,9.9561704268611,27.0438295731389
"2000","can show",-0.128333346461394,37,9,28,9.9561704268611,27.0438295731389
"2000","michael",-0.128333346461394,37,9,28,9.9561704268611,27.0438295731389
"2000","never ends",-0.128333346461394,37,9,28,9.9561704268611,27.0438295731389
"2000","new day",-0.128333346461394,37,9,28,9.9561704268611,27.0438295731389
"2000","pushing",-0.128333346461394,37,9,28,9.9561704268611,27.0438295731389
"2000","sixteen",-0.128333346461394,37,9,28,9.9561704268611,27.0438295731389
"2010","itll",-0.128503956635826,133,19,114,20.4770422891347,112.522957710865
"2010","want just",-0.129130124346442,72,10,62,11.0853161264489,60.9146838735512
"1980","baby wont",-0.129168231711037,47,7,40,7.90707919924816,39.0929208007518
"1980","tricks",-0.129168231711037,47,7,40,7.90707919924816,39.0929208007518
"1980","dance dance",-0.12968741108847,177,28,149,29.7777237929133,147.222276207087
"1990","dont get",-0.129798925651959,145,29,116,30.7609809097821,114.239019090218
"2010","find way",-0.130514927170155,160,23,137,24.634035836553,135.365964163447
"1980","yes im",-0.131024611733443,97,15,82,16.3188655814271,80.6811344185729
"1990","either",-0.131160438032824,62,12,50,13.152971147631,48.847028852369
"1990","love thats",-0.131320058167144,111,22,89,23.548061248178,87.451938751822
"1990","now can",-0.131320058167144,111,22,89,23.548061248178,87.451938751822
"1970","see see",-0.132724409072784,58,7,51,7.93717772689968,50.0628222731003
"2010","three",-0.132815337732429,367,54,313,56.5043197000935,310.495680299907
"1980","grown",-0.133994367416546,128,20,108,21.534173138378,106.465826861622
"1990","three",-0.134292329214441,367,75,292,77.8571034061381,289.142896593862
"1990","tell youre",-0.134413430854076,67,13,54,14.2136946272786,52.7863053727214
"2000","talking",-0.134691794147741,323,84,239,86.9146769696253,236.085323030375
"2000","get yeah",-0.134968080669206,41,10,31,11.032513175711,29.9674868242891
"2000","players",-0.134968080669206,41,10,31,11.032513175711,29.9674868242891
"2000","try make",-0.134968080669206,41,10,31,11.032513175711,29.9674868242891
"2000","windows",-0.134968080669206,41,10,31,11.032513175711,29.9674868242891
"2000","see just",-0.135430834344999,72,18,54,19.3741694792973,52.6258305207027
"1980","baby wanna",-0.13554305885377,66,10,56,11.1035580244761,54.8964419755239
"1980","ill go",-0.13554305885377,66,10,56,11.1035580244761,54.8964419755239
"1980","make mine",-0.13554305885377,66,10,56,11.1035580244761,54.8964419755239
"1980","sees",-0.13554305885377,66,10,56,11.1035580244761,54.8964419755239
"1990","cash",-0.135698372392812,116,23,93,24.6087847278257,91.3912152721743
"1970","say hey",-0.136112957979604,89,11,78,12.1794623740357,76.8205376259643
"1990","men",-0.136367822953017,184,37,147,39.0346240510338,144.965375948966
"1990","seem",-0.136674195561566,295,60,235,62.5826852992118,232.417314700788
"1980","na na na",-0.137620408598247,1049,172,877,176.479278298113,872.520721701887
"2000","straight",-0.137662879003015,255,66,189,68.6168502391779,186.383149760822
"1960","rich",-0.139253083879531,134,7,127,8.00291863464511,125.997081365355
"1970","rockin",-0.140071096728271,173,22,151,23.6746852888559,149.325314711144
"1970","dah",-0.141256324076876,66,8,58,9.03196086164446,56.9680391383555
"1970","emotion",-0.141256324076876,66,8,58,9.03196086164446,56.9680391383555
"1970","sees",-0.141256324076876,66,8,58,9.03196086164446,56.9680391383555
"1960","played",-0.141496961094885,152,8,144,9.07793755571684,142.922062444283
"2000","guarantee",-0.141761700788698,45,11,34,12.1088559245608,32.8911440754392
"2000","whose",-0.141761700788698,45,11,34,12.1088559245608,32.8911440754392
"2000","woo woo",-0.141761700788698,45,11,34,12.1088559245608,32.8911440754392
"1990","shining",-0.143226400719395,160,32,128,33.9431513487251,126.056848651275
"2010","yet",-0.143958125201268,174,25,149,26.7895139722514,147.210486027749
"1990","grind",-0.145072795338645,82,16,66,17.3958650662216,64.6041349337784
"1980","water",-0.145576251544733,245,39,206,41.2177532726766,203.782246727323
"1980","clown",-0.145672509157372,41,6,35,6.8976648333867,34.1023351666133
"1980","girl need",-0.145672509157372,41,6,35,6.8976648333867,34.1023351666133
"1980","just enough",-0.145672509157372,41,6,35,6.8976648333867,34.1023351666133
"1980","know think",-0.145672509157372,41,6,35,6.8976648333867,34.1023351666133
"1980","one else can",-0.145672509157372,41,6,35,6.8976648333867,34.1023351666133
"1980","think id",-0.145672509157372,41,6,35,6.8976648333867,34.1023351666133
"1980","just take",-0.145702020639504,85,13,72,14.3000368497041,70.6999631502959
"1980","least",-0.145702020639504,85,13,72,14.3000368497041,70.6999631502959
"2000","sleep",-0.145943584192327,433,113,320,116.514102562996,316.485897437004
"1960","uh huh",-0.146197416015205,276,15,261,16.4836234564332,259.516376543567
"1990","hide",-0.1466256837543,358,73,285,75.9478011427723,282.052198857228
"1980","pleasure",-0.146946914753127,60,9,51,10.0941436586147,49.9058563413853
"2010","bird",-0.147300239030911,93,13,80,14.3185333299964,78.6814666700036
"1960","really want",-0.147993953660083,188,10,178,11.2279753978603,176.77202460214
"1960","know can",-0.148001044908095,241,13,228,14.3933088876826,226.606691112317
"1990","gonna find",-0.148839286843402,87,17,70,18.4565885458693,68.5434114541307
"1970","doors",-0.150053439071897,74,9,65,10.1267439963892,63.8732560036107
"2000","many times",-0.150478704827782,80,20,60,21.526854976997,58.473145023003
"1980","dont know im",-0.150663881976037,110,17,93,18.5059300407936,91.4940699592064
"1980","child",-0.151235595735211,288,46,242,48.4518895613504,239.54811043865
"2010","around dont",-0.152800035711472,45,6,39,6.92832257903053,38.0716774209695
"2010","company",-0.152800035711472,45,6,39,6.92832257903053,38.0716774209695
"2010","im scared",-0.152800035711472,45,6,39,6.92832257903053,38.0716774209695
"2010","night away",-0.152800035711472,45,6,39,6.92832257903053,38.0716774209695
"2010","realized",-0.152800035711472,45,6,39,6.92832257903053,38.0716774209695
"2010","stop stop",-0.152800035711472,45,6,39,6.92832257903053,38.0716774209695
"2010","take another",-0.152800035711472,45,6,39,6.92832257903053,38.0716774209695
"2010","whoo",-0.152800035711472,45,6,39,6.92832257903053,38.0716774209695
"1970","thinkin",-0.15298046054021,362,47,315,49.5389368472014,312.461063152799
"1980","way love",-0.153293627180043,227,36,191,38.1895101750922,188.810489824908
"2010","know wanna",-0.153555933104292,100,14,86,15.3962723978456,84.6037276021544
"2000","walls",-0.154701135843115,107,27,80,28.7921685317335,78.2078314682665
"2010","bread",-0.154913342002319,52,7,45,8.00606164687973,43.9939383531203
"2010","burned",-0.154913342002319,52,7,45,8.00606164687973,43.9939383531203
"2010","hills",-0.154913342002319,52,7,45,8.00606164687973,43.9939383531203
"2010","now time",-0.154913342002319,52,7,45,8.00606164687973,43.9939383531203
"1970","im tired",-0.155364490105897,105,13,92,14.3690286435253,90.6309713564747
"1960","ends",-0.155519009357103,135,7,128,8.06264190803798,126.937358091962
"1960","singin",-0.155519009357103,135,7,128,8.06264190803798,126.937358091962
"2000","love im",-0.155546750067364,267,69,198,71.8458784857274,195.154121514273
"2000","amazing",-0.155681075628002,53,13,40,14.2615414222605,38.7384585777395
"2000","cant make",-0.155681075628002,53,13,40,14.2615414222605,38.7384585777395
"2000","chasing",-0.155681075628002,53,13,40,14.2615414222605,38.7384585777395
"2000","destiny",-0.155681075628002,53,13,40,14.2615414222605,38.7384585777395
"2000","love love baby",-0.155681075628002,53,13,40,14.2615414222605,38.7384585777395
"2010","callin",-0.155832684091432,134,19,115,20.6310050131131,113.368994986887
"2010","twice",-0.155832684091432,134,19,115,20.6310050131131,113.368994986887
"1970","get right",-0.155980694371623,128,16,112,17.5165301559165,110.483469844083
"2000","came",-0.156237213591726,701,184,517,188.629066735936,512.370933264064
"1990","acting",-0.156592810972874,97,19,78,20.5780355051646,76.4219644948354
"1990","good time",-0.156653875786778,175,35,140,37.125321787668,137.874678212332
"2010","fallin",-0.1574137462234,188,27,161,28.9449921079498,159.05500789205
"2010","get lets",-0.158146554427777,59,8,51,9.08380071472892,49.9161992852711
"2010","wait wait",-0.158146554427777,59,8,51,9.08380071472892,49.9161992852711
"1970","nine",-0.159037575160799,82,10,72,11.221527131134,70.778472868866
"1980","get back",-0.159196713012812,215,34,181,36.1706814433693,178.829318556631
"1990","fix",-0.160558112638302,102,20,82,21.6387589848122,80.3612410151878
"1990","lifes",-0.160558112638302,102,20,82,21.6387589848122,80.3612410151878
"1980","can come",-0.160993233752294,54,8,46,9.08472929275321,44.9152707072468
"1980","now wanna",-0.160993233752294,54,8,46,9.08472929275321,44.9152707072468
"1980","right cause",-0.160993233752294,54,8,46,9.08472929275321,44.9152707072468
"1970","anymore",-0.162020705996591,227,29,198,31.0644714483832,195.935528551617
"2010","happens",-0.162138530423022,66,9,57,10.1615397825781,55.8384602174219
"2010","love baby love",-0.162138530423022,66,9,57,10.1615397825781,55.8384602174219
"2010","waste time",-0.162138530423022,66,9,57,10.1615397825781,55.8384602174219
"1970","lose",-0.162531290450896,684,90,594,93.603958020679,590.396041979321
"2000","letting go",-0.162760026964784,57,14,43,15.3378841711103,41.6621158288897
"1960","believe",-0.163363567907217,1245,71,1174,74.3554753741281,1170.64452462587
"1970","seem",-0.163949458081024,295,38,257,40.3701280937139,254.629871906286
"1970","break heart",-0.165016452550738,113,14,99,15.4638117782701,97.5361882217299
"1970","oh im",-0.165016452550738,113,14,99,15.4638117782701,97.5361882217299
"1980","later",-0.165325374455625,98,15,83,16.4871013090706,81.5128986909294
"1980","fever",-0.165411865867279,73,11,62,12.2812081179812,60.7187918820188
"1980","tell want",-0.165411865867279,73,11,62,12.2812081179812,60.7187918820188
"1970","excited",-0.165937503131438,51,6,45,6.97924248399799,44.020757516002
"1970","honestly",-0.165937503131438,51,6,45,6.97924248399799,44.020757516002
"1970","just come",-0.165937503131438,51,6,45,6.97924248399799,44.020757516002
"1970","like man",-0.165937503131438,51,6,45,6.97924248399799,44.020757516002
"1970","will let",-0.165937503131438,51,6,45,6.97924248399799,44.020757516002
"2010","nothing can",-0.166255287405008,114,16,98,17.551750533544,96.448249466456
"1990","land",-0.166527688686939,151,30,121,32.0338490853593,118.966150914641
"2010","benz",-0.16666835244592,73,10,63,11.2392788504273,61.7607211495727
"2010","private",-0.16666835244592,73,10,63,11.2392788504273,61.7607211495727
"2010","kick",-0.166742649601932,329,48,281,50.6537361889121,278.346263811088
"1970","sell",-0.1721561428164,59,7,52,8.07402561874278,50.9259743812572
"1960","thoughts",-0.173848148416889,118,6,112,7.04734626035913,110.952653739641
"1980","best friend",-0.174147949714046,92,14,78,15.4776869432092,76.5223130567908
"1980","got get",-0.174147949714046,92,14,78,15.4776869432092,76.5223130567908
"1960","eat",-0.174535343095141,172,9,163,10.2724030235743,161.727596976426
"1960","shoes",-0.174535343095141,172,9,163,10.2724030235743,161.727596976426
"1990","na na na",-0.17611387655041,1049,217,832,222.539786030079,826.460213969921
"1990","id rather",-0.176839531968764,122,24,98,25.8816529034029,96.1183470965971
"2000","doi",-0.177082805695191,65,16,49,17.49056966881,47.50943033119
"2000","brand new",-0.177114299659102,142,36,106,38.2101675841696,103.78983241583
"2000","mirror",-0.177114299659102,142,36,106,38.2101675841696,103.78983241583
"1970","gonna give",-0.177382606391128,98,12,86,13.4110934006236,84.5889065993764
"1970","later",-0.177382606391128,98,12,86,13.4110934006236,84.5889065993764
"1980","good good good",-0.178025588354775,67,10,57,11.2717937521197,55.7282062478803
"1980","huh uh",-0.178025588354775,67,10,57,11.2717937521197,55.7282062478803
"1980","soft",-0.178025588354775,67,10,57,11.2717937521197,55.7282062478803
"1980","think time",-0.178025588354775,67,10,57,11.2717937521197,55.7282062478803
"1980","ill just",-0.178711295537648,48,7,41,8.07531492689174,39.9246850731083
"1980","way know",-0.178711295537648,48,7,41,8.07531492689174,39.9246850731083
"1980","well get",-0.178711295537648,48,7,41,8.07531492689174,39.9246850731083
"1980","youbaby",-0.178711295537648,48,7,41,8.07531492689174,39.9246850731083
"1980","youre like",-0.178711295537648,48,7,41,8.07531492689174,39.9246850731083
"2010","six",-0.179136429769308,128,18,110,19.7072286692424,108.292771330758
"1970","can never",-0.179229127312488,67,8,59,9.16880875348756,57.8311912465124
"1970","disguise",-0.179229127312488,67,8,59,9.16880875348756,57.8311912465124
"2000","can tell",-0.179469405753292,264,68,196,71.03862142409,192.96137857591
"1990","fan",-0.179614558613848,53,10,43,11.2436688842652,41.7563311157348
"1990","make night",-0.179614558613848,53,10,43,11.2436688842652,41.7563311157348
"1990","wide",-0.179805083268318,166,33,133,35.2160195243022,130.783980475698
"1960","leave",-0.180064758259515,1265,72,1193,75.5499408419855,1189.45005915801
"1990","heavy",-0.180326984940869,58,11,47,12.3043923639128,45.6956076360872
"1990","likes",-0.180326984940869,58,11,47,12.3043923639128,45.6956076360872
"1970","pass",-0.180494770810204,243,31,212,33.2540377178728,209.745962282127
"1990","give us",-0.18086448629272,43,8,35,9.12222192496986,33.8777780750301
"1990","hesitate",-0.18086448629272,43,8,35,9.12222192496986,33.8777780750301
"1990","now youve",-0.18086448629272,43,8,35,9.12222192496986,33.8777780750301
"2000","style",-0.181043401508703,207,53,154,55.7007372529797,151.29926274702
"1990","last forever",-0.181644313880331,63,12,51,13.3651158435605,49.6348841564395
"1970","got",-0.182143009979594,8289,1121,7168,1134.33217548744,7154.66782451256
"2010","lines",-0.18227212560063,94,13,81,14.4724960539749,79.5275039460251
"2010","dancin",-0.182670355550004,162,23,139,24.9419612845099,137.05803871549
"2000","really want",-0.183169416735301,188,48,140,50.5881091959429,137.411890804057
"1960","used",-0.18324092823362,732,41,691,43.7174361235837,688.282563876416
"1990","bullshit",-0.183546030046535,38,7,31,8.0614984453222,29.9385015546778
"1990","dont turn",-0.183546030046535,38,7,31,8.0614984453222,29.9385015546778
"1990","mas",-0.183546030046535,38,7,31,8.0614984453222,29.9385015546778
"1990","say baby",-0.183546030046535,38,7,31,8.0614984453222,29.9385015546778
"1990","shape",-0.183546030046535,38,7,31,8.0614984453222,29.9385015546778
"1990","yeahoh",-0.183546030046535,38,7,31,8.0614984453222,29.9385015546778
"1980","taking",-0.184197875673359,216,34,182,36.3389171710128,179.661082828987
"1980","make better",-0.184250347343398,86,13,73,14.4682725773477,71.5317274226523
"2000","oh got",-0.184307453763487,69,17,52,18.5669124176599,50.4330875823401
"2000","say want",-0.184307453763487,69,17,52,18.5669124176599,50.4330875823401
"1990","afraid",-0.185289976594647,239,48,191,50.7025823271581,188.297417672842
"1990","missed",-0.185591029665962,73,14,59,15.4865628028558,57.5134371971442
"2000","ball",-0.186549550038081,169,43,126,45.4754811389061,123.524518861094
"1970","danced",-0.18687976054444,75,9,66,10.2635918882323,64.7364081117677
"1970","know youve",-0.18687976054444,75,9,66,10.2635918882323,64.7364081117677
"1990","just feel",-0.188050482456387,78,15,63,16.5472862825035,61.4527137174965
"1990","law",-0.188050482456387,78,15,63,16.5472862825035,61.4527137174965
"1990","morning",-0.188058545574624,509,104,405,107.981650228132,401.018349771868
"1990","can dont",-0.188450682176786,33,6,27,7.00077496567454,25.9992250343255
"1990","flo",-0.188450682176786,33,6,27,7.00077496567454,25.9992250343255
"1990","gift",-0.188450682176786,33,6,27,7.00077496567454,25.9992250343255
"1990","go youre",-0.188450682176786,33,6,27,7.00077496567454,25.9992250343255
"1990","good ill",-0.188450682176786,33,6,27,7.00077496567454,25.9992250343255
"1990","look eye",-0.188450682176786,33,6,27,7.00077496567454,25.9992250343255
"1990","man want",-0.188450682176786,33,6,27,7.00077496567454,25.9992250343255
"1990","remain",-0.188450682176786,33,6,27,7.00077496567454,25.9992250343255
"1990","tonight dont",-0.188450682176786,33,6,27,7.00077496567454,25.9992250343255
"1990","turned around",-0.188450682176786,33,6,27,7.00077496567454,25.9992250343255
"1990","wanna fuck",-0.188450682176786,33,6,27,7.00077496567454,25.9992250343255
"1990","touched",-0.190755163864844,83,16,67,17.6080097621511,65.3919902378489
"1990","trees",-0.190755163864844,83,16,67,17.6080097621511,65.3919902378489
"2000","private",-0.191565002165968,73,18,55,19.6432551665097,53.3567448334902
"1990","river",-0.192460475966612,215,43,172,45.6111096248493,169.388890375151
"1980","john",-0.19322755644878,61,9,52,10.2623793862583,50.7376206137417
"1980","one another",-0.19322755644878,61,9,52,10.2623793862583,50.7376206137417
"1990","hurry",-0.193579457365654,142,28,114,30.1245468219935,111.875453178007
"1990","letter",-0.193662898055791,88,17,71,18.6687332417988,69.3312667582012
"2010","taken",-0.193695186519707,108,15,93,16.6279741896733,91.3720258103267
"1980","runnin",-0.195347653264768,241,38,203,40.5448103621023,200.455189637898
"1980","attention",-0.195929219670866,80,12,68,13.4588582114862,66.5411417885138
"2000","let",-0.196535667907476,4927,1312,3615,1325.7851808958,3601.2148191042
"1960","needed",-0.197462169576713,227,12,215,13.5571830601824,213.442816939818
"1980","else",-0.198776780168028,625,101,524,105.147329777236,519.852670222764
"2010","loose",-0.199600222730003,115,16,99,17.7057132575225,97.2942867424775
"1960","youre gonna",-0.199746370068826,421,23,398,25.1434980983999,395.8565019016
"2000","care say",-0.200451330018196,26,6,20,6.99622786752402,19.003772132476
"2000","cheated",-0.200451330018196,26,6,20,6.99622786752402,19.003772132476
"2000","dont want love",-0.200451330018196,26,6,20,6.99622786752402,19.003772132476
"2000","figured",-0.200451330018196,26,6,20,6.99622786752402,19.003772132476
"2000","girl youve",-0.200451330018196,26,6,20,6.99622786752402,19.003772132476
"2000","just im",-0.200451330018196,26,6,20,6.99622786752402,19.003772132476
"2000","killed",-0.200451330018196,26,6,20,6.99622786752402,19.003772132476
"2000","mewhen",-0.200451330018196,26,6,20,6.99622786752402,19.003772132476
"2000","oh shes",-0.200451330018196,26,6,20,6.99622786752402,19.003772132476
"2000","tag",-0.200451330018196,26,6,20,6.99622786752402,19.003772132476
"2000","wrong im",-0.200451330018196,26,6,20,6.99622786752402,19.003772132476
"2000","ashamed",-0.200904946216766,30,7,23,8.07257061637387,21.9274293836261
"2000","girl yeah",-0.200904946216766,30,7,23,8.07257061637387,21.9274293836261
"2000","go make",-0.200904946216766,30,7,23,8.07257061637387,21.9274293836261
"2000","good just",-0.200904946216766,30,7,23,8.07257061637387,21.9274293836261
"2000","hold like",-0.200904946216766,30,7,23,8.07257061637387,21.9274293836261
"2000","innocence",-0.200904946216766,30,7,23,8.07257061637387,21.9274293836261
"2000","keep mind",-0.200904946216766,30,7,23,8.07257061637387,21.9274293836261
"2000","like real",-0.200904946216766,30,7,23,8.07257061637387,21.9274293836261
"2000","move body",-0.200904946216766,30,7,23,8.07257061637387,21.9274293836261
"2000","way oh",-0.200904946216766,30,7,23,8.07257061637387,21.9274293836261
"1960","next",-0.200951419841875,491,27,464,29.3241272359011,461.675872764099
"1970","lover",-0.201359056042215,500,65,435,68.423945921549,431.576054078451
"1970","pray",-0.201703074023713,206,26,180,28.1906657196782,177.809334280322
"1980","got go",-0.201745717288952,42,6,36,7.06590056103027,34.9340994389697
"1980","jumped",-0.201745717288952,42,6,36,7.06590056103027,34.9340994389697
"1980","note",-0.201745717288952,42,6,36,7.06590056103027,34.9340994389697
"1980","tell one",-0.201745717288952,42,6,36,7.06590056103027,34.9340994389697
"1980","tonight yeah",-0.201745717288952,42,6,36,7.06590056103027,34.9340994389697
"1980","want man",-0.201745717288952,42,6,36,7.06590056103027,34.9340994389697
"2010","act",-0.201998762819405,304,44,260,46.8046680894507,257.195331910549
"2010","rollin",-0.202842010824344,183,26,157,28.1751784880575,154.824821511943
"2000","agree",-0.203045888718146,34,8,26,9.14891336522372,24.8510866347763
"2000","cared",-0.203045888718146,34,8,26,9.14891336522372,24.8510866347763
"2000","cheat",-0.203045888718146,34,8,26,9.14891336522372,24.8510866347763
"2000","coat",-0.203045888718146,34,8,26,9.14891336522372,24.8510866347763
"2000","dont really wanna",-0.203045888718146,34,8,26,9.14891336522372,24.8510866347763
"2000","get gotta",-0.203045888718146,34,8,26,9.14891336522372,24.8510866347763
"2000","girl wanna",-0.203045888718146,34,8,26,9.14891336522372,24.8510866347763
"2000","mend",-0.203045888718146,34,8,26,9.14891336522372,24.8510866347763
"2000","mercedes",-0.203045888718146,34,8,26,9.14891336522372,24.8510866347763
"2000","shootin",-0.203045888718146,34,8,26,9.14891336522372,24.8510866347763
"2000","take control",-0.203045888718146,34,8,26,9.14891336522372,24.8510866347763
"2000","will wait",-0.203045888718146,34,8,26,9.14891336522372,24.8510866347763
"2010","cant make",-0.203085353324642,53,7,46,8.16002437085818,44.8399756291418
"2010","go like",-0.203085353324642,53,7,46,8.16002437085818,44.8399756291418
"2010","like ive",-0.203085353324642,53,7,46,8.16002437085818,44.8399756291418
"2010","thing thats",-0.203085353324642,53,7,46,8.16002437085818,44.8399756291418
"2010","wanting",-0.203085353324642,53,7,46,8.16002437085818,44.8399756291418
"1970","gas",-0.203298561771835,91,11,80,12.4531581577219,78.5468418422781
"1990","one can",-0.203306450744981,103,20,83,21.8509036807418,81.1490963192582
"2010","boots",-0.203733380948604,60,8,52,9.23776343870738,50.7622365612926
"2010","aint right",-0.204347286756789,46,6,40,7.08228530300899,38.917714696991
"2010","cant touch",-0.204347286756789,46,6,40,7.08228530300899,38.917714696991
"2010","horse",-0.204347286756789,46,6,40,7.08228530300899,38.917714696991
"2010","let hear say",-0.204347286756789,46,6,40,7.08228530300899,38.917714696991
"2010","take slow",-0.204347286756789,46,6,40,7.08228530300899,38.917714696991
"1960","eye",-0.204431019734385,263,14,249,15.7072209023258,247.292779097674
"1980","youre gone",-0.204616887751288,124,19,105,20.8612302278037,103.138769772196
"1990","feeling",-0.204752604180706,922,190,732,195.597409647028,726.402590352972
"2010","anyway",-0.205604446208785,122,17,105,18.7834523253717,103.216547674628
"2010","back im",-0.205681887478475,67,9,58,10.3155025065566,56.6844974934434
"1960","let go",-0.205756497558367,804,45,759,48.0175118078706,755.982488192129
"2000","lets ride",-0.206334402876656,38,9,29,10.2252561140736,27.7747438859264
"2000","sexy lady",-0.206334402876656,38,9,29,10.2252561140736,27.7747438859264
"2000","split",-0.206334402876656,38,9,29,10.2252561140736,27.7747438859264
"2000","used love",-0.206334402876656,38,9,29,10.2252561140736,27.7747438859264
"2000","vow",-0.206334402876656,38,9,29,10.2252561140736,27.7747438859264
"2000","wanna lover",-0.206334402876656,38,9,29,10.2252561140736,27.7747438859264
"1980","road",-0.206563764126327,370,59,311,62.2472192281238,307.752780771876
"1990","dont believe",-0.206756221509307,108,21,87,22.9116271603894,85.0883728396106
"1990","sleep",-0.207888341571532,433,88,345,91.8586533374872,341.141346662513
"2010","crush",-0.208555828309585,74,10,64,11.3932415744058,62.6067584255942
"2010","fell love",-0.208555828309585,74,10,64,11.3932415744058,62.6067584255942
"2000","hear voice",-0.210438806266867,42,10,32,11.3015988629234,30.6984011370766
"2000","jumped",-0.210438806266867,42,10,32,11.3015988629234,30.6984011370766
"2000","say yeah",-0.210438806266867,42,10,32,11.3015988629234,30.6984011370766
"2000","think ive",-0.210438806266867,42,10,32,11.3015988629234,30.6984011370766
"1960","coming",-0.211647868712703,614,34,580,36.6700898632246,577.329910136775
"1970","fat",-0.211884486115314,99,12,87,13.5479412924667,85.4520587075333
"1980","vain",-0.211898380471185,55,8,47,9.25296502039679,45.7470349796032
"1960","forever",-0.212506685012252,874,49,825,52.1981409453718,821.801859054628
"1970","em bring",-0.21251840285883,52,6,46,7.11609037584109,44.8839096241589
"1970","em bring em",-0.21251840285883,52,6,46,7.11609037584109,44.8839096241589
"1970","help help",-0.21251840285883,52,6,46,7.11609037584109,44.8839096241589
"1970","knocked",-0.21251840285883,52,6,46,7.11609037584109,44.8839096241589
"1970","now time",-0.21251840285883,52,6,46,7.11609037584109,44.8839096241589
"1970","rent",-0.21251840285883,52,6,46,7.11609037584109,44.8839096241589
"1970","shook",-0.21251840285883,52,6,46,7.11609037584109,44.8839096241589
"1970","troubles",-0.21251840285883,52,6,46,7.11609037584109,44.8839096241589
"1980","little love",-0.213099191726846,118,18,100,19.8518158619422,98.1481841380578
"1960","dont see",-0.213224546605502,120,6,114,7.16679280714487,112.833207192855
"1960","sounds",-0.213224546605502,120,6,114,7.16679280714487,112.833207192855
"2000","unless",-0.213488477640866,85,21,64,22.8722834130593,62.1277165869407
"2000","wont take",-0.213488477640866,85,21,64,22.8722834130593,62.1277165869407
"1980","right im",-0.214336536045237,93,14,79,15.6459226708527,77.3540773291473
"1980","surely",-0.214336536045237,93,14,79,15.6459226708527,77.3540773291473
"1970","sent",-0.214927596479269,130,16,114,17.7902259396027,112.209774060397
"1970","whole world",-0.214927596479269,130,16,114,17.7902259396027,112.209774060397
"1970","let em",-0.216151857742308,60,7,53,8.21087351058588,51.7891264894141
"1970","mac",-0.216151857742308,60,7,53,8.21087351058588,51.7891264894141
"1970","see love",-0.216151857742308,60,7,53,8.21087351058588,51.7891264894141
"1970","sold",-0.216151857742308,60,7,53,8.21087351058588,51.7891264894141
"1970","sweetest",-0.216151857742308,60,7,53,8.21087351058588,51.7891264894141
"2010","like just",-0.216184707230693,88,12,76,13.5487197101042,74.4512802898958
"1970","cant help",-0.217170770601948,199,25,174,27.2327304767765,171.767269523223
"2000","house",-0.217723799999519,417,108,309,112.208731567597,304.791268432403
"1990","eat",-0.219198128253065,172,34,138,36.4888876998794,135.511112300121
"1980","outside",-0.220149998342595,205,32,173,34.4883241669335,170.511675833067
"2000","finding",-0.220304478692829,50,12,38,13.4542843606231,36.5457156393769
"2000","matters",-0.220304478692829,50,12,38,13.4542843606231,36.5457156393769
"2000","now never",-0.220304478692829,50,12,38,13.4542843606231,36.5457156393769
"2000","ship",-0.220304478692829,50,12,38,13.4542843606231,36.5457156393769
"1970","bad bad",-0.221250004175251,68,8,60,9.30565664533066,58.6943433546693
"1970","go wrong",-0.221250004175251,68,8,60,9.30565664533066,58.6943433546693
"1980","love cant",-0.222525683004192,112,17,95,18.8424014960807,93.1575985039193
"1970","meet",-0.222766367290026,381,49,332,52.1390467922203,328.86095320778
"1970","just dont",-0.224222248159202,184,23,161,25.18001209913,158.81998790087
"1960","dream",-0.224641459080775,789,44,745,47.1216627069775,741.878337293022
"1990","stick",-0.225168997059712,133,26,107,28.2152445586277,104.784755441372
"1980","beats",-0.225745782639932,68,10,58,11.4400294797633,56.5599705202367
"1980","seemed",-0.225745782639932,68,10,58,11.4400294797633,56.5599705202367
"1980","shinin",-0.225745782639932,68,10,58,11.4400294797633,56.5599705202367
"1980","back now",-0.226940453201476,87,13,74,14.6365083049913,72.3634916950087
"1980","see youre",-0.226940453201476,87,13,74,14.6365083049913,72.3634916950087
"1970","case",-0.227342815016599,76,9,67,10.4004397800754,65.5995602199246
"1970","said im",-0.227342815016599,76,9,67,10.4004397800754,65.5995602199246
"2000","come now",-0.228197304102154,93,23,70,25.024968910759,67.975031089241
"1990","future",-0.229024964669021,138,27,111,29.2759680382754,108.724031961725
"1980","remind",-0.229309536533693,162,25,137,27.2541878782596,134.74581212174
"1980","trouble",-0.229309536533693,162,25,137,27.2541878782596,134.74581212174
"1980","last",-0.229769691073658,827,134,693,139.130946761239,687.869053238761
"1980","half",-0.229872890626707,230,36,194,38.6942173580229,191.305782641977
"1960","meant",-0.229888809589047,318,17,301,18.9920009389339,299.007999061066
"1970","make feel",-0.230240023222937,404,52,352,55.2865483046116,348.713451695388
"1970","room",-0.231597023556324,389,50,339,53.2338299269651,335.766170073035
"2000","girls girls",-0.231611262423398,58,14,44,15.6069698583228,42.3930301416772
"2010","wanna go",-0.231646425541243,184,26,158,28.329141212036,155.670858787964
"2010","window",-0.231646425541243,184,26,158,28.329141212036,155.670858787964
"1960","get get get",-0.232801405410869,265,14,251,15.8266674491116,249.173332550888
"2000","respect",-0.233241992483054,124,31,93,33.3666252143453,90.6333747856547
"1970","nothin",-0.234598367174427,487,63,424,66.6449233275887,420.355076672411
"1980","afternoon",-0.235370003503755,49,7,42,8.24355065453532,40.7564493454647
"1980","guess im",-0.235370003503755,49,7,42,8.24355065453532,40.7564493454647
"1980","tears eyes",-0.235370003503755,49,7,42,8.24355065453532,40.7564493454647
"2000","hurting",-0.237629412186125,62,15,47,16.6833126071727,45.3166873928273
"2000","im wrong",-0.237629412186125,62,15,47,16.6833126071727,45.3166873928273
"2000","pair",-0.237629412186125,62,15,47,16.6833126071727,45.3166873928273
"2000","sunlight",-0.237629412186125,62,15,47,16.6833126071727,45.3166873928273
"1980","ones",-0.239372142543551,218,34,184,36.6753886263,181.3246113737
"1990","excuse",-0.239402449262063,69,13,56,14.6379840191377,54.3620159808623
"1990","girl oh",-0.23959902428528,64,12,52,13.57726053949,50.42273946051
"1990","shadow",-0.23959902428528,64,12,52,13.57726053949,50.42273946051
"1990","bones",-0.240601974385251,59,11,48,12.5165370598424,46.4834629401576
"1970","cry",-0.24069016755735,899,118,781,123.026254766945,775.973745233055
"1990","foot",-0.240807561470813,79,15,64,16.759430978433,62.240569021567
"1970","best friend",-0.241460776575753,92,11,81,12.590006049565,79.409993950435
"1980","never leave",-0.241489850628411,81,12,69,13.6270939391298,67.3729060608702
"1980","dont make",-0.24183766050373,125,19,106,21.0294659554472,103.970534044553
"1970","voice",-0.242547775270237,177,22,155,24.2220768562283,152.777923143772
"1990","askin",-0.24263986188038,54,10,44,11.4558135801947,42.5441864198053
"1990","life dont",-0.24263986188038,54,10,44,11.4558135801947,42.5441864198053
"1990","long im",-0.24263986188038,54,10,44,11.4558135801947,42.5441864198053
"1990","play game",-0.24263986188038,54,10,44,11.4558135801947,42.5441864198053
"2000","guy",-0.242852863489295,243,62,181,65.3878219926283,177.612178007372
"2010","jam",-0.242997756238104,164,23,141,25.2498867324668,138.750113267533
"2010","knock",-0.242997756238104,164,23,141,25.2498867324668,138.750113267533
"2000","happens",-0.243831363156966,66,16,50,17.7596553560225,48.2403446439775
"2000","mmm mmm",-0.243831363156966,66,16,50,17.7596553560225,48.2403446439775
"2000","turn lights",-0.243831363156966,66,16,50,17.7596553560225,48.2403446439775
"2000","take time",-0.24402699476109,155,39,116,41.7082815179316,113.291718482068
"2000","gold",-0.244206646280184,304,78,226,81.8020489125885,222.197951087411
"1980","love never",-0.244911524588586,100,15,85,16.8235727643578,83.1764272356422
"1980","belong belong",-0.245183753658158,62,9,53,10.4306151139018,51.5693848860982
"1980","got man",-0.245183753658158,62,9,53,10.4306151139018,51.5693848860982
"1980","love good",-0.245183753658158,62,9,53,10.4306151139018,51.5693848860982
"1980","need baby",-0.245183753658158,62,9,53,10.4306151139018,51.5693848860982
"1980","now see",-0.245183753658158,62,9,53,10.4306151139018,51.5693848860982
"1960","let love",-0.245184532588676,248,13,235,14.8113718014327,233.188628198567
"1990","right wrong",-0.246036692055188,49,9,40,10.3950901005471,38.604909899453
"1990","rest",-0.246472581879615,241,48,193,51.1268717190171,189.873128280983
"2010","holla",-0.246761005931064,130,18,112,20.0151541171993,109.984845882801
"2010","cant see",-0.247598101107016,306,44,262,47.1125935374076,258.887406462592
"1970","feeling",-0.248673147464936,922,121,801,126.173756279336,795.826243720664
"1980","pass",-0.248896907236168,243,38,205,40.8812818173894,202.118718182611
"1970","beauty",-0.249173014059252,100,12,88,13.6847891843098,86.3152108156902
"2000","bow",-0.250185395875397,70,17,53,18.8359981048724,51.1640018951276
"2000","dont look",-0.250185395875397,70,17,53,18.8359981048724,51.1640018951276
"2000","love song",-0.250185395875397,70,17,53,18.8359981048724,51.1640018951276
"1960","dont think",-0.250474532216316,284,15,269,16.9614096435762,267.038590356424
"1990","good life",-0.2512675762357,44,8,36,9.33436662089939,34.6656333791006
"1990","im gonna get",-0.2512675762357,44,8,36,9.33436662089939,34.6656333791006
"1990","made love",-0.2512675762357,44,8,36,9.33436662089939,34.6656333791006
"1990","now need",-0.2512675762357,44,8,36,9.33436662089939,34.6656333791006
"1990","pie",-0.2512675762357,44,8,36,9.33436662089939,34.6656333791006
"1990","think think",-0.2512675762357,44,8,36,9.33436662089939,34.6656333791006
"1990","want need",-0.2512675762357,44,8,36,9.33436662089939,34.6656333791006
"1970","hearts",-0.251992438389292,322,41,281,44.0650211734775,277.934978826522
"1970","falling",-0.253196994391662,375,48,327,51.3179594411617,323.682040558838
"1990","others",-0.25341131717682,109,21,88,23.1237718563189,85.8762281436811
"1990","rules",-0.25341131717682,109,21,88,23.1237718563189,85.8762281436811
"2000","around",-0.253640909014582,2228,589,1639,599.522911109366,1628.47708889063
"2010","notice",-0.253857857118458,68,9,59,10.469465230535,57.530534769465
"2010","named",-0.254449240224012,61,8,53,9.39172616268583,51.6082738373142
"2010","oclock",-0.254449240224012,61,8,53,9.39172616268583,51.6082738373142
"2010","oh lord",-0.254449240224012,61,8,53,9.39172616268583,51.6082738373142
"2010","silence",-0.254449240224012,61,8,53,9.39172616268583,51.6082738373142
"2010","know whats",-0.254666726185786,75,10,65,11.5472042983842,63.4527957016158
"2000","cross",-0.255813798207228,136,34,102,36.5956534608949,99.4043465391051
"1960","double",-0.25611023025259,122,6,116,7.28623935393062,114.713760646069
"2010","laughing",-0.25651062258848,82,11,71,12.6249433662334,69.3750566337666
"2000","spread",-0.256666692922787,74,18,56,19.9123408537222,54.0876591462778
"2010","new york city",-0.257000962367497,54,7,47,8.31398709483664,45.6860129051634
"2010","shirt",-0.257000962367497,54,7,47,8.31398709483664,45.6860129051634
"2010","someones",-0.257000962367497,54,7,47,8.31398709483664,45.6860129051634
"2000","gonna love",-0.257764569342004,109,27,82,29.3303399061584,79.6696600938416
"1980","cause baby",-0.258468986733051,75,11,64,12.6176795732683,62.3823204267317
"2010","somethin",-0.258547309657239,293,42,251,45.1110781256877,247.888921874312
"1990","bother",-0.259058532765498,39,7,32,8.27364314125173,30.7263568587483
"1990","fortune",-0.259058532765498,39,7,32,8.27364314125173,30.7263568587483
"1990","lala",-0.259058532765498,39,7,32,8.27364314125173,30.7263568587483
"1990","youll know",-0.259058532765498,39,7,32,8.27364314125173,30.7263568587483
"2010","boat",-0.259141202729954,89,12,77,13.7026824340826,75.2973175659174
"2010","nothings",-0.259141202729954,89,12,77,13.7026824340826,75.2973175659174
"1960","band",-0.259190311343931,195,10,185,11.6460383116104,183.35396168839
"1960","funky",-0.259190311343931,195,10,185,11.6460383116104,183.35396168839
"1990","sweet",-0.259656290576348,1136,234,902,240.996374575948,895.003625424052
"2010","feelin",-0.259689222634973,494,72,422,76.0575856453574,417.942414354643
"1990","turned",-0.259839152237603,256,51,205,54.3090421579601,201.69095784204
"1960","never let",-0.260772222625408,177,9,168,10.5710193905387,166.428980609461
"1960","york",-0.260772222625408,177,9,168,10.5710193905387,166.428980609461
"2010","mary",-0.262383703258588,96,13,83,14.7804215019318,81.2195784980682
"2010","gonna run",-0.262418061357177,47,6,41,7.23624802698745,39.7637519730126
"2010","guilty",-0.262418061357177,47,6,41,7.23624802698745,39.7637519730126
"2010","pillow",-0.262418061357177,47,6,41,7.23624802698745,39.7637519730126
"2010","sun goes",-0.262418061357177,47,6,41,7.23624802698745,39.7637519730126
"2010","theres much",-0.262418061357177,47,6,41,7.23624802698745,39.7637519730126
"2010","time oh",-0.262418061357177,47,6,41,7.23624802698745,39.7637519730126
"2010","tricks",-0.262418061357177,47,6,41,7.23624802698745,39.7637519730126
"2010","want ill",-0.262418061357177,47,6,41,7.23624802698745,39.7637519730126
"1970","taking",-0.263217421752113,216,27,189,29.5591446381092,186.440855361891
"1980","just get",-0.263281591438468,113,17,96,19.0106372237243,93.9893627762757
"1960","one night",-0.264054231034673,159,8,151,9.49600046946696,149.503999530533
"1970","aint good",-0.264117079197784,53,6,47,7.25293826768419,45.7470617323158
"1970","chasing",-0.264117079197784,53,6,47,7.25293826768419,45.7470617323158
"1970","know right",-0.264117079197784,53,6,47,7.25293826768419,45.7470617323158
"1970","say know",-0.264117079197784,53,6,47,7.25293826768419,45.7470617323158
"2010","love girl",-0.264151921276799,151,21,130,23.2483713207469,127.751628679253
"1970","although",-0.264550784313794,61,7,54,8.34772140242897,52.652278597571
"1970","gonna tell",-0.264550784313794,61,7,54,8.34772140242897,52.652278597571
"1970","now oh",-0.264550784313794,61,7,54,8.34772140242897,52.652278597571
"1970","oclock",-0.264550784313794,61,7,54,8.34772140242897,52.652278597571
"1970","sense",-0.265448818145568,116,14,102,15.8743554537994,100.125644546201
"1980","black white",-0.265758079878489,43,6,37,7.23413628867385,35.7658637113261
"1980","god knows",-0.265758079878489,43,6,37,7.23413628867385,35.7658637113261
"1980","impossible",-0.265758079878489,43,6,37,7.23413628867385,35.7658637113261
"1980","keep comin",-0.265758079878489,43,6,37,7.23413628867385,35.7658637113261
"1980","like nobody",-0.265758079878489,43,6,37,7.23413628867385,35.7658637113261
"1980","real good",-0.265758079878489,43,6,37,7.23413628867385,35.7658637113261
"1980","sending",-0.265758079878489,43,6,37,7.23413628867385,35.7658637113261
"1970","get know",-0.267192932842526,69,8,61,9.44250453717376,59.5574954628262
"1990","na na",-0.267536918074695,1366,282,1084,289.78965463974,1076.21034536026
"1980","care",-0.268047538430848,702,113,589,118.101480805792,583.898519194208
"1980","really wanna",-0.268659802507708,188,29,159,31.6283167969926,156.371683203007
"2010","movin",-0.268704644653895,192,27,165,29.5608430038636,162.439156996136
"1990","oh yes",-0.268826861708153,134,26,108,28.4273892545572,105.572610745443
"1970","can feel",-0.268980722759039,300,38,262,41.0543675529294,258.945632447071
"1980","drug",-0.268994289718577,56,8,48,9.42120074804036,46.5787992519596
"1980","now ill",-0.268994289718577,56,8,48,9.42120074804036,46.5787992519596
"1980","shall",-0.268994289718577,56,8,48,9.42120074804036,46.5787992519596
"1990","ohh",-0.269405446248041,188,37,151,39.8832028347519,148.116797165248
"2000","rock rock",-0.269936161338411,82,20,62,22.0650263514219,59.9349736485781
"1990","agree",-0.270577531165773,34,6,28,7.21291966160408,26.7870803383959
"1990","dont just",-0.270577531165773,34,6,28,7.21291966160408,26.7870803383959
"1990","frontin",-0.270577531165773,34,6,28,7.21291966160408,26.7870803383959
"1990","glow",-0.270577531165773,34,6,28,7.21291966160408,26.7870803383959
"1990","let put",-0.270577531165773,34,6,28,7.21291966160408,26.7870803383959
"1990","mention",-0.270577531165773,34,6,28,7.21291966160408,26.7870803383959
"1990","really like",-0.270577531165773,34,6,28,7.21291966160408,26.7870803383959
"1990","said goodbye",-0.270577531165773,34,6,28,7.21291966160408,26.7870803383959
"1990","shootin",-0.270577531165773,34,6,28,7.21291966160408,26.7870803383959
"1990","true dont",-0.270577531165773,34,6,28,7.21291966160408,26.7870803383959
"1990","want show",-0.270577531165773,34,6,28,7.21291966160408,26.7870803383959
"1990","wearin",-0.270577531165773,34,6,28,7.21291966160408,26.7870803383959
"1980","im feeling",-0.271086117707539,132,20,112,22.2071160489523,109.792883951048
"1970","ever seen",-0.271341175279298,77,9,68,10.5372876719185,66.4627123280815
"2000","baby can",-0.272422136549776,194,49,145,52.2026233192177,141.797376680782
"1980","letter",-0.27366939676444,88,13,75,14.8047440326349,73.1952559673651
"1990","last night",-0.275674962012365,144,28,116,30.5488362138526,113.451163786147
"1970","fit",-0.276562505219067,85,10,75,11.6320708066633,73.3679291933367
"1970","wont take",-0.276562505219067,85,10,75,11.6320708066633,73.3679291933367
"1960","five",-0.277341189242596,196,10,186,11.7057615850033,184.294238414997
"1980","come around",-0.278537619259206,69,10,59,11.6082652074069,57.3917347925931
"1980","dont forget",-0.278537619259206,69,10,59,11.6082652074069,57.3917347925931
"1980","news",-0.278537619259206,69,10,59,11.6082652074069,57.3917347925931
"1980","way",-0.279091387577935,4483,741,3742,754.20076702616,3728.79923297384
"2010","shy",-0.279375568263895,124,17,107,19.0913777733286,104.908622226671
"1970","try",-0.280613265337596,1260,166,1094,172.428343722303,1087.5716562777
"2000","stuck",-0.281401556176551,175,44,131,47.0899952621809,127.910004737819
"1980","slowly",-0.281926466996569,126,19,107,21.1977016830908,104.802298316909
"1990","end",-0.284249387311387,629,128,501,133.439013739675,495.560986260325
"1960","find way",-0.284299395474069,160,8,152,9.55572374285983,150.44427625714
"1970","roof",-0.28470329345282,163,20,143,22.306206370425,140.693793629575
"1990","thats right",-0.286446450093075,159,31,128,33.7310066527955,125.268993347204
"2000","havent",-0.287467367755988,125,31,94,33.6357109015578,91.3642890984422
"2000","love way",-0.289221152393421,248,63,185,66.7332504286907,181.266749571309
"1990","alone",-0.289544238906645,975,200,775,206.841078531293,768.158921468707
"2000","dont love",-0.290410707347477,94,23,71,25.2940545979715,68.7059454020285
"1960","waitin",-0.291402242415363,142,7,135,8.4807048217881,133.519295178212
"1980","dont see",-0.293893829506255,120,18,102,20.1882873172294,99.8117126827707
"1980","back dont",-0.298833098974284,50,7,43,8.4117863821789,41.5882136178211
"1980","make happen",-0.298833098974284,50,7,43,8.4117863821789,41.5882136178211
"1990","crack",-0.29923241182389,85,16,69,18.0322991540102,66.9677008459898
"1990","asking",-0.299500775616015,90,17,73,19.0930226336578,70.9069773663421
"1990","let show",-0.299500775616015,90,17,73,19.0930226336578,70.9069773663421
"2010","touch",-0.300054740455412,942,139,803,145.032885987706,796.967114012294
"1990","life life",-0.300408776198829,75,14,61,15.9108521947149,59.0891478052851
"1990","staring",-0.300408776198829,75,14,61,15.9108521947149,59.0891478052851
"2000","completely",-0.300676995027311,39,9,30,10.494341801286,28.505658198714
"2000","dance like",-0.300676995027311,39,9,30,10.494341801286,28.505658198714
"2000","get caught",-0.300676995027311,39,9,30,10.494341801286,28.505658198714
"2000","im sayin",-0.300676995027311,39,9,30,10.494341801286,28.505658198714
"2000","lights lights",-0.300676995027311,39,9,30,10.494341801286,28.505658198714
"2000","nervous",-0.300676995027311,39,9,30,10.494341801286,28.505658198714
"2000","unh",-0.300676995027311,39,9,30,10.494341801286,28.505658198714
"2000","creepin",-0.300796160572544,43,10,33,11.5706845501359,31.4293154498641
"2000","fault",-0.300796160572544,43,10,33,11.5706845501359,31.4293154498641
"2000","impossible",-0.300796160572544,43,10,33,11.5706845501359,31.4293154498641
"2000","like ooh",-0.300796160572544,43,10,33,11.5706845501359,31.4293154498641
"2000","promise promise",-0.300796160572544,43,10,33,11.5706845501359,31.4293154498641
"2000","real good",-0.300796160572544,43,10,33,11.5706845501359,31.4293154498641
"2000","watched",-0.300796160572544,43,10,33,11.5706845501359,31.4293154498641
"1970","buy",-0.300867855270496,225,28,197,30.790775664697,194.209224335303
"1990","dime",-0.301316517937515,100,19,81,21.2144695929532,78.7855304070468
"1990","folks",-0.302103028098225,70,13,57,14.8501287150672,55.1498712849328
"1990","love song",-0.302103028098225,70,13,57,14.8501287150672,55.1498712849328
"1990","think love",-0.302103028098225,70,13,57,14.8501287150672,55.1498712849328
"1990","youyou",-0.302103028098225,70,13,57,14.8501287150672,55.1498712849328
"2000","guilty",-0.302195295400731,47,11,36,12.6470272989857,34.3529727010143
"2000","middle night",-0.302195295400731,47,11,36,12.6470272989857,34.3529727010143
"2000","stopped",-0.302195295400731,47,11,36,12.6470272989857,34.3529727010143
"2000","will still",-0.302195295400731,47,11,36,12.6470272989857,34.3529727010143
"2000","hip hop",-0.302286136018779,35,8,27,9.41799905243618,25.5820009475638
"2000","just thought",-0.302286136018779,35,8,27,9.41799905243618,25.5820009475638
"2000","oh thats",-0.302286136018779,35,8,27,9.41799905243618,25.5820009475638
"2000","perfume",-0.302286136018779,35,8,27,9.41799905243618,25.5820009475638
"2000","show show",-0.302286136018779,35,8,27,9.41799905243618,25.5820009475638
"2000","word say",-0.302286136018779,35,8,27,9.41799905243618,25.5820009475638
"2000","deny",-0.30235428029463,133,33,100,35.7883963992575,97.2116036007425
"2000","itll",-0.30235428029463,133,33,100,35.7883963992575,97.2116036007425
"1980","babyi",-0.302618575933427,63,9,54,10.5988508415454,52.4011491584546
"1980","now want",-0.302618575933427,63,9,54,10.5988508415454,52.4011491584546
"1980","oh uh",-0.302618575933427,63,9,54,10.5988508415454,52.4011491584546
"1980","yeah now",-0.302618575933427,63,9,54,10.5988508415454,52.4011491584546
"1990","know aint",-0.302740523133884,105,20,85,22.2751930726008,82.7248069273992
"1960","doesnt",-0.303503260264189,341,18,323,20.36563622697,320.63436377303
"2000","anything",-0.303564420624163,636,165,471,171.138497067126,464.861502932874
"1970","deep inside",-0.30371877410755,117,14,103,16.0112033456425,100.988796654358
"2000","dont cry",-0.30433578477029,102,25,77,27.4467400956712,74.5532599043289
"1990","blues",-0.304445293477766,110,21,89,23.3359165522485,86.6640834477515
"1990","love youre",-0.304445293477766,110,21,89,23.3359165522485,86.6640834477515
"1990","take take",-0.304445293477766,110,21,89,23.3359165522485,86.6640834477515
"2000","take place",-0.304568833077222,51,12,39,13.7233700478356,37.2766299521644
"2010","cant hear",-0.304688595846724,83,11,72,12.7789060902119,70.2210939097881
"1990","drove",-0.304766372469548,65,12,53,13.7894052354196,51.2105947645804
"1990","thats im",-0.304766372469548,65,12,53,13.7894052354196,51.2105947645804
"2010","way move",-0.305600071422944,90,12,78,13.8566451580611,76.1433548419389
"2000","another round",-0.306309182371442,31,7,24,8.34165630358633,22.6583436964137
"2000","just leave",-0.306309182371442,31,7,24,8.34165630358633,22.6583436964137
"2000","longing",-0.306309182371442,31,7,24,8.34165630358633,22.6583436964137
"2000","night long night",-0.306309182371442,31,7,24,8.34165630358633,22.6583436964137
"2000","tape",-0.306309182371442,31,7,24,8.34165630358633,22.6583436964137
"2000","youll get",-0.306309182371442,31,7,24,8.34165630358633,22.6583436964137
"2010","spell",-0.30652093013521,69,9,60,10.6234279545135,58.3765720454865
"1980","love come",-0.307171863914507,114,17,97,19.1788729513679,94.8211270486321
"2000","closed",-0.307701324356973,55,13,42,14.7997127966854,40.2002872033146
"1990","wow",-0.308555186619497,120,23,97,25.4573635115438,94.5426364884562
"2010","got right",-0.310114833904163,62,8,54,9.54568888666429,52.4543111133357
"2010","mountains",-0.310114833904163,62,8,54,9.54568888666429,52.4543111133357
"2000","gonna come",-0.311436489998854,59,14,45,15.8760555455353,43.1239444544647
"2000","got real",-0.311436489998854,59,14,45,15.8760555455353,43.1239444544647
"2000","whats name",-0.311436489998854,59,14,45,15.8760555455353,43.1239444544647
"1970","dont care",-0.31238631320409,355,45,310,48.5810016042998,306.4189983957
"2010","one two",-0.312833742464377,111,15,96,17.0898623616086,93.9101376383913
"2010","small",-0.312833742464377,111,15,96,17.0898623616086,93.9101376383913
"1990","come get",-0.313185621945748,194,38,156,41.1560710103291,152.843928989671
"1980","next",-0.313186622852793,491,78,413,82.6037422729968,408.396257727003
"1970","another",-0.313673069937495,1121,147,974,153.406486756113,967.593513243887
"2000","ask im",-0.313850075669535,27,6,21,7.26531355473648,19.7346864452635
"2000","done dont",-0.313850075669535,27,6,21,7.26531355473648,19.7346864452635
"2000","find one",-0.313850075669535,27,6,21,7.26531355473648,19.7346864452635
"2000","girl gotta",-0.313850075669535,27,6,21,7.26531355473648,19.7346864452635
"2000","glitter",-0.313850075669535,27,6,21,7.26531355473648,19.7346864452635
"2000","go wanna",-0.313850075669535,27,6,21,7.26531355473648,19.7346864452635
"2000","group",-0.313850075669535,27,6,21,7.26531355473648,19.7346864452635
"2000","hunger",-0.313850075669535,27,6,21,7.26531355473648,19.7346864452635
"2000","intentions",-0.313850075669535,27,6,21,7.26531355473648,19.7346864452635
"2000","just another day",-0.313850075669535,27,6,21,7.26531355473648,19.7346864452635
"2000","keep dancin",-0.313850075669535,27,6,21,7.26531355473648,19.7346864452635
"2000","make one",-0.313850075669535,27,6,21,7.26531355473648,19.7346864452635
"2000","miss like",-0.313850075669535,27,6,21,7.26531355473648,19.7346864452635
"2000","now youre gone",-0.313850075669535,27,6,21,7.26531355473648,19.7346864452635
"2000","please baby",-0.313850075669535,27,6,21,7.26531355473648,19.7346864452635
"2000","rainbow",-0.313850075669535,27,6,21,7.26531355473648,19.7346864452635
"2000","say shes",-0.313850075669535,27,6,21,7.26531355473648,19.7346864452635
"2000","stories",-0.313850075669535,27,6,21,7.26531355473648,19.7346864452635
"2000","uh dont",-0.313850075669535,27,6,21,7.26531355473648,19.7346864452635
"2000","yeah girl",-0.313850075669535,27,6,21,7.26531355473648,19.7346864452635
"1990","colors",-0.314084470294626,55,10,45,11.6679582761242,43.3320417238758
"1990","doesnt mean",-0.314084470294626,55,10,45,11.6679582761242,43.3320417238758
"1990","eyes can",-0.314084470294626,55,10,45,11.6679582761242,43.3320417238758
"1990","liked",-0.314084470294626,55,10,45,11.6679582761242,43.3320417238758
"1990","threw",-0.314084470294626,55,10,45,11.6679582761242,43.3320417238758
"1960","young",-0.314171963676854,589,32,557,35.1770080284028,553.822991971597
"2000","know baby",-0.315658209400322,63,15,48,16.9523982943851,46.0476017056149
"2010","takin",-0.316293108855554,118,16,102,18.1676014294578,99.8323985705422
"2010","better get",-0.316433819860167,55,7,48,8.4679498188151,46.5320501811849
"2010","colors",-0.316433819860167,55,7,48,8.4679498188151,46.5320501811849
"2010","vain",-0.316433819860167,55,7,48,8.4679498188151,46.5320501811849
"2010","york city",-0.316433819860167,55,7,48,8.4679498188151,46.5320501811849
"1970","baby im",-0.316834697474788,340,43,297,46.5282832266533,293.471716773347
"1970","give time",-0.316937693448077,70,8,62,9.57935242901686,60.4206475709831
"2010","whatcha",-0.317013653005653,173,24,149,26.6355512482729,146.364448751727
"1970","busy",-0.317200511143232,62,7,55,8.48456929427207,53.5154307057279
"1970","guide",-0.317200511143232,62,7,55,8.48456929427207,53.5154307057279
"1970","see eyes",-0.318777604288247,78,9,69,10.6741355637616,67.3258644362384
"2000","baby ooh",-0.320278397866236,67,16,51,18.028741043235,48.971258956765
"1990","ill get",-0.321560165242972,50,9,41,10.6072347964766,39.3927652035234
"1990","recognize",-0.321560165242972,50,9,41,10.6072347964766,39.3927652035234
"1990","shore",-0.321560165242972,50,9,41,10.6072347964766,39.3927652035234
"1990","spring",-0.321560165242972,50,9,41,10.6072347964766,39.3927652035234
"1970","kinda",-0.32171018214148,264,33,231,36.1278434465778,227.872156553422
"1980","mercy",-0.321986467504588,108,16,92,18.1694585855064,89.8305414144936
"1970","prayer",-0.322120542691974,86,10,76,11.7689186985064,74.2310813014936
"2000","sittin",-0.323529215379731,172,43,129,46.2827382005435,125.717261799456
"2000","baby youre",-0.324718002277441,145,36,109,39.017424645807,105.982575354193
"2000","seeing",-0.325229025879484,71,17,54,19.1050837920848,51.8949162079152
"2010","embrace",-0.326717758705651,48,6,42,7.3902107509659,40.6097892490341
"2010","extra",-0.326717758705651,48,6,42,7.3902107509659,40.6097892490341
"2010","get im",-0.326717758705651,48,6,42,7.3902107509659,40.6097892490341
"2010","like aint",-0.326717758705651,48,6,42,7.3902107509659,40.6097892490341
"2010","situation",-0.326717758705651,48,6,42,7.3902107509659,40.6097892490341
"2010","youbaby",-0.326717758705651,48,6,42,7.3902107509659,40.6097892490341
"1960","baby come",-0.326764185667712,125,6,119,7.46540917410924,117.534590825891
"1960","dont make",-0.326764185667712,125,6,119,7.46540917410924,117.534590825891
"1990","long time",-0.327901095082121,155,30,125,32.8824278690774,122.117572130923
"1980","skin",-0.330823731734557,146,22,124,24.5624162359624,121.437583764038
"1960","playing",-0.331358505064338,217,11,206,12.9599503262536,204.040049673746
"1980","babe",-0.331553793838438,675,108,567,113.559116159415,561.440883840585
"1990","around dont",-0.331774909069242,45,8,37,9.54651131682892,35.4534886831711
"1990","come easy",-0.331774909069242,45,8,37,9.54651131682892,35.4534886831711
"1990","im scared",-0.331774909069242,45,8,37,9.54651131682892,35.4534886831711
"1990","liquor",-0.331774909069242,45,8,37,9.54651131682892,35.4534886831711
"1990","realized",-0.331774909069242,45,8,37,9.54651131682892,35.4534886831711
"1990","roads",-0.331774909069242,45,8,37,9.54651131682892,35.4534886831711
"1990","simply",-0.331774909069242,45,8,37,9.54651131682892,35.4534886831711
"1980","cute",-0.332043696200754,57,8,49,9.58943647568394,47.4105635243161
"1980","oh yeah yeah",-0.332043696200754,57,8,49,9.58943647568394,47.4105635243161
"2010","love oh",-0.332510574810017,228,32,196,35.103501067088,192.896498932912
"2000","go dont",-0.332644432291154,118,29,89,31.7521110910705,86.2478889089295
"2010","cant wait",-0.333336704891839,146,20,126,22.4785577008546,123.521442299145
"1960","word",-0.33355795242014,343,18,325,20.4850827737558,322.514917226244
"1960","times",-0.335955980637411,626,34,592,37.3867691439391,588.613230856061
"1970","hold tight",-0.336010997471966,149,18,131,20.3903358846216,128.609664115378
"1970","every time",-0.336032109134867,356,45,311,48.7178494961429,307.282150503857
"1980","distance",-0.336242862148222,70,10,60,11.7765009350505,58.2234990649496
"1980","can see eyes",-0.337315257850887,44,6,38,7.40237201631743,36.5976279836826
"1980","got baby",-0.337315257850887,44,6,38,7.40237201631743,36.5976279836826
"1980","groovy",-0.337315257850887,44,6,38,7.40237201631743,36.5976279836826
"1980","im missing",-0.337315257850887,44,6,38,7.40237201631743,36.5976279836826
"1980","meoh",-0.337315257850887,44,6,38,7.40237201631743,36.5976279836826
"1980","say cant",-0.337315257850887,44,6,38,7.40237201631743,36.5976279836826
"1980","think think",-0.337315257850887,44,6,38,7.40237201631743,36.5976279836826
"1980","whole lot",-0.337315257850887,44,6,38,7.40237201631743,36.5976279836826
"1980","never find",-0.338618673959902,102,15,87,17.1600442196449,84.8399557803551
"1960","baby know",-0.340703636142777,181,9,172,10.8099124841102,170.19008751589
"2000","can just",-0.34158168872638,83,20,63,22.3341120386344,60.6658879613656
"1980","fame",-0.342876134424015,140,21,119,23.5530018701009,116.446998129899
"1970","kisses",-0.344312285632799,118,14,104,16.1480512374856,101.851948762514
"1980","can just",-0.345381737973863,83,12,71,13.963565394417,69.036434605583
"1980","cat",-0.345381737973863,83,12,71,13.963565394417,69.036434605583
"1990","grip",-0.345793539890843,40,7,33,8.48578783718126,31.5142121628187
"1990","ityou",-0.345793539890843,40,7,33,8.48578783718126,31.5142121628187
"1990","pressure",-0.345793539890843,40,7,33,8.48578783718126,31.5142121628187
"1990","stop til",-0.345793539890843,40,7,33,8.48578783718126,31.5142121628187
"1980","wanna go",-0.348295899428091,184,28,156,30.9553738864183,153.044626113582
"1960","sleep",-0.348739995549117,433,23,410,25.8601773791144,407.139822620886
"1960","memories",-0.348949057201004,163,8,155,9.73489356303845,153.265106436962
"1990","im one",-0.349549077246917,239,47,192,50.7025823271581,188.297417672842
"1980","thats right",-0.349591856702222,159,24,135,26.7494806953289,132.250519304671
"1960","trying",-0.351182022537469,504,27,477,30.1005297900085,473.899470209992
"1980","kind",-0.354489360281839,554,88,466,93.2025931145422,460.797406885458
"2000","cry",-0.356172302486618,899,234,665,241.908032804004,657.091967195996
"2000","past",-0.35628734686001,215,54,161,57.8534227506794,157.146577249321
"2010","cause aint",-0.356548271469242,84,11,73,12.9328688141903,71.0671311858097
"1980","whoa oh oh",-0.357422591075296,96,14,82,16.1506298537835,79.8493701462165
"2010","first",-0.358197406345596,706,103,603,108.69768312879,597.30231687121
"2010","know dont know",-0.359082138543286,77,10,67,11.8551297463411,65.1448702536589
"2010","telephone",-0.359082138543286,77,10,67,11.8551297463411,65.1448702536589
"1990","man",-0.360145300215219,2466,511,1955,523.148820162225,1942.85117983778
"2010","park",-0.360574505232931,119,16,103,18.3215641534363,100.678435846564
"2000","cant let",-0.361381295296957,134,33,101,36.0574820864699,97.9425179135301
"2000","angel",-0.361493312085043,288,73,215,77.4966779171891,210.503322082811
"2010","blowing",-0.36353235784944,70,9,61,10.7773906784919,59.2226093215081
"2010","distance",-0.36353235784944,70,9,61,10.7773906784919,59.2226093215081
"2010","give time",-0.36353235784944,70,9,61,10.7773906784919,59.2226093215081
"2010","just know",-0.36353235784944,70,9,61,10.7773906784919,59.2226093215081
"2010","thatll",-0.36353235784944,70,9,61,10.7773906784919,59.2226093215081
"2010","youyou",-0.36353235784944,70,9,61,10.7773906784919,59.2226093215081
"2000","set",-0.36394482167513,395,101,294,106.288846448923,288.711153551077
"1990","teach",-0.363959792820545,81,15,66,17.1837203702921,63.8162796297079
"1990","corner",-0.364971989711359,131,25,106,27.7909551667686,103.209044833231
"1990","start",-0.365286454416728,753,153,600,159.744956034937,593.255043965063
"1990","high like",-0.365316130732499,35,6,29,7.42506435753361,27.5749356424664
"1990","ive gotta",-0.365316130732499,35,6,29,7.42506435753361,27.5749356424664
"1990","just dream",-0.365316130732499,35,6,29,7.42506435753361,27.5749356424664
"1990","love things",-0.365316130732499,35,6,29,7.42506435753361,27.5749356424664
"1990","right side",-0.365316130732499,35,6,29,7.42506435753361,27.5749356424664
"1990","tryin make",-0.365316130732499,35,6,29,7.42506435753361,27.5749356424664
"1960","share",-0.366713245870255,237,12,225,14.1544157941111,222.845584205889
"1990","moment",-0.367017651843449,410,82,328,86.979325331108,323.020674668892
"1990","im trying",-0.367092060093071,76,14,62,16.1229968906444,59.8770031093556
"1990","married",-0.367092060093071,76,14,62,16.1229968906444,59.8770031093556
"1990","said im",-0.367092060093071,76,14,62,16.1229968906444,59.8770031093556
"1980","come",-0.368604761436213,4867,803,4064,818.803286441294,4048.19671355871
"2000","worry",-0.368765105605165,292,74,218,78.573020666039,213.426979333961
"1990","theyll",-0.368939505588764,141,27,114,29.912402126064,111.087597873936
"1970","ill love",-0.369558827210313,79,9,70,10.8109834556047,68.1890165443953
"1980","lied",-0.369867148363044,77,11,66,12.9541510285555,64.0458489714445
"1970","know oh",-0.370369516879955,71,8,63,9.71620032085995,61.2837996791401
"1970","last time",-0.370369516879955,71,8,63,9.71620032085995,61.2837996791401
"2010","just make",-0.370560118503378,63,8,55,9.69965161064275,53.3003483893573
"1990","just say",-0.371320725910263,71,13,58,15.0622734109967,55.9377265890033
"1990","uptown",-0.371320725910263,71,13,58,15.0622734109967,55.9377265890033
"2000","holdin",-0.372078208109541,103,25,78,27.7158257828836,75.2841742171164
"1970","lucky",-0.37339478817799,95,11,84,13.0005497250943,81.9994502749057
"1970","youre youre",-0.37339478817799,95,11,84,13.0005497250943,81.9994502749057
"1990","love girl",-0.373574050885141,151,29,122,32.0338490853593,118.966150914641
"2010","speak",-0.374152857198118,147,20,127,22.6325204248331,124.367479575167
"1990","ill keep",-0.376901364353573,66,12,54,14.0015499313491,51.9984500686509
"1990","lose control",-0.376901364353573,66,12,54,14.0015499313491,51.9984500686509
"1990","silver",-0.376901364353573,66,12,54,14.0015499313491,51.9984500686509
"1990","turn lights",-0.376901364353573,66,12,54,14.0015499313491,51.9984500686509
"1990","bet",-0.377843071451822,225,44,181,47.7325565841446,177.267443415855
"1990","ring",-0.378725027244172,274,54,220,58.1276466846917,215.872353315308
"1980","wishing",-0.378850839702386,90,13,77,15.141215487922,74.858784512078
"2010","gotta go",-0.381170718489949,56,7,49,8.62191254279355,47.3780874572064
"2010","guns",-0.381170718489949,56,7,49,8.62191254279355,47.3780874572064
"2010","pictures",-0.381170718489949,56,7,49,8.62191254279355,47.3780874572064
"2010","trick",-0.381170718489949,56,7,49,8.62191254279355,47.3780874572064
"1970","colors",-0.381581587540088,55,6,49,7.52663405137039,47.4733659486296
"1970","eyes see",-0.381581587540088,55,6,49,7.52663405137039,47.4733659486296
"1970","give one",-0.381581587540088,55,6,49,7.52663405137039,47.4733659486296
"1970","im gonna love",-0.381581587540088,55,6,49,7.52663405137039,47.4733659486296
"1960","dont worry",-0.384165345378884,183,9,174,10.9293590308959,172.070640969104
"1990","john",-0.384175742818515,61,11,50,12.9408264517014,48.0591735482986
"1990","now oh",-0.384175742818515,61,11,50,12.9408264517014,48.0591735482986
"2000","time im",-0.384492707643587,177,44,133,47.6281666366058,129.371833363394
"2000","small",-0.385000039384174,111,27,84,29.8685112805833,81.1314887194167
"2000","week",-0.385000039384174,111,27,84,29.8685112805833,81.1314887194167
"2000","nothin",-0.385289151902217,487,125,362,131.044729672469,355.955270327531
"1970","theyre",-0.386077774797277,472,60,412,64.5922049499422,407.407795050058
"1980","dear",-0.387504695133111,141,21,120,23.7212375977445,117.278762402256
"1980","want go",-0.390580120513293,103,15,88,17.3282799472885,85.6717200527115
"1980","makes",-0.392391924410523,739,118,621,124.326202728604,614.673797271396
"1990","careful",-0.393611541720317,56,10,46,11.8801029720538,44.1198970279462
"1990","natural",-0.393611541720317,56,10,46,11.8801029720538,44.1198970279462
"1990","rocks",-0.393611541720317,56,10,46,11.8801029720538,44.1198970279462
"1990","truly",-0.393611541720317,56,10,46,11.8801029720538,44.1198970279462
"2010","best",-0.396058906845328,908,133,775,139.798153372438,768.201846627562
"2010","kinda",-0.396523020057327,264,37,227,40.6461591303125,223.353840869688
"1980","thats way",-0.396614570895472,204,31,173,34.3200884392899,169.67991156071
"2010","regret",-0.396971322576032,49,6,43,7.54417347494436,41.4558265250556
"2010","wood",-0.396971322576032,49,6,43,7.54417347494436,41.4558265250556
"1980","car",-0.397313038473348,390,61,329,65.6119337809954,324.388066219005
"1960","live without",-0.397570779292846,202,10,192,12.0641012253605,189.935898774639
"1960","school",-0.397570779292846,202,10,192,12.0641012253605,189.935898774639
"1980","ever gonna",-0.398710581283868,71,10,61,11.944736662694,59.055263337306
"1980","im always",-0.398710581283868,71,10,61,11.944736662694,59.055263337306
"1980","imagine",-0.40082274352832,58,8,50,9.75767220332752,48.2423277966725
"1980","just turn",-0.40082274352832,58,8,50,9.75767220332752,48.2423277966725
"1980","never wanna",-0.40082274352832,58,8,50,9.75767220332752,48.2423277966725
"1980","ooh oh",-0.40082274352832,58,8,50,9.75767220332752,48.2423277966725
"2000","building",-0.400842441979399,56,13,43,15.0687984838979,40.9312015161021
"2000","nothing nothing",-0.400842441979399,56,13,43,15.0687984838979,40.9312015161021
"2000","papa",-0.400842441979399,56,13,43,15.0687984838979,40.9312015161021
"2000","tell whats",-0.400842441979399,56,13,43,15.0687984838979,40.9312015161021
"2000","dont mess",-0.400902660036393,52,12,40,13.992455735048,38.007544264952
"2000","love ya",-0.400902660036393,52,12,40,13.992455735048,38.007544264952
"2000","never go",-0.400902660036393,52,12,40,13.992455735048,38.007544264952
"2000","saving",-0.400902660036393,52,12,40,13.992455735048,38.007544264952
"2000","want tell",-0.402252866365302,48,11,37,12.9161129861982,35.0838870138018
"1980","girlfriend",-0.402483084380685,135,20,115,22.711823231883,112.288176768117
"1980","baby cause",-0.403491434577903,84,12,72,14.1318011220605,69.8681988779394
"1980","taught",-0.403491434577903,84,12,72,14.1318011220605,69.8681988779394
"1960","grown",-0.404680844400071,128,6,122,7.64457899428786,120.355421005712
"1960","weak",-0.404680844400071,128,6,122,7.64457899428786,120.355421005712
"1980","baby oh",-0.404957272651386,154,23,131,25.908302057111,128.091697942889
"2000","youre angel",-0.40525303306712,44,10,34,11.8397702373483,32.1602297626517
"2010","baby dont",-0.405684021648689,366,52,314,56.350356976115,309.649643023885
"1990","bodies",-0.405866296748677,51,9,42,10.8193794924061,40.1806205075939
"1990","mom",-0.405866296748677,51,9,42,10.8193794924061,40.1806205075939
"2000","shinin",-0.406091777436292,68,16,52,18.2978267304474,49.7021732695526
"2000","squeeze",-0.406091777436292,68,16,52,18.2978267304474,49.7021732695526
"1960","cmon",-0.406093493367059,239,12,227,14.2738623408969,224.726137659103
"2010","thick",-0.406170706649283,106,14,92,16.3200487417164,89.6799512582836
"1990","funk",-0.406612901489963,206,40,166,43.7018073614835,162.298192638516
"1960","hood",-0.406747345875457,184,9,175,10.9890823042888,173.010917695711
"1960","wall",-0.406747345875457,184,9,175,10.9890823042888,173.010917695711
"1960","window",-0.406747345875457,184,9,175,10.9890823042888,173.010917695711
"2010","deeper",-0.406851352934918,99,13,86,15.2423096738672,83.7576903261328
"2010","turns",-0.407466761897208,120,16,104,18.4755268774148,101.524473122585
"2000","tell tell",-0.409141864608376,72,17,55,19.3741694792973,52.6258305207027
"2000","want just",-0.409141864608376,72,17,55,19.3741694792973,52.6258305207027
"2010","guys",-0.409144930446951,127,17,110,19.5532659452639,107.446734054736
"2000","get dont",-0.410410932918472,40,9,31,10.7634274884985,29.2365725115015
"2000","love theres",-0.410410932918472,40,9,31,10.7634274884985,29.2365725115015
"2000","scars",-0.410410932918472,40,9,31,10.7634274884985,29.2365725115015
"2000","way just",-0.410410932918472,40,9,31,10.7634274884985,29.2365725115015
"2000","world just",-0.410410932918472,40,9,31,10.7634274884985,29.2365725115015
"1960","speak",-0.410604810801628,147,7,140,8.77932118875247,138.220678811248
"2000","girl like",-0.411651609000722,127,31,96,34.1738822759827,92.8261177240173
"2010","crack",-0.411995978054974,85,11,74,13.0868315381688,71.9131684618312
"2010","like love",-0.411995978054974,85,11,74,13.0868315381688,71.9131684618312
"2010","whoa whoa whoa",-0.411995978054974,85,11,74,13.0868315381688,71.9131684618312
"2000","la la",-0.414328791563104,1558,408,1150,419.235500677016,1138.76449932298
"1980","arent",-0.416051631836482,45,6,39,7.57060774396101,37.429392256039
"1980","can change",-0.416051631836482,45,6,39,7.57060774396101,37.429392256039
"1980","recall",-0.416051631836482,45,6,39,7.57060774396101,37.429392256039
"1980","wanna break",-0.416051631836482,45,6,39,7.57060774396101,37.429392256039
"1980","whose",-0.416051631836482,45,6,39,7.57060774396101,37.429392256039
"2000","take chance",-0.416600203468584,80,19,61,21.526854976997,58.473145023003
"2000","battle",-0.418466767559378,36,8,28,9.68708473964864,26.3129152603514
"2000","can read",-0.418466767559378,36,8,28,9.68708473964864,26.3129152603514
"2000","every morning",-0.418466767559378,36,8,28,9.68708473964864,26.3129152603514
"2000","gonna keep",-0.418466767559378,36,8,28,9.68708473964864,26.3129152603514
"2000","james",-0.418466767559378,36,8,28,9.68708473964864,26.3129152603514
"2000","neither",-0.418466767559378,36,8,28,9.68708473964864,26.3129152603514
"2000","read mind",-0.418466767559378,36,8,28,9.68708473964864,26.3129152603514
"1990","searching",-0.418949561748041,117,22,95,24.8209294237552,92.1790705762448
"1980","brand",-0.419161337314645,148,22,126,24.8988876912495,123.10111230875
"1960","picture",-0.419299319596698,166,8,158,9.91406338321707,156.085936616783
"1960","wide",-0.419299319596698,166,8,158,9.91406338321707,156.085936616783
"2010","yeah yeah",-0.421144368883798,1719,255,1464,264.661922518966,1454.33807748103
"2000","nowhere",-0.421340373517788,224,56,168,60.2751939355916,163.724806064408
"1990","seems like",-0.421440963909918,102,19,83,21.6387589848122,80.3612410151878
"1990","cause girl",-0.421894775456599,46,8,38,9.75865601275846,36.2413439872415
"1990","got mind",-0.421894775456599,46,8,38,9.75865601275846,36.2413439872415
"1990","know thats",-0.421894775456599,46,8,38,9.75865601275846,36.2413439872415
"1990","youre making",-0.421894775456599,46,8,38,9.75865601275846,36.2413439872415
"1990","beating",-0.423386855331921,97,18,79,20.5780355051646,76.4219644948354
"1990","kissed",-0.423386855331921,97,18,79,20.5780355051646,76.4219644948354
"1990","well well",-0.423386855331921,97,18,79,20.5780355051646,76.4219644948354
"1970","many times",-0.423595318781802,80,9,71,10.9478313474478,69.0521686525522
"1980","begin",-0.423796760942371,110,16,94,18.5059300407936,91.4940699592064
"1960","without",-0.423891862099694,1367,76,1291,81.6417147280587,1285.35828527194
"2010","fancy",-0.424759739051094,71,9,62,10.9313534024704,60.0686465975296
"1970","quite",-0.425036805717659,104,12,92,14.2321807516822,89.7678192483178
"2000","chains",-0.425453332813519,88,21,67,23.6795404746967,64.3204595253033
"1990","broken",-0.425502112446839,329,65,264,69.7956049608159,259.204395039184
"1990","lying",-0.426045201866983,92,17,75,19.5173120255169,72.4826879744831
"1970","complete",-0.427378759786305,72,8,64,9.85304821270305,62.146951787297
"2010","mei",-0.428183479321242,169,23,146,26.0197003523591,142.980299647641
"1970","peace",-0.428266454462752,167,20,147,22.8535979377974,144.146402062203
"2010","sit",-0.429524292993505,265,37,228,40.8001218542909,224.199878145709
"2000","play",-0.430064230471338,1125,293,832,302.72139811402,822.27860188598
"2000","baby theres",-0.430543558520576,32,7,25,8.61074199079879,23.3892580092012
"2000","boy youre",-0.430543558520576,32,7,25,8.61074199079879,23.3892580092012
"2000","cmon cmon",-0.430543558520576,32,7,25,8.61074199079879,23.3892580092012
"2000","dream come true",-0.430543558520576,32,7,25,8.61074199079879,23.3892580092012
"2000","eyes im",-0.430543558520576,32,7,25,8.61074199079879,23.3892580092012
"2000","feeling im",-0.430543558520576,32,7,25,8.61074199079879,23.3892580092012
"2000","hammer",-0.430543558520576,32,7,25,8.61074199079879,23.3892580092012
"2000","hey girl",-0.430543558520576,32,7,25,8.61074199079879,23.3892580092012
"2000","holding hands",-0.430543558520576,32,7,25,8.61074199079879,23.3892580092012
"2000","love inside",-0.430543558520576,32,7,25,8.61074199079879,23.3892580092012
"2000","tracks",-0.430543558520576,32,7,25,8.61074199079879,23.3892580092012
"2000","will keep",-0.430543558520576,32,7,25,8.61074199079879,23.3892580092012
"1980","oooh",-0.432122610755617,78,11,67,13.1223867561991,64.8776132438009
"1970","dont see",-0.432303715484616,120,14,106,16.4217470211718,103.578252978828
"1980","come come come come",-0.433186167429346,65,9,56,10.9353222968326,54.0646777031674
"1980","flash",-0.433186167429346,65,9,56,10.9353222968326,54.0646777031674
"1980","brand new",-0.434615599339063,142,21,121,23.8894733253881,118.110526674612
"1970","hole",-0.434681137556816,64,7,57,8.75826507795827,55.2417349220417
"1970","want stay",-0.434681137556816,64,7,57,8.75826507795827,55.2417349220417
"2010","know wont",-0.435623678274226,64,8,56,9.8536143346212,54.1463856653788
"2010","shadow",-0.435623678274226,64,8,56,9.8536143346212,54.1463856653788
"1990","streets",-0.436248274503634,177,34,143,37.5496111795271,139.450388820473
"2000","closer",-0.436388244000655,232,58,174,62.4278794332912,169.572120566709
"1970","grown",-0.437105674324709,128,15,113,17.5165301559165,110.483469844083
"1960","whos",-0.439640204416169,457,24,433,27.2935359405434,429.706464059457
"1990","ever seen",-0.439718258412472,77,14,63,16.3351415865739,60.6648584134261
"2000","never know",-0.440608957385659,100,24,76,26.9085687212462,73.0914312787538
"2000","comin",-0.442785749147893,355,90,265,95.5254189604241,259.474581039576
"1990","im doin",-0.44313867688641,41,7,34,8.6979325331108,32.3020674668892
"1990","lets take",-0.44313867688641,41,7,34,8.6979325331108,32.3020674668892
"1990","money dont",-0.44313867688641,41,7,34,8.6979325331108,32.3020674668892
"1990","say can",-0.44313867688641,41,7,34,8.6979325331108,32.3020674668892
"1990","things never",-0.44313867688641,41,7,34,8.6979325331108,32.3020674668892
"2010","catch",-0.443444046431688,347,49,298,53.4250652205243,293.574934779476
"1990","funny",-0.444162780590659,192,37,155,40.7317816184701,151.26821838153
"1980","believe im",-0.445025858203442,52,7,45,8.74825783746605,43.251742162534
"1980","bread",-0.445025858203442,52,7,45,8.74825783746605,43.251742162534
"1980","heart break",-0.445025858203442,52,7,45,8.74825783746605,43.251742162534
"1980","help help",-0.445025858203442,52,7,45,8.74825783746605,43.251742162534
"1980","baby lets",-0.445851548169617,104,15,89,17.4965156749321,86.5034843250679
"1980","let get",-0.445851548169617,104,15,89,17.4965156749321,86.5034843250679
"2000","ever ever",-0.446044578765972,104,25,79,27.9849114700961,76.0150885299039
"2010","sex",-0.446132811857902,245,34,211,37.7208673747218,207.279132625278
"2000","eye",-0.446292138870174,263,66,197,70.7695357368776,192.230464263122
"1970","holding",-0.446815528341701,299,37,262,40.9175196610863,258.082480338914
"1990","dont know youre",-0.446852945477949,72,13,59,15.2744181069263,56.7255818930737
"1990","set free",-0.446852945477949,72,13,59,15.2744181069263,56.7255818930737
"1970","careful",-0.447082625395029,56,6,50,7.66348194321348,48.3365180567865
"1970","cause thats",-0.447082625395029,56,6,50,7.66348194321348,48.3365180567865
"1970","nothing left",-0.447082625395029,56,6,50,7.66348194321348,48.3365180567865
"1970","yeah baby",-0.448386303199181,144,17,127,19.7060964254061,124.293903574594
"2000","ah oh",-0.448431924017935,28,6,22,7.53439924194894,20.4656007580511
"2000","back can",-0.448431924017935,28,6,22,7.53439924194894,20.4656007580511
"2000","im waiting",-0.448431924017935,28,6,22,7.53439924194894,20.4656007580511
"2000","say yeah yeah",-0.448431924017935,28,6,22,7.53439924194894,20.4656007580511
"2000","sound like",-0.448431924017935,28,6,22,7.53439924194894,20.4656007580511
"2000","tan",-0.448431924017935,28,6,22,7.53439924194894,20.4656007580511
"2000","virgin",-0.448431924017935,28,6,22,7.53439924194894,20.4656007580511
"2000","whip",-0.449028990002877,182,45,137,48.9735950726681,133.026404927332
"2010","im telling",-0.451010593371947,57,7,50,8.77587526677201,48.224124733228
"2010","independent",-0.451010593371947,57,7,50,8.77587526677201,48.224124733228
"1970","everybody",-0.451086045587688,1033,134,899,141.36387227392,891.63612772608
"1980","wake",-0.451991645928109,330,51,279,55.5177901223807,274.482209877619
"1990","style",-0.452883304281041,207,40,167,43.913952057413,163.086047942587
"1970","less",-0.454685630033198,152,18,134,20.8008795601509,131.199120439849
"1970","always",-0.454802587135578,1781,234,1547,243.726095372557,1537.27390462744
"2010","known",-0.455892493072621,211,29,182,32.4861347594543,178.513865240546
"1990","may",-0.456323421273797,476,95,381,100.980875262457,375.019124737543
"2010","freedom",-0.457320917814231,114,15,99,17.551750533544,96.448249466456
"2010","dont mean",-0.457325262224566,128,17,111,19.7072286692424,108.292771330758
"1990","bitches",-0.458049929338042,276,54,222,58.5519360765507,217.448063923449
"2010","go let go",-0.458679350752594,107,14,93,16.4740114656948,90.5259885343052
"2010","starts",-0.460046351931318,142,19,123,21.8627068049408,120.137293195059
"1990","walking",-0.465486069660411,227,44,183,48.1568459760037,178.843154023996
"1980","lately",-0.465569715854223,85,12,73,14.3000368497041,70.6999631502959
"1980","spinning",-0.465569715854223,85,12,73,14.3000368497041,70.6999631502959
"1980","want just",-0.465796708886362,72,10,62,12.1129723903376,59.8870276096624
"1980","supposed",-0.466887018055855,149,22,127,25.0671234188931,123.932876581107
"1990","mile",-0.466919081960372,62,11,51,13.152971147631,48.847028852369
"1990","snap",-0.466919081960372,62,11,51,13.152971147631,48.847028852369
"1990","surrender",-0.466919081960372,62,11,51,13.152971147631,48.847028852369
"1980","doo doo",-0.47074000700751,98,14,84,16.4871013090706,81.5128986909294
"1990","baby please dont",-0.471883287187983,36,6,30,7.63720905346314,28.3627909465369
"1990","cant forget",-0.471883287187983,36,6,30,7.63720905346314,28.3627909465369
"1990","knee",-0.471883287187983,36,6,30,7.63720905346314,28.3627909465369
"1990","little things",-0.471883287187983,36,6,30,7.63720905346314,28.3627909465369
"1990","took long",-0.471883287187983,36,6,30,7.63720905346314,28.3627909465369
"1980","fine",-0.472481373247271,608,96,512,102.287322407295,505.712677592705
"2010","ill get",-0.472921547474269,50,6,44,7.69813619892281,42.3018638010772
"2010","mine baby",-0.472921547474269,50,6,44,7.69813619892281,42.3018638010772
"2010","now know",-0.474439663283401,177,24,153,27.2514021441868,149.748597855813
"2010","streets",-0.474439663283401,177,24,153,27.2514021441868,149.748597855813
"1980","got real",-0.475119990704992,59,8,51,9.9259079309711,49.0740920690289
"1980","yeah dont",-0.475119990704992,59,8,51,9.9259079309711,49.0740920690289
"1970","just get",-0.476959587964879,113,13,100,15.4638117782701,97.5361882217299
"1990","probably",-0.478804898524126,138,26,112,29.2759680382754,108.724031961725
"2010","fair",-0.479010485675186,79,10,69,12.163055194298,66.8369448057019
"2010","laid",-0.479010485675186,79,10,69,12.163055194298,66.8369448057019
"2010","ooh yeah",-0.479010485675186,79,10,69,12.163055194298,66.8369448057019
"1980","sorry",-0.480121591311965,306,47,259,51.4801326589348,254.519867341065
"1990","dancer",-0.480904115189692,57,10,47,12.0922476679833,44.9077523320167
"1990","never will",-0.480904115189692,57,10,47,12.0922476679833,44.9077523320167
"1990","see baby",-0.480904115189692,57,10,47,12.0922476679833,44.9077523320167
"1990","little love",-0.481203948770501,118,22,96,25.0330741196847,92.9669258803153
"1970","wall",-0.482921553151507,184,22,162,25.18001209913,158.81998790087
"1980","proud",-0.484170993867229,143,21,122,24.0577090530316,118.942290946968
"1970","close",-0.484305802973319,764,98,666,104.551789368127,659.448210631873
"1990","can hear",-0.485279723760759,108,20,88,22.9116271603894,85.0883728396106
"1990","strange",-0.485279723760759,108,20,88,22.9116271603894,85.0883728396106
"1980","told",-0.485316652709759,780,124,656,131.223867561991,648.776132438009
"2000","way feel",-0.488280080894399,171,42,129,46.0136525133311,124.986347486669
"1990","ive got",-0.489032737383965,579,116,463,122.831778943199,456.168221056801
"2000","youi",-0.489374172669638,233,58,175,62.6969651205037,170.303034879496
"1970","cold",-0.489644946333726,522,66,456,71.4345995420971,450.565400457903
"1980","dont leave",-0.490367507316316,124,18,106,20.8612302278037,103.138769772196
"1960","knows",-0.490369065177352,496,26,470,29.6227436028655,466.377256397135
"1990","glass",-0.492073384110376,98,18,80,20.7901802010941,77.2098197989059
"2000","empty",-0.493982116393422,136,33,103,36.5956534608949,99.4043465391051
"1990","tear",-0.494142399384621,193,37,156,40.9439263143996,152.0560736856
"1960","didnt",-0.495247856912021,868,47,821,51.8398013050146,816.160198694985
"2000","kinda",-0.496579725931779,264,66,198,71.03862142409,192.96137857591
"1990","hotel",-0.496770005983191,93,17,76,19.7294567214464,73.2705432785536
"1990","thats just",-0.496770005983191,93,17,76,19.7294567214464,73.2705432785536
"1990","advice",-0.498577776527514,52,9,43,11.0315241883356,40.9684758116644
"1980","ill love",-0.498588199703891,79,11,68,13.2906224838427,65.7093775161573
"1980","now just",-0.498588199703891,79,11,68,13.2906224838427,65.7093775161573
"1980","try try",-0.498588199703891,79,11,68,13.2906224838427,65.7093775161573
"1980","waited",-0.498588199703891,79,11,68,13.2906224838427,65.7093775161573
"1970","know say",-0.499244108054528,65,7,58,8.89511296980137,56.1048870301986
"1970","stranger",-0.499244108054528,65,7,58,8.89511296980137,56.1048870301986
"1980","moves",-0.499612706998173,175,26,149,29.4412523376261,145.558747662374
"1960","nothing",-0.500165016811195,1236,68,1168,73.8179659135922,1162.18203408641
"2000","everytime",-0.500956241565394,69,16,53,18.5669124176599,50.4330875823401
"2000","wanna hear",-0.500956241565394,69,16,53,18.5669124176599,50.4330875823401
"2000","youll always",-0.500956241565394,69,16,53,18.5669124176599,50.4330875823401
"2000","get home",-0.50112832504549,65,15,50,17.49056966881,47.50943033119
"1980","know thats",-0.501627574771295,46,6,40,7.73884347160458,38.2611565283954
"1980","picked",-0.501627574771295,46,6,40,7.73884347160458,38.2611565283954
"1980","put hand",-0.501627574771295,46,6,40,7.73884347160458,38.2611565283954
"1980","see got",-0.501627574771295,46,6,40,7.73884347160458,38.2611565283954
"1980","sink",-0.501627574771295,46,6,40,7.73884347160458,38.2611565283954
"1980","want leave",-0.501627574771295,46,6,40,7.73884347160458,38.2611565283954
"2000","gonna tell",-0.502330104234342,61,14,47,16.4142269199602,44.5857730800398
"1990","dont take",-0.502535152471401,88,16,72,18.6687332417988,69.3312667582012
"1960","girl know",-0.502604195959612,188,9,179,11.2279753978603,176.77202460214
"1980","just keep",-0.503035624178457,137,20,117,23.0482946871702,113.95170531283
"2000","hot hot",-0.50304881184249,77,18,59,20.7195979153596,56.2804020846404
"2010","moment",-0.503126448872715,410,58,352,63.1247168311671,346.875283168833
"2000","blows",-0.50478319688193,57,13,44,15.3378841711103,41.6621158288897
"2000","bodys",-0.505069101345842,81,19,62,21.7959406642094,59.2040593357906
"2010","im im",-0.505152150392201,65,8,57,10.0075770585997,54.9924229414003
"2010","thats im",-0.505152150392201,65,8,57,10.0075770585997,54.9924229414003
"1980","just cant get",-0.50597288677633,66,9,57,11.1035580244761,54.8964419755239
"2010","maybe",-0.507120949499202,740,107,633,113.932415744058,626.067584255942
"1980","stars",-0.507553749035056,313,48,265,52.6577827524399,260.34221724756
"2000","ease",-0.507614721795369,85,20,65,22.8722834130593,62.1277165869407
"2000","make feel like",-0.507614721795369,85,20,65,22.8722834130593,62.1277165869407
"2010","dont like",-0.507715714236915,136,18,118,20.9389304610701,115.06106953893
"2010","theres one",-0.507898696808983,129,17,112,19.8611913932209,109.138808606779
"1980","ah ah",-0.50811175167468,213,32,181,35.8342099880821,177.165790011918
"2000","gonna go",-0.50877778716219,53,12,41,14.2615414222605,38.7384585777395
"2000","tonight baby",-0.50877778716219,53,12,41,14.2615414222605,38.7384585777395
"2000","without cant",-0.50877778716219,53,12,41,14.2615414222605,38.7384585777395
"1990","know theres",-0.509567233027995,83,15,68,17.6080097621511,65.3919902378489
"1990","makes feel",-0.509567233027995,83,15,68,17.6080097621511,65.3919902378489
"1970","miles",-0.509910209751781,169,20,149,23.1272937214836,145.872706278516
"1990","doesnt",-0.509957801921361,341,67,274,72.3413413119703,268.65865868803
"2010","move move",-0.510868216891981,115,15,100,17.7057132575225,97.2942867424775
"2010","stuff",-0.513021245176961,164,22,142,25.2498867324668,138.750113267533
"2000","brand",-0.513333385845574,148,36,112,39.8246817074444,108.175318292556
"2000","jealous",-0.514701392758042,49,11,38,13.1851986734107,35.8148013265894
"2000","shared",-0.514701392758042,49,11,38,13.1851986734107,35.8148013265894
"2000","whiskey",-0.514701392758042,49,11,38,13.1851986734107,35.8148013265894
"2000","whos gonna",-0.514701392758042,49,11,38,13.1851986734107,35.8148013265894
"2000","walked",-0.515529138684007,218,54,164,58.6606798123168,159.339320187683
"2010","round",-0.51612215372319,727,105,622,111.930900332338,615.069099667662
"1970","flow",-0.516468428449209,177,21,156,24.2220768562283,152.777923143772
"1970","cant sleep",-0.516870146306281,57,6,51,7.80032983505658,49.1996701649434
"1970","everybody wants",-0.516870146306281,57,6,51,7.80032983505658,49.1996701649434
"1970","plain",-0.516870146306281,57,6,51,7.80032983505658,49.1996701649434
"1970","shows",-0.516870146306281,57,6,51,7.80032983505658,49.1996701649434
"1970","way say",-0.516870146306281,57,6,51,7.80032983505658,49.1996701649434
"1960","tried",-0.517785430457442,408,21,387,24.3670955442926,383.632904455707
"1960","ill take",-0.518275009203836,151,7,144,9.01821428232397,141.981785717676
"2010","kid",-0.518282405459908,178,24,154,27.4053648681652,150.594635131835
"2010","hold hold",-0.518549105631926,101,13,88,15.5502351218241,85.4497648781759
"1980","ways",-0.520703433471749,207,31,176,34.8247956222206,172.175204377779
"1990","day im",-0.521170611137572,47,8,39,9.97080070868799,37.029199291312
"1990","like got",-0.521170611137572,47,8,39,9.97080070868799,37.029199291312
"1990","rocking",-0.521170611137572,47,8,39,9.97080070868799,37.029199291312
"1990","still got",-0.521170611137572,47,8,39,9.97080070868799,37.029199291312
"2000","love still",-0.523083459449242,45,10,35,12.1088559245608,32.8911440754392
"2000","thank god",-0.523083459449242,45,10,35,12.1088559245608,32.8911440754392
"1980","corner",-0.523706983322076,131,19,112,22.0388803213087,108.961119678691
"2000","fill",-0.524048929470055,191,47,144,51.3953662575803,139.60463374242
"2010","keeping",-0.524836122714355,94,12,82,14.4724960539749,79.5275039460251
"2010","night night",-0.524836122714355,94,12,82,14.4724960539749,79.5275039460251
"2010","will love",-0.524836122714355,94,12,82,14.4724960539749,79.5275039460251
"1970","drive",-0.525258391720797,340,42,298,46.5282832266533,293.471716773347
"1970","reason",-0.525258391720797,340,42,298,46.5282832266533,293.471716773347
"2010","go im",-0.525763615903461,58,7,51,8.92983799075047,49.0701620092495
"2010","human",-0.525763615903461,58,7,51,8.92983799075047,49.0701620092495
"2010","night can",-0.525763615903461,58,7,51,8.92983799075047,49.0701620092495
"1980","chasing",-0.52722656141525,53,7,46,8.91649356510963,44.0835064348904
"1980","gonna go",-0.52722656141525,53,7,46,8.91649356510963,44.0835064348904
"1980","hoo hoo",-0.52722656141525,53,7,46,8.91649356510963,44.0835064348904
"1980","kind girl",-0.52722656141525,53,7,46,8.91649356510963,44.0835064348904
"1980","now cause",-0.52722656141525,53,7,46,8.91649356510963,44.0835064348904
"1980","sunny",-0.52722656141525,53,7,46,8.91649356510963,44.0835064348904
"1970","build",-0.527996283971675,114,13,101,15.6006596701132,98.3993403298868
"1970","uhh",-0.528234158395567,106,12,94,14.5058765353684,91.4941234646316
"1970","longer",-0.530154903009486,98,11,87,13.4110934006236,84.5889065993764
"1970","put hands",-0.530389472891844,193,23,170,26.4116431257179,166.588356874282
"1970","crowd",-0.531296007147079,130,15,115,17.7902259396027,112.209774060397
"1980","problems",-0.531516159756978,86,12,74,14.4682725773477,71.5317274226523
"2010","body body",-0.533298300238024,87,11,76,13.3947569861257,73.6052430138743
"2010","poison",-0.533298300238024,87,11,76,13.3947569861257,73.6052430138743
"2010","youre going",-0.533298300238024,87,11,76,13.3947569861257,73.6052430138743
"1970","color",-0.534223449732887,90,10,80,12.3163102658788,77.6836897341212
"2000","mind cause",-0.534666983927475,41,9,32,11.032513175711,29.9674868242891
"2000","think id",-0.534666983927475,41,9,32,11.032513175711,29.9674868242891
"2000","tied",-0.534666983927475,41,9,32,11.032513175711,29.9674868242891
"1990","come come come",-0.539097804641879,144,27,117,30.5488362138526,113.451163786147
"1990","laugh",-0.54004268973305,169,32,137,35.8524536120908,133.147546387909
"2010","take",-0.540926685211637,4302,645,3657,662.347638555319,3639.65236144468
"1990","mouth",-0.542119483327134,179,34,145,37.9739005713862,141.026099428614
"2010","california",-0.544529597842786,80,10,70,12.3170179182765,67.6829820817235
"2010","take chance",-0.544529597842786,80,10,70,12.3170179182765,67.6829820817235
"2010","youll find",-0.544529597842786,80,10,70,12.3170179182765,67.6829820817235
"1960","new",-0.545785190599844,1223,67,1156,73.0415633594848,1149.95843664052
"2000","itd",-0.550528460674694,37,8,29,9.9561704268611,27.0438295731389
"2000","love baby baby",-0.550528460674694,37,8,29,9.9561704268611,27.0438295731389
"2000","make real",-0.550528460674694,37,8,29,9.9561704268611,27.0438295731389
"2000","mold",-0.550528460674694,37,8,29,9.9561704268611,27.0438295731389
"2000","really care",-0.550528460674694,37,8,29,9.9561704268611,27.0438295731389
"2000","right front",-0.550528460674694,37,8,29,9.9561704268611,27.0438295731389
"1990","crystal",-0.550530501719332,42,7,35,8.91007722904033,33.0899227709597
"1990","got say",-0.550530501719332,42,7,35,8.91007722904033,33.0899227709597
"1990","growing",-0.550530501719332,42,7,35,8.91007722904033,33.0899227709597
"1990","learning",-0.550530501719332,42,7,35,8.91007722904033,33.0899227709597
"1990","please please",-0.550530501719332,42,7,35,8.91007722904033,33.0899227709597
"1990","stay away",-0.550530501719332,42,7,35,8.91007722904033,33.0899227709597
"1990","stomp",-0.550530501719332,42,7,35,8.91007722904033,33.0899227709597
"1990","want oh",-0.550530501719332,42,7,35,8.91007722904033,33.0899227709597
"1990","weekend",-0.550530501719332,42,7,35,8.91007722904033,33.0899227709597
"1970","dont matter",-0.551714774624644,74,8,66,10.1267439963892,63.8732560036107
"2010","rest",-0.553985578971418,241,33,208,37.105016478808,203.894983521192
"1970","right",-0.553993268882369,3946,524,3422,540.001781212864,3405.99821878714
"2010","mystery",-0.554327564640249,51,6,45,7.85209892290127,43.1479010770987
"1970","living",-0.554356600693058,517,65,452,70.7503600828816,446.249639917118
"1980","heavens",-0.554735509115287,60,8,52,10.0941436586147,49.9058563413853
"1990","brighter",-0.556621157328467,63,11,52,13.3651158435605,49.6348841564395
"2010","will always",-0.559274661894825,137,18,119,21.0928931850485,115.907106814951
"2010","now go",-0.559362231121057,73,9,64,11.2392788504273,61.7607211495727
"2010","tell want",-0.559362231121057,73,9,64,11.2392788504273,61.7607211495727
"2010","vision",-0.559362231121057,73,9,64,11.2392788504273,61.7607211495727
"1990","can see",-0.565248919333103,450,89,361,95.4651131682892,354.534886831711
"1990","want see",-0.56535204653036,99,18,81,21.0023248970236,77.9976751029764
"2000","shake shake shake shake",-0.56704680315479,180,44,136,48.4354236982432,131.564576301757
"2000","moving",-0.567427514722468,215,53,162,57.8534227506794,157.146577249321
"1970","bills",-0.56752110113611,66,7,59,9.03196086164446,56.9680391383555
"1970","girl just",-0.56752110113611,66,7,59,9.03196086164446,56.9680391383555
"1980","love girl",-0.569280655725314,151,22,129,25.4035948741803,125.59640512582
"1980","tried",-0.569922208276182,408,63,345,68.6401768785798,339.35982312142
"2000","can play",-0.572289105166326,33,7,26,8.87982767801125,24.1201723219887
"2000","cruisin",-0.572289105166326,33,7,26,8.87982767801125,24.1201723219887
"2000","deja",-0.572289105166326,33,7,26,8.87982767801125,24.1201723219887
"2000","heart know",-0.572289105166326,33,7,26,8.87982767801125,24.1201723219887
"2000","like rain",-0.572289105166326,33,7,26,8.87982767801125,24.1201723219887
"2000","makes happy",-0.572289105166326,33,7,26,8.87982767801125,24.1201723219887
"2000","sisters",-0.572289105166326,33,7,26,8.87982767801125,24.1201723219887
"2000","think dont",-0.572289105166326,33,7,26,8.87982767801125,24.1201723219887
"2000","turned around",-0.572289105166326,33,7,26,8.87982767801125,24.1201723219887
"2000","us cause",-0.572289105166326,33,7,26,8.87982767801125,24.1201723219887
"2000","wall",-0.573920200363617,184,45,139,49.5117664470931,134.488233552907
"2010","ways",-0.575182564698526,207,28,179,31.8702838635405,175.12971613646
"1990","bringing",-0.575663571878441,58,10,48,12.3043923639128,45.6956076360872
"1990","lets dance",-0.575663571878441,58,10,48,12.3043923639128,45.6956076360872
"1980","till",-0.57840285967956,692,109,583,116.419123529356,575.580876470644
"1980","nothing",-0.57863679623086,1236,198,1038,207.939359367462,1028.06064063254
"2010","lifes",-0.578817779442365,102,13,89,15.7041978458025,86.2958021541975
"2010","rap",-0.578817779442365,102,13,89,15.7041978458025,86.2958021541975
"2010","uh huh",-0.578837350773815,276,38,238,42.4937118180539,233.506288181946
"2010","emotion",-0.578999697293616,66,8,58,10.1615397825781,55.8384602174219
"2010","girl just",-0.578999697293616,66,8,58,10.1615397825781,55.8384602174219
"2010","slow motion",-0.578999697293616,66,8,58,10.1615397825781,55.8384602174219
"1990","brings",-0.58057961819063,89,16,73,18.8808779377283,70.1191220622717
"1990","flowers",-0.58057961819063,89,16,73,18.8808779377283,70.1191220622717
"1990","nothings",-0.58057961819063,89,16,73,18.8808779377283,70.1191220622717
"1970","somebodys",-0.581291199072655,115,13,102,15.7375075619563,99.2624924380437
"1970","stronger",-0.581291199072655,115,13,102,15.7375075619563,99.2624924380437
"2000","sugar",-0.582374382903904,254,63,191,68.3477645519654,185.652235448035
"1970","sitting",-0.583470569294562,107,12,95,14.6427244272115,92.3572755727885
"1970","walls",-0.583470569294562,107,12,95,14.6427244272115,92.3572755727885
"1980","promised",-0.583544935721271,67,9,58,11.2717937521197,55.7282062478803
"2000","years",-0.589190694895041,412,104,308,110.863303131534,301.136696868466
"1980","kiss",-0.589432111518928,809,128,681,136.102703663655,672.897296336345
"1990","always mind",-0.58956675922768,37,6,31,7.84935374939267,29.1506462506073
"1990","friday night",-0.58956675922768,37,6,31,7.84935374939267,29.1506462506073
"1990","hold arms",-0.58956675922768,37,6,31,7.84935374939267,29.1506462506073
"1990","know ill never",-0.58956675922768,37,6,31,7.84935374939267,29.1506462506073
"1990","let love let",-0.58956675922768,37,6,31,7.84935374939267,29.1506462506073
"1990","like fool",-0.58956675922768,37,6,31,7.84935374939267,29.1506462506073
"1990","make mind",-0.58956675922768,37,6,31,7.84935374939267,29.1506462506073
"1990","oughta",-0.58956675922768,37,6,31,7.84935374939267,29.1506462506073
"1990","pushing",-0.58956675922768,37,6,31,7.84935374939267,29.1506462506073
"1990","really care",-0.58956675922768,37,6,31,7.84935374939267,29.1506462506073
"1990","spend time",-0.58956675922768,37,6,31,7.84935374939267,29.1506462506073
"1990","theres many",-0.58956675922768,37,6,31,7.84935374939267,29.1506462506073
"1990","precious",-0.590417312580479,84,15,69,17.8201544580807,66.1798455419193
"1990","taught",-0.590417312580479,84,15,69,17.8201544580807,66.1798455419193
"1970","likes",-0.590786347294243,58,6,52,7.93717772689968,50.0628222731003
"1980","ill see",-0.593727041261162,47,6,41,7.90707919924816,39.0929208007518
"1980","pillow",-0.593727041261162,47,6,41,7.90707919924816,39.0929208007518
"1980","things want",-0.593727041261162,47,6,41,7.90707919924816,39.0929208007518
"1980","think know",-0.593727041261162,47,6,41,7.90707919924816,39.0929208007518
"1980","werent",-0.593727041261162,47,6,41,7.90707919924816,39.0929208007518
"1970","go away",-0.594364128874587,91,10,81,12.4531581577219,78.5468418422781
"1970","give",-0.594614724557992,3148,416,2732,430.797163522072,2717.20283647793
"1990","middle",-0.59662132231526,289,56,233,61.3098171236346,227.690182876365
"1990","turning",-0.598585155493149,165,31,134,35.0038748283727,129.996125171627
"1990","amazing",-0.599341168154287,53,9,44,11.2436688842652,41.7563311157348
"1990","moments",-0.599341168154287,53,9,44,11.2436688842652,41.7563311157348
"1990","thing thats",-0.599341168154287,53,9,44,11.2436688842652,41.7563311157348
"1980","break heart",-0.599578197981386,113,16,97,19.0106372237243,93.9893627762757
"1990","want love",-0.599615973534322,185,35,150,39.2467687469634,145.753231253037
"1980","oh night",-0.60123411529248,87,12,75,14.6365083049913,72.3634916950087
"1980","wanna rock",-0.60123411529248,87,12,75,14.6365083049913,72.3634916950087
"2000","yeah got",-0.601353990054623,78,18,60,20.9886836025721,57.0113163974279
"1970","can see",-0.601735710540991,450,56,394,61.5815513293941,388.418448670606
"2000","fell love",-0.602459547357999,74,17,57,19.9123408537222,54.0876591462778
"2000","meyou",-0.602459547357999,74,17,57,19.9123408537222,54.0876591462778
"2000","every moment",-0.602510430132767,29,6,23,7.80348492916141,21.1965150708386
"2000","ive always",-0.602510430132767,29,6,23,7.80348492916141,21.1965150708386
"2000","july",-0.602510430132767,29,6,23,7.80348492916141,21.1965150708386
"2000","make every",-0.602510430132767,29,6,23,7.80348492916141,21.1965150708386
"2000","sacrifice",-0.602510430132767,29,6,23,7.80348492916141,21.1965150708386
"2000","see oh",-0.602510430132767,29,6,23,7.80348492916141,21.1965150708386
"2000","shes just",-0.602510430132767,29,6,23,7.80348492916141,21.1965150708386
"2000","steel",-0.602510430132767,29,6,23,7.80348492916141,21.1965150708386
"2000","sticks",-0.602510430132767,29,6,23,7.80348492916141,21.1965150708386
"2000","sunset",-0.602510430132767,29,6,23,7.80348492916141,21.1965150708386
"2000","tell truth",-0.602510430132767,29,6,23,7.80348492916141,21.1965150708386
"2000","whatever want",-0.602510430132767,29,6,23,7.80348492916141,21.1965150708386
"2010","booty",-0.603361472564554,256,35,221,39.4144573384848,216.585542661515
"2000","without without",-0.604572272037559,70,16,54,18.8359981048724,51.1640018951276
"2010","hard find",-0.605250370711231,59,7,52,9.08380071472892,49.9161992852711
"2010","hiding",-0.605250370711231,59,7,52,9.08380071472892,49.9161992852711
"2010","innocent",-0.605250370711231,59,7,52,9.08380071472892,49.9161992852711
"2010","spit",-0.605250370711231,59,7,52,9.08380071472892,49.9161992852711
"2010","youre everything",-0.605250370711231,59,7,52,9.08380071472892,49.9161992852711
"1990","grow",-0.605481046267768,210,40,170,44.5503861452016,165.449613854798
"2000","secrets",-0.606550807431506,98,23,75,26.3703973468213,71.6296026531787
"1990","first time",-0.606599654700901,135,25,110,28.6395339504868,106.360466049513
"1960","funny",-0.607021266600108,192,9,183,11.4668684914318,180.533131508568
"2010","eye",-0.60797707306387,263,36,227,40.492196406334,222.507803593666
"1990","beach",-0.609532744939095,130,24,106,27.5788104708391,102.421189529161
"1990","holla",-0.609532744939095,130,24,106,27.5788104708391,102.421189529161
"2010","everybodys",-0.609761223752369,152,20,132,23.4023340447254,128.597665955275
"2010","rockin",-0.610046987974301,173,23,150,26.6355512482729,146.364448751727
"1960","hearts",-0.610404936376532,322,16,306,19.2308940325054,302.769105967495
"1960","pay",-0.610404936376532,322,16,306,19.2308940325054,302.769105967495
"2000","want dont",-0.612102196646776,106,25,81,28.523082844521,77.476917155479
"1990","dont make",-0.613071511683444,125,23,102,26.5180869911915,98.4819130088085
"1980","begun",-0.615170862347582,54,7,47,9.08472929275321,44.9152707072468
"1980","need little",-0.615170862347582,54,7,47,9.08472929275321,44.9152707072468
"1980","one youre",-0.615170862347582,54,7,47,9.08472929275321,44.9152707072468
"1980","shirt",-0.615170862347582,54,7,47,9.08472929275321,44.9152707072468
"1980","work hard",-0.615170862347582,54,7,47,9.08472929275321,44.9152707072468
"1990","make sure",-0.616096658887131,74,13,61,15.6987074987853,58.3012925012147
"1970","nobodys",-0.618845285943116,75,8,67,10.2635918882323,64.7364081117677
"1970","sweeter",-0.618845285943116,75,8,67,10.2635918882323,64.7364081117677
"2000","ceiling",-0.619092891701713,58,13,45,15.6069698583228,42.3930301416772
"2000","likes",-0.619092891701713,58,13,45,15.6069698583228,42.3930301416772
"1960","cold",-0.621469177778693,522,27,495,31.1755487110802,490.82445128892
"1980","family",-0.623882239304771,152,22,130,25.5718306018238,126.428169398176
"2010","know youre",-0.626977504192592,448,63,385,68.9753003423484,379.024699657652
"1970","lies",-0.627002563052203,289,35,254,39.5490407426553,249.450959257345
"2000","garden",-0.627700151339071,54,12,42,14.530627109473,39.469372890527
"2000","tell now",-0.627700151339071,54,12,42,14.530627109473,39.469372890527
"1990","love yeah",-0.628168940589251,110,20,90,23.3359165522485,86.6640834477515
"1990","blow mind",-0.629177716250663,48,8,40,10.1829454046175,37.8170545953825
"1990","rude",-0.629177716250663,48,8,40,10.1829454046175,37.8170545953825
"1990","suck",-0.629177716250663,48,8,40,10.1829454046175,37.8170545953825
"1960","two",-0.629313882924752,967,52,915,57.7524053709091,909.247594629091
"1970","black",-0.631104478465943,428,53,375,58.5708977088459,369.429102291154
"1980","know can",-0.631895288580131,241,36,205,40.5448103621023,200.455189637898
"1990","know cause",-0.632842163184901,69,12,57,14.6379840191377,54.3620159808623
"1990","tell ya",-0.632842163184901,69,12,57,14.6379840191377,54.3620159808623
"2010","love youre",-0.632867639720334,110,14,96,16.9358996376302,93.0641003623698
"1980","dont love",-0.633550162258325,94,13,81,15.8141583984963,78.1858416015037
"1980","faces",-0.633550162258325,94,13,81,15.8141583984963,78.1858416015037
"1970","baby cant",-0.634401022286465,124,14,110,16.9691385885441,107.030861411456
"1990","im tired",-0.635060383757312,105,19,86,22.2751930726008,82.7248069273992
"1970","motion",-0.63527705171546,148,17,131,20.2534879927785,127.746512007221
"2010","everyday",-0.636335238970762,243,33,210,37.4129419267649,205.587058073235
"2010","know dont",-0.636335238970762,243,33,210,37.4129419267649,205.587058073235
"2000","know know",-0.637652681342887,390,98,292,104.94341801286,285.05658198714
"2000","come lets",-0.638968414235874,50,11,39,13.4542843606231,36.5457156393769
"2000","misery",-0.638968414235874,50,11,39,13.4542843606231,36.5457156393769
"2000","anyone",-0.640556795732472,134,32,102,36.0574820864699,97.9425179135301
"2010","advice",-0.640963485431788,52,6,46,8.00606164687973,43.9939383531203
"2010","biggest",-0.640963485431788,52,6,46,8.00606164687973,43.9939383531203
"2010","life just",-0.640963485431788,52,6,46,8.00606164687973,43.9939383531203
"2010","wrapped",-0.640963485431788,52,6,46,8.00606164687973,43.9939383531203
"1970","bar",-0.644241085383948,172,20,152,23.5378373970128,148.462162602987
"1970","words",-0.645321322113984,612,77,535,83.7509098079759,528.249090192024
"1960","dont like",-0.645418603708634,136,6,130,8.12236518143086,127.877634818569
"2000","brown",-0.645432072073895,138,33,105,37.1338248353198,100.86617516468
"1970","pieces",-0.6476620845399,100,11,89,13.6847891843098,86.3152108156902
"1970","three",-0.648735621954392,367,45,322,50.2231763064169,316.776823693583
"1990","gonna let",-0.652538889485306,95,17,78,20.1537461133055,74.8462538866945
"1990","now now",-0.652538889485306,95,17,78,20.1537461133055,74.8462538866945
"1990","pulled",-0.6530397772027,64,11,53,13.57726053949,50.42273946051
"1990","wont tell",-0.6530397772027,64,11,53,13.57726053949,50.42273946051
"2010","guitar",-0.653435517411302,96,12,84,14.7804215019318,81.2195784980682
"2010","shouldnt",-0.653435517411302,96,12,84,14.7804215019318,81.2195784980682
"2000","every little thing",-0.653616416906147,46,10,36,12.3779416117733,33.6220583882267
"2000","never met",-0.653616416906147,46,10,36,12.3779416117733,33.6220583882267
"2000","tune",-0.653616416906147,46,10,36,12.3779416117733,33.6220583882267
"1970","live",-0.653685611324921,1210,156,1054,165.585949130148,1044.41405086985
"2000","put hands",-0.654824968030761,193,47,146,51.9335376320052,141.066462367995
"1960","wont",-0.656891228270506,2313,129,2184,138.139931357717,2174.86006864228
"2010","tell youre",-0.657027521593372,67,8,59,10.3155025065566,56.6844974934434
"2010","twist",-0.657027521593372,67,8,59,10.3155025065566,56.6844974934434
"2000","nothing",-0.657353728885976,1236,320,916,332.589909394603,903.410090605397
"1990","looks",-0.658715924053679,196,37,159,41.5803604021882,154.419639597812
"2010","que",-0.660328320658807,167,22,145,25.7117749044022,141.288225095598
"2010","whoa whoa",-0.660328320658807,167,22,145,25.7117749044022,141.288225095598
"1970","dead",-0.663750012525753,204,24,180,27.916969935992,176.083030064008
"1980","freedom",-0.664087392401507,114,16,98,19.1788729513679,94.8211270486321
"2010","drive",-0.664640006918404,340,47,293,52.3473261526751,287.652673847325
"1960","ah ah",-0.665445824226324,213,10,203,12.7210572326821,200.278942767318
"1960","know got",-0.665445824226324,213,10,203,12.7210572326821,200.278942767318
"2010","every day",-0.6656199179306,209,28,181,32.1782093114974,176.821790688503
"1980","feels good",-0.665749597250736,68,9,59,11.4400294797633,56.5599705202367
"1990","cant go",-0.666029150894545,231,44,187,49.0054247597218,181.994575240278
"1980","job",-0.666049093526953,101,14,87,16.9918084920014,84.0081915079986
"1990","black white",-0.66744941297948,43,7,36,9.12222192496986,33.8777780750301
"1990","boy dont",-0.66744941297948,43,7,36,9.12222192496986,33.8777780750301
"1990","boy know",-0.66744941297948,43,7,36,9.12222192496986,33.8777780750301
"1990","im real",-0.66744941297948,43,7,36,9.12222192496986,33.8777780750301
"1990","impossible",-0.66744941297948,43,7,36,9.12222192496986,33.8777780750301
"1990","maybe im",-0.66744941297948,43,7,36,9.12222192496986,33.8777780750301
"1990","real good",-0.66744941297948,43,7,36,9.12222192496986,33.8777780750301
"1990","thing dont",-0.66744941297948,43,7,36,9.12222192496986,33.8777780750301
"1990","yeah well",-0.66744941297948,43,7,36,9.12222192496986,33.8777780750301
"2010","else can",-0.667913809290319,89,11,78,13.7026824340826,75.2973175659174
"1970","baby need",-0.668681990507115,59,6,53,8.07402561874278,50.9259743812572
"1970","breathing",-0.668681990507115,59,6,53,8.07402561874278,50.9259743812572
"1970","cats",-0.668681990507115,59,6,53,8.07402561874278,50.9259743812572
"1970","hiding",-0.668681990507115,59,6,53,8.07402561874278,50.9259743812572
"1970","steps",-0.668681990507115,59,6,53,8.07402561874278,50.9259743812572
"1970","yeah dont",-0.668681990507115,59,6,53,8.07402561874278,50.9259743812572
"1980","write",-0.668953060043508,172,25,147,28.9365451546954,143.063454845305
"2010","aint gonna",-0.668983037757702,139,18,121,21.4008186330054,117.599181366995
"2010","ill",-0.670190087893879,4216,630,3586,649.106844293172,3566.89315570683
"1970","really dont",-0.670623938092543,84,9,75,11.4952229148202,72.5047770851798
"1970","broken",-0.670795264354441,329,40,289,45.0229564163792,283.977043583621
"2000","got say",-0.672647886026905,42,9,33,11.3015988629234,30.6984011370766
"2000","whether",-0.672647886026905,42,9,33,11.3015988629234,30.6984011370766
"2010","year",-0.673584965897227,132,17,115,20.3230795651562,111.676920434844
"1980","breakin",-0.674630515701774,88,12,76,14.8047440326349,73.1952559673651
"1980","whole life",-0.674630515701774,88,12,76,14.8047440326349,73.1952559673651
"2010","dont need",-0.675303475439433,395,55,340,60.8152759714902,334.18472402851
"1990","least",-0.676443827914461,85,15,70,18.0322991540102,66.9677008459898
"1990","spinning",-0.676443827914461,85,15,70,18.0322991540102,66.9677008459898
"1990","whoa whoa whoa",-0.676443827914461,85,15,70,18.0322991540102,66.9677008459898
"1990","foolish",-0.677608242594668,59,10,49,12.5165370598424,46.4834629401576
"1990","mister",-0.677608242594668,59,10,49,12.5165370598424,46.4834629401576
"1990","youre everything",-0.677608242594668,59,10,49,12.5165370598424,46.4834629401576
"2010","ago",-0.679500597114825,125,16,109,19.245340497307,105.754659502693
"1990","get enough",-0.685064611322622,126,23,103,26.730231687121,99.269768312879
"2010","chicks",-0.686189281149637,82,10,72,12.6249433662334,69.3750566337666
"2010","yeah oh yeah",-0.686189281149637,82,10,72,12.6249433662334,69.3750566337666
"2000","kids",-0.688344911946571,213,52,161,57.3152513762545,155.684748623746
"1970","im getting",-0.689160195075073,76,8,68,10.4004397800754,65.5995602199246
"1970","take back",-0.689160195075073,76,8,68,10.4004397800754,65.5995602199246
"2010","just give",-0.689301106701331,60,7,53,9.23776343870738,50.7622365612926
"2010","see want",-0.689301106701331,60,7,53,9.23776343870738,50.7622365612926
"1960","far",-0.69200497620059,616,32,584,36.7895364100103,579.21046358999
"1980","box",-0.692055430499141,48,6,42,8.07531492689174,39.9246850731083
"1980","doo doo doo doo",-0.692055430499141,48,6,42,8.07531492689174,39.9246850731083
"1980","kitchen",-0.692055430499141,48,6,42,8.07531492689174,39.9246850731083
"1980","shouldve",-0.69341938639414,75,10,65,12.6176795732683,62.3823204267317
"2010","broken heart",-0.696304208256253,111,14,97,17.0898623616086,93.9101376383913
"2000","freeze",-0.697508708199716,38,8,30,10.2252561140736,27.7747438859264
"2000","life aint",-0.697508708199716,38,8,30,10.2252561140736,27.7747438859264
"2000","nobody nobody",-0.697508708199716,38,8,30,10.2252561140736,27.7747438859264
"2000","please come",-0.697508708199716,38,8,30,10.2252561140736,27.7747438859264
"2000","treated",-0.697508708199716,38,8,30,10.2252561140736,27.7747438859264
"2000","well dont",-0.697508708199716,38,8,30,10.2252561140736,27.7747438859264
"1990","sense",-0.697826986050417,116,21,95,24.6087847278257,91.3912152721743
"1970","spend",-0.701188119642071,291,35,256,39.8227365263415,251.177263473658
"2000","need need",-0.701275613356507,95,22,73,25.5631402851839,69.4368597148161
"2000","plans",-0.701275613356507,95,22,73,25.5631402851839,69.4368597148161
"2000","girl let",-0.70261777229605,87,20,67,23.4104547874842,63.5895452125158
"1980","clouds",-0.705965728919048,95,13,82,15.9823941261399,79.0176058738601
"2000","climb",-0.707352316877328,79,18,61,21.2577692897845,57.7422307102155
"2000","come home",-0.707352316877328,79,18,61,21.2577692897845,57.7422307102155
"2000","storm",-0.707352316877328,79,18,61,21.2577692897845,57.7422307102155
"1990","day just",-0.707824930781994,54,9,45,11.4558135801947,42.5441864198053
"1990","girl make",-0.707824930781994,54,9,45,11.4558135801947,42.5441864198053
"1990","love yes",-0.707824930781994,54,9,45,11.4558135801947,42.5441864198053
"1990","want now",-0.707824930781994,54,9,45,11.4558135801947,42.5441864198053
"1980","cant let go",-0.708632411729734,55,7,48,9.25296502039679,45.7470349796032
"1980","got power",-0.708632411729734,55,7,48,9.25296502039679,45.7470349796032
"1980","way youre",-0.708632411729734,55,7,48,9.25296502039679,45.7470349796032
"2010","baby want",-0.709382321211402,75,9,66,11.5472042983842,63.4527957016158
"1970","hold hold",-0.710150423997277,101,11,90,13.8216370761529,87.1783629238471
"2010","five",-0.711101580382449,196,26,170,30.1766938997774,165.823306100223
"2000","staring",-0.711339091918402,75,17,58,20.1814265409347,54.8185734590653
"2000","sweeter",-0.711339091918402,75,17,58,20.1814265409347,54.8185734590653
"1960","forget",-0.71188868439636,491,25,466,29.3241272359011,461.675872764099
"1960","future",-0.712605093015763,138,6,132,8.2418117282166,129.758188271783
"1970","big",-0.712712494698135,964,123,841,131.921367736746,832.078632263254
"1970","changes",-0.714749586236137,68,7,61,9.30565664533066,58.6943433546693
"2000","anytime",-0.716655056255118,71,16,55,19.1050837920848,51.8949162079152
"2000","know oh",-0.716655056255118,71,16,55,19.1050837920848,51.8949162079152
"2000","written",-0.716655056255118,71,16,55,19.1050837920848,51.8949162079152
"2000","think can",-0.716832168466524,127,30,97,34.1738822759827,92.8261177240173
"1990","awayi",-0.717716917321029,38,6,32,8.0614984453222,29.9385015546778
"1990","dont stop dont",-0.717716917321029,38,6,32,8.0614984453222,29.9385015546778
"1990","need just",-0.717716917321029,38,6,32,8.0614984453222,29.9385015546778
"1990","person",-0.717716917321029,38,6,32,8.0614984453222,29.9385015546778
"1990","please let",-0.717716917321029,38,6,32,8.0614984453222,29.9385015546778
"1990","smart",-0.717716917321029,38,6,32,8.0614984453222,29.9385015546778
"1990","winning",-0.717716917321029,38,6,32,8.0614984453222,29.9385015546778
"1990","across",-0.718797072855837,192,36,156,40.7317816184701,151.26821838153
"1960","past",-0.720344505467109,215,10,205,12.8405037794679,202.159496220532
"1990","whip",-0.720496592143283,182,34,148,38.6103346591748,143.389665340825
"1970","hotel",-0.722723819029106,93,10,83,12.7268539414081,80.2731460585919
"1960","flow",-0.722758185075252,177,8,169,10.5710193905387,166.428980609461
"1990","mother",-0.723457945170878,172,32,140,36.4888876998794,135.511112300121
"2000","feel feel",-0.723544783830548,67,15,52,18.028741043235,48.971258956765
"1980","hurting",-0.729174345849819,62,8,54,10.4306151139018,51.5693848860982
"1980","pair",-0.729174345849819,62,8,54,10.4306151139018,51.5693848860982
"1980","sunlight",-0.729174345849819,62,8,54,10.4306151139018,51.5693848860982
"1980","trying get",-0.729174345849819,62,8,54,10.4306151139018,51.5693848860982
"2000","shake shake shake",-0.729991919144313,272,67,205,73.1913069217897,198.80869307821
"2000","come dont",-0.730361365715662,34,7,27,9.14891336522372,24.8510866347763
"2000","drums",-0.730361365715662,34,7,27,9.14891336522372,24.8510866347763
"2000","got little",-0.730361365715662,34,7,27,9.14891336522372,24.8510866347763
"2000","guess ill",-0.730361365715662,34,7,27,9.14891336522372,24.8510866347763
"2000","plastic",-0.730361365715662,34,7,27,9.14891336522372,24.8510866347763
"2000","thats true",-0.730361365715662,34,7,27,9.14891336522372,24.8510866347763
"2000","wrong dont",-0.730361365715662,34,7,27,9.14891336522372,24.8510866347763
"2010","barely",-0.732617182834916,53,6,47,8.16002437085818,44.8399756291418
"2010","calls",-0.732617182834916,53,6,47,8.16002437085818,44.8399756291418
"2010","decide",-0.732617182834916,53,6,47,8.16002437085818,44.8399756291418
"2010","feed",-0.732617182834916,53,6,47,8.16002437085818,44.8399756291418
"2010","hug",-0.732617182834916,53,6,47,8.16002437085818,44.8399756291418
"2010","like first",-0.732617182834916,53,6,47,8.16002437085818,44.8399756291418
"2010","make change",-0.732617182834916,53,6,47,8.16002437085818,44.8399756291418
"2010","tonight baby",-0.732617182834916,53,6,47,8.16002437085818,44.8399756291418
"1990","become",-0.737360918499218,96,17,79,20.365890809235,75.634109190765
"2010","changes",-0.739103419520307,68,8,60,10.469465230535,57.530534769465
"2010","pimpin",-0.739103419520307,68,8,60,10.469465230535,57.530534769465
"1970","dress",-0.739348678594863,150,17,133,20.5271837764647,129.472816223535
"1970","just take",-0.739711930137848,85,9,76,11.6320708066633,73.3679291933367
"1970","spinning",-0.739711930137848,85,9,76,11.6320708066633,73.3679291933367
"1970","love got",-0.740739033759911,142,16,126,19.4324006417199,122.56759935828
"2000","cup",-0.741052326994492,151,36,115,40.6319387690818,110.368061230918
"1970","yet",-0.741477581978697,174,20,154,23.811533180699,150.188466819301
"1990","woman",-0.742564905527722,796,159,637,168.867177959907,627.132822040093
"1990","love ooh",-0.745520349727739,49,8,41,10.3950901005471,38.604909899453
"1970","aah",-0.74678957635598,190,22,168,26.0010994501886,163.998900549811
"1960","aint gonna",-0.747191444325937,139,6,133,8.30153500160948,130.698464998391
"1970","explain",-0.74791282962609,126,14,112,17.2428343722303,108.75716562777
"1970","wondering",-0.74791282962609,126,14,112,17.2428343722303,108.75716562777
"1970","ridin",-0.750323994515884,198,23,175,27.0958825849334,170.904117415067
"1970","gray",-0.750415793793258,60,6,54,8.21087351058588,51.7891264894141
"1970","know get",-0.750415793793258,60,6,54,8.21087351058588,51.7891264894141
"1970","see want",-0.750415793793258,60,6,54,8.21087351058588,51.7891264894141
"1990","fly away",-0.751325188271542,91,16,75,19.3051673295874,71.6948326704126
"1980","get know",-0.752441362156942,69,9,60,11.6082652074069,57.3917347925931
"1960","say goodbye",-0.753684679388094,178,8,170,10.6307426639316,167.369257336068
"1970","quit",-0.754315061751856,118,13,105,16.1480512374856,101.851948762514
"1990","baby get",-0.755945213747205,65,11,54,13.7894052354196,51.2105947645804
"1990","doi",-0.755945213747205,65,11,54,13.7894052354196,51.2105947645804
"1990","im im",-0.755945213747205,65,11,54,13.7894052354196,51.2105947645804
"1990","know say",-0.755945213747205,65,11,54,13.7894052354196,51.2105947645804
"2000","id give",-0.757206909096254,55,12,43,14.7997127966854,40.2002872033146
"2000","im gonna love",-0.757206909096254,55,12,43,14.7997127966854,40.2002872033146
"2000","just got",-0.757206909096254,55,12,43,14.7997127966854,40.2002872033146
"2000","slam",-0.757206909096254,55,12,43,14.7997127966854,40.2002872033146
"2000","today",-0.759688553611639,377,94,283,101.445304079098,275.554695920902
"1990","guys",-0.760602309236016,127,23,104,26.9423763830505,100.057623616949
"2010","know theres",-0.762145925315882,83,10,73,12.7789060902119,70.2210939097881
"1970","know id",-0.762571380247983,77,8,69,10.5372876719185,66.4627123280815
"2010","close eyes",-0.762801064496879,218,29,189,33.5638738273035,184.436126172697
"1970","sleeping",-0.763163175080176,110,12,98,15.0532681027408,94.9467318972592
"1980","ends",-0.764042288624393,135,19,116,22.711823231883,112.288176768117
"1980","girl im",-0.767349307591727,148,21,127,24.8988876912495,123.10111230875
"2010","miles",-0.767658670259725,169,22,147,26.0197003523591,142.980299647641
"1980","baby got",-0.769527546063081,109,15,94,18.33769431315,90.66230568685
"1980","im never",-0.769527546063081,109,15,94,18.33769431315,90.66230568685
"2010","love love love love",-0.771002887102492,162,21,141,24.9419612845099,137.05803871549
"2000","got nothing",-0.77452044071565,51,11,40,13.7233700478356,37.2766299521644
"2000","spinnin",-0.77452044071565,51,11,40,13.7233700478356,37.2766299521644
"2000","dont wanna know",-0.774593684123349,30,6,24,8.07257061637387,21.9274293836261
"2000","ended",-0.774593684123349,30,6,24,8.07257061637387,21.9274293836261
"2000","eyed",-0.774593684123349,30,6,24,8.07257061637387,21.9274293836261
"2000","feel alone",-0.774593684123349,30,6,24,8.07257061637387,21.9274293836261
"2000","floating",-0.774593684123349,30,6,24,8.07257061637387,21.9274293836261
"2000","hella",-0.774593684123349,30,6,24,8.07257061637387,21.9274293836261
"2000","just much",-0.774593684123349,30,6,24,8.07257061637387,21.9274293836261
"2000","kiss lips",-0.774593684123349,30,6,24,8.07257061637387,21.9274293836261
"2000","love keeps",-0.774593684123349,30,6,24,8.07257061637387,21.9274293836261
"2000","make feel way",-0.774593684123349,30,6,24,8.07257061637387,21.9274293836261
"2000","staying",-0.774593684123349,30,6,24,8.07257061637387,21.9274293836261
"2000","take little",-0.774593684123349,30,6,24,8.07257061637387,21.9274293836261
"2000","thati",-0.774593684123349,30,6,24,8.07257061637387,21.9274293836261
"2000","youwhen",-0.774593684123349,30,6,24,8.07257061637387,21.9274293836261
"1980","class",-0.777661963974,76,10,66,12.7859153009119,63.2140846990881
"2010","although",-0.777755054336975,61,7,54,9.39172616268583,51.6082738373142
"2010","baby make",-0.777755054336975,61,7,54,9.39172616268583,51.6082738373142
"1990","kids",-0.778249436099893,213,40,173,45.1868202329902,167.81317976701
"1960","wind",-0.778490877624247,348,17,331,20.7836991407201,327.21630085928
"1990","shell",-0.779390917591121,203,38,165,43.0653732736949,159.934626726305
"1990","hang",-0.780350727389278,198,37,161,42.0046497940473,155.995350205953
"1970","wild",-0.780715447344036,479,59,420,65.5501401928439,413.449859807156
"1980","guitar",-0.781719123695279,96,13,83,16.1506298537835,79.8493701462165
"1980","number one",-0.781719123695279,96,13,83,16.1506298537835,79.8493701462165
"1990","cause dont",-0.783153927230096,188,35,153,39.8832028347519,148.116797165248
"1990","rollin",-0.785046546228147,183,34,149,38.8224793551043,144.177520644896
"1960","secret",-0.785139933270233,179,8,171,10.6904659373244,168.309534062676
"2010","dear",-0.787254184071528,141,18,123,21.7087440809623,119.291255919038
"2000","songs",-0.787541516912412,187,45,142,50.3190235087304,136.68097649127
"2010","youre",-0.788095103103721,6592,989,5603,1014.92227646598,5577.07772353402
"2010","married",-0.789900396747727,76,9,67,11.7011670223627,64.2988329776373
"1960","making",-0.790772156832756,367,18,349,21.9184413351847,345.081558664815
"1970","keeping",-0.790820486862129,94,10,84,12.8637018332512,81.1362981667488
"1990","angel",-0.792298087917294,288,55,233,61.0976724277051,226.902327572295
"1990","baddest",-0.793415205174192,44,7,37,9.33436662089939,34.6656333791006
"1990","cant read",-0.793415205174192,44,7,37,9.33436662089939,34.6656333791006
"1990","girl thats",-0.793415205174192,44,7,37,9.33436662089939,34.6656333791006
"1990","names",-0.793415205174192,44,7,37,9.33436662089939,34.6656333791006
"1990","pockets",-0.793415205174192,44,7,37,9.33436662089939,34.6656333791006
"1970","know will",-0.793480868858889,69,7,62,9.44250453717376,59.5574954628262
"1970","return",-0.793480868858889,69,7,62,9.44250453717376,59.5574954628262
"2010","later",-0.793942645152064,98,12,86,15.0883469498887,82.9116530501113
"1970","tellin",-0.793953165868833,151,17,134,20.6640316683078,130.335968331692
"1960","knew",-0.796018024947681,712,37,675,42.5229706557262,669.477029344274
"2000","endless",-0.796230390533983,47,10,37,12.6470272989857,34.3529727010143
"2000","life im",-0.796230390533983,47,10,37,12.6470272989857,34.3529727010143
"2000","listen heart",-0.796230390533983,47,10,37,12.6470272989857,34.3529727010143
"2000","sat",-0.796230390533983,47,10,37,12.6470272989857,34.3529727010143
"1980","love tell",-0.796337686258976,49,6,43,8.24355065453532,40.7564493454647
"1980","saying",-0.796555737961041,314,47,267,52.8260184800835,261.173981519917
"1970","proud",-0.796867243540878,143,16,127,19.569248533563,123.430751466437
"1960","shining",-0.797397547308815,160,7,153,9.55572374285983,150.44427625714
"1990","ladies",-0.798297341870152,303,58,245,64.2798428666481,238.720157133352
"1960","da da",-0.798807560959512,550,28,522,32.8478003660807,517.152199633919
"2000","choose",-0.803619784867065,120,28,92,32.2902824654955,87.7097175345045
"2000","make wanna",-0.804505732730603,96,22,74,25.8322259723964,70.1677740276036
"2000","spent",-0.805231671184266,124,29,95,33.3666252143453,90.6333747856547
"1970","moving",-0.805301356729846,215,25,190,29.4222967462661,185.577703253734
"1960","close eyes",-0.806085275528562,218,10,208,13.0196735996465,204.980326400354
"1960","turn around",-0.806085275528562,218,10,208,13.0196735996465,204.980326400354
"1960","know just",-0.806383454727119,237,11,226,14.1544157941111,222.845584205889
"2000","whatcha gonna",-0.807038407607437,92,21,71,24.7558832235465,67.2441167764535
"1980","girl can",-0.807398002248978,56,7,49,9.42120074804036,46.5787992519596
"1980","gotta go",-0.807398002248978,56,7,49,9.42120074804036,46.5787992519596
"1980","im right",-0.807398002248978,56,7,49,9.42120074804036,46.5787992519596
"1980","satisfy",-0.807398002248978,56,7,49,9.42120074804036,46.5787992519596
"1980","wearing",-0.807398002248978,56,7,49,9.42120074804036,46.5787992519596
"1990","flying",-0.808390146816328,76,13,63,16.1229968906444,59.8770031093556
"1990","like youre",-0.808390146816328,76,13,63,16.1229968906444,59.8770031093556
"1990","way can",-0.808390146816328,76,13,63,16.1229968906444,59.8770031093556
"1990","girl im",-0.810632982178939,148,27,121,31.3974149975707,116.602585002429
"1980","bang bang",-0.812307905780316,103,14,89,17.3282799472885,85.6717200527115
"1980","woh",-0.812307905780316,103,14,89,17.3282799472885,85.6717200527115
"1980","days",-0.816705877694961,682,106,576,114.73676625292,567.26323374708
"1960","go let",-0.81830206754325,141,6,135,8.42098154839523,132.579018451605
"2000","change",-0.82012986571857,823,210,613,221.457520575856,601.542479424143
"2000","hurts",-0.821701250136165,148,35,113,39.8246817074444,108.175318292556
"2000","bobby",-0.823620579838665,43,9,34,11.5706845501359,31.4293154498641
"2000","fly fly",-0.823620579838665,43,9,34,11.5706845501359,31.4293154498641
"2000","know girl",-0.823620579838665,43,9,34,11.5706845501359,31.4293154498641
"2000","maybe im",-0.823620579838665,43,9,34,11.5706845501359,31.4293154498641
"2000","one last",-0.823620579838665,43,9,34,11.5706845501359,31.4293154498641
"1980","wheels",-0.823648322338534,63,8,55,10.5988508415454,52.4011491584546
"2010","ive waiting",-0.825101369251753,69,8,61,10.6234279545135,58.3765720454865
"2010","worse",-0.825101369251753,69,8,61,10.6234279545135,58.3765720454865
"2000","waste",-0.825337611506626,152,36,116,40.9010244562943,111.098975543706
"1990","see face",-0.826666369221808,97,17,80,20.5780355051646,76.4219644948354
"1990","tha",-0.826666369221808,97,17,80,20.5780355051646,76.4219644948354
"1990","wave",-0.826666369221808,97,17,80,20.5780355051646,76.4219644948354
"1970","now can",-0.827572161936962,111,12,99,15.1901159945839,95.8098840054161
"1970","one two",-0.827572161936962,111,12,99,15.1901159945839,95.8098840054161
"2000","team",-0.828035646876788,76,17,59,20.4505122281471,55.5494877718529
"1980","people",-0.828890440530078,972,153,819,163.525127269558,808.474872730442
"2010","bunch",-0.829089194541031,54,6,48,8.31398709483664,45.6860129051634
"2010","one chance",-0.829089194541031,54,6,48,8.31398709483664,45.6860129051634
"1980","admit",-0.832103263672964,90,12,78,15.141215487922,74.858784512078
"1990","last time",-0.834334426521338,71,12,59,15.0622734109967,55.9377265890033
"1990","never meant",-0.834334426521338,71,12,59,15.0622734109967,55.9377265890033
"1960","give love",-0.835553271556363,219,10,209,13.0793968730394,205.920603126961
"1970","silence",-0.835853874578206,61,6,55,8.34772140242897,52.652278597571
"2000","dont know youre",-0.836933535118757,72,16,56,19.3741694792973,52.6258305207027
"2000","stuff",-0.837397717184311,164,39,125,44.1300527028438,119.869947297156
"1990","just want",-0.838004714867568,244,46,198,51.7633058068057,192.236694193194
"1970","can find",-0.838994331274123,78,8,70,10.6741355637616,67.3258644362384
"1970","fears",-0.838994331274123,78,8,70,10.6741355637616,67.3258644362384
"1970","just feel",-0.838994331274123,78,8,70,10.6741355637616,67.3258644362384
"1970","law",-0.838994331274123,78,8,70,10.6741355637616,67.3258644362384
"1970","now ive",-0.838994331274123,78,8,70,10.6741355637616,67.3258644362384
"1970","now tell",-0.838994331274123,78,8,70,10.6741355637616,67.3258644362384
"2010","sand",-0.841403718137252,84,10,74,12.9328688141903,71.0671311858097
"1980","difference",-0.84348148176066,70,9,61,11.7765009350505,58.2234990649496
"1970","told",-0.849244227972481,780,98,682,106.741355637616,673.258644362384
"1990","swear",-0.849293795709817,299,57,242,63.43126408293,235.56873591707
"1960","sayin",-0.849612706492428,181,8,173,10.8099124841102,170.19008751589
"1970","look eyes",-0.850238034886338,152,17,135,20.8008795601509,131.199120439849
"1960","saying",-0.854444741323833,314,15,299,18.7531078453624,295.246892154638
"1960","brand new",-0.854807651328314,142,6,136,8.4807048217881,133.519295178212
"1960","starts",-0.854807651328314,142,6,136,8.4807048217881,133.519295178212
"1990","cause never",-0.855739596541759,39,6,33,8.27364314125173,30.7263568587483
"1990","might well",-0.855739596541759,39,6,33,8.27364314125173,30.7263568587483
"1990","nervous",-0.855739596541759,39,6,33,8.27364314125173,30.7263568587483
"1990","now let",-0.855739596541759,39,6,33,8.27364314125173,30.7263568587483
"1990","wanna just",-0.855739596541759,39,6,33,8.27364314125173,30.7263568587483
"2000","arms",-0.85671220601278,556,140,416,149.611642090129,406.388357909871
"2000","alone im",-0.858530318186274,39,8,31,10.494341801286,28.505658198714
"2000","bother",-0.858530318186274,39,8,31,10.494341801286,28.505658198714
"2000","broadway",-0.858530318186274,39,8,31,10.494341801286,28.505658198714
"2000","heal",-0.858530318186274,39,8,31,10.494341801286,28.505658198714
"2000","know hes",-0.858530318186274,39,8,31,10.494341801286,28.505658198714
"2000","loves loves",-0.858530318186274,39,8,31,10.494341801286,28.505658198714
"2000","now let",-0.858530318186274,39,8,31,10.494341801286,28.505658198714
"2000","rock rock rock",-0.858530318186274,39,8,31,10.494341801286,28.505658198714
"2000","someone like",-0.858530318186274,39,8,31,10.494341801286,28.505658198714
"1990","get",-0.859564511913149,8265,1719,6546,1753.37591185758,6511.62408814242
"2000","realize",-0.860576096098525,184,44,140,49.5117664470931,134.488233552907
"2000","im thinking",-0.861087117041152,64,14,50,17.2214839815976,46.7785160184024
"2000","minds",-0.861087117041152,64,14,50,17.2214839815976,46.7785160184024
"1970","let hear",-0.861450243843843,95,10,85,13.0005497250943,81.9994502749057
"1970","shoot",-0.861450243843843,95,10,85,13.0005497250943,81.9994502749057
"1990","starting",-0.863495357817658,87,15,72,18.4565885458693,68.5434114541307
"2010","number",-0.863754668708147,241,32,209,37.105016478808,203.894983521192
"1990","danger",-0.865119359844662,66,11,55,14.0015499313491,51.9984500686509
"1990","sees",-0.865119359844662,66,11,55,14.0015499313491,51.9984500686509
"1990","way dont",-0.865119359844662,66,11,55,14.0015499313491,51.9984500686509
"1960","take home",-0.865912333861144,162,7,155,9.67517028964558,152.324829710354
"1960","trouble",-0.865912333861144,162,7,155,9.67517028964558,152.324829710354
"1980","cryin",-0.866372334858693,130,18,112,21.8706445936651,108.129355406335
"1960","bright",-0.867780324149571,277,13,264,16.5433467298261,260.456653270174
"2010","golden",-0.868499545940425,99,12,87,15.2423096738672,83.7576903261328
"1990","didnt",-0.8686958124466,868,173,695,184.141596066833,683.858403933167
"1970","let love",-0.86924667889328,248,29,219,33.9382771770883,214.061722822912
"2010","funny",-0.86982048743323,192,25,167,29.5608430038636,162.439156996136
"1990","mine mine",-0.869829148326887,50,8,42,10.6072347964766,39.3927652035234
"2010","mile",-0.870459802230561,62,7,55,9.54568888666429,52.4543111133357
"2010","now see",-0.870459802230561,62,7,55,9.54568888666429,52.4543111133357
"1980","hot",-0.870755771989455,949,149,800,159.655705533755,789.344294466244
"2010","wings",-0.871247356548452,128,16,112,19.7072286692424,108.292771330758
"2000","everyday",-0.872442790602046,243,59,184,65.3878219926283,177.612178007372
"2010","ever seen",-0.873953778074596,77,9,68,11.8551297463411,65.1448702536589
"2010","roses",-0.873953778074596,77,9,68,11.8551297463411,65.1448702536589
"1970","faded",-0.875485092758828,70,7,63,9.57935242901686,60.4206475709831
"1970","night im",-0.875485092758828,70,7,63,9.57935242901686,60.4206475709831
"2000","love just cant",-0.877221310938828,60,13,47,16.1451412327477,43.8548587672523
"1980","mean",-0.883400326170236,746,116,630,125.503852822109,620.496147177891
"1990","smiling",-0.886277353772821,82,14,68,17.3958650662216,64.6041349337784
"1980","editor",-0.890051716406885,104,14,90,17.4965156749321,86.5034843250679
"1980","within",-0.890051716406885,104,14,90,17.4965156749321,86.5034843250679
"1980","sand",-0.890219235532685,84,11,73,14.1318011220605,69.8681988779394
"1960","carry",-0.895796094084983,221,10,211,13.1988434198251,207.801156580175
"2000","meaning byamandah",-0.896863848035871,56,12,44,15.0687984838979,40.9312015161021
"2000","meaning byamandah editor",-0.896863848035871,56,12,44,15.0687984838979,40.9312015161021
"2000","time got",-0.896863848035871,56,12,44,15.0687984838979,40.9312015161021
"2010","front",-0.898631578253553,339,46,293,52.1933634286967,286.806636571303
"2000","give give",-0.901787063923836,125,29,96,33.6357109015578,91.3642890984422
"2000","ive seen",-0.902980805909182,113,26,87,30.4066826550082,82.5933173449918
"2000","buzz",-0.903692631477241,35,7,28,9.41799905243618,25.5820009475638
"2000","day dont",-0.903692631477241,35,7,28,9.41799905243618,25.5820009475638
"2000","dizzy",-0.903692631477241,35,7,28,9.41799905243618,25.5820009475638
"2000","dream come",-0.903692631477241,35,7,28,9.41799905243618,25.5820009475638
"2000","eyes know",-0.903692631477241,35,7,28,9.41799905243618,25.5820009475638
"2000","gang",-0.903692631477241,35,7,28,9.41799905243618,25.5820009475638
"2000","just long",-0.903692631477241,35,7,28,9.41799905243618,25.5820009475638
"2000","lake",-0.903692631477241,35,7,28,9.41799905243618,25.5820009475638
"2000","now like",-0.903692631477241,35,7,28,9.41799905243618,25.5820009475638
"2000","sing along",-0.903692631477241,35,7,28,9.41799905243618,25.5820009475638
"2000","time make",-0.903692631477241,35,7,28,9.41799905243618,25.5820009475638
"2000","want dont want",-0.903692631477241,35,7,28,9.41799905243618,25.5820009475638
"2000","just keep",-0.904823400390809,137,32,105,36.8647391481073,100.135260851893
"1980","baby cant",-0.906154669004937,124,17,107,20.8612302278037,103.138769772196
"1980","day life",-0.906316603046701,50,6,44,8.4117863821789,41.5882136178211
"1980","knowin",-0.906316603046701,50,6,44,8.4117863821789,41.5882136178211
"1980","lyrics",-0.906316603046701,50,6,44,8.4117863821789,41.5882136178211
"2000","go ahead",-0.909946429690714,101,23,78,27.1776544084587,73.8223455915413
"2000","hanging",-0.911052408067306,149,35,114,40.0937673946569,108.906232605343
"1980","baby give",-0.911266569020462,57,7,50,9.58943647568394,47.4105635243161
"1970","let go let go",-0.911938961523948,104,11,93,14.2321807516822,89.7678192483178
"1990","thing",-0.913678485165292,1697,344,1353,360.009548992415,1336.99045100758
"2000","yes im",-0.913929991672257,97,22,75,26.1013116596088,70.8986883403912
"1990","scared",-0.914299117408643,195,36,159,41.3682157062587,153.631784293741
"1970","cant believe",-0.914383954030333,145,16,129,19.8429443172492,125.157055682751
"2010","turned",-0.914650524449133,256,34,222,39.4144573384848,216.585542661515
"2010","come let",-0.914901150921485,70,8,62,10.7773906784919,59.2226093215081
"1980","beg",-0.916009872867329,91,12,79,15.3094512155656,75.6905487844344
"1980","fly away",-0.916009872867329,91,12,79,15.3094512155656,75.6905487844344
"1970","ghetto",-0.918347954664224,79,8,71,10.8109834556047,68.1890165443953
"1970","waited",-0.918347954664224,79,8,71,10.8109834556047,68.1890165443953
"2000","now time",-0.920859477310676,52,11,41,13.992455735048,38.007544264952
"2000","raised",-0.920859477310676,52,11,41,13.992455735048,38.007544264952
"2000","treat right",-0.920859477310676,52,11,41,13.992455735048,38.007544264952
"1970","feel good",-0.922525716585931,137,15,122,18.7481611825044,118.251838817496
"1980","cant find",-0.922740573998857,64,8,56,10.767086569189,53.232913430811
"1980","didnt want",-0.922740573998857,64,8,56,10.767086569189,53.232913430811
"2010","birds",-0.923879274400385,85,10,75,13.0868315381688,71.9131684618312
"1970","sit",-0.924481314316273,265,31,234,36.264691338421,228.735308661579
"1970","now see",-0.924869241542382,62,6,56,8.48456929427207,53.5154307057279
"1970","open door",-0.924869241542382,62,6,56,8.48456929427207,53.5154307057279
"1970","tip",-0.924869241542382,62,6,56,8.48456929427207,53.5154307057279
"2000","lights",-0.925047622528602,465,116,349,125.124844553795,339.875155446205
"2000","nothings",-0.925079422992914,89,20,69,23.9486261619091,65.0513738380909
"1990","apple",-0.927983174707744,45,7,38,9.54651131682892,35.4534886831711
"1990","love still",-0.927983174707744,45,7,38,9.54651131682892,35.4534886831711
"1990","shades",-0.927983174707744,45,7,38,9.54651131682892,35.4534886831711
"1990","shit make",-0.927983174707744,45,7,38,9.54651131682892,35.4534886831711
"1990","stop now",-0.927983174707744,45,7,38,9.54651131682892,35.4534886831711
"1990","thank god",-0.927983174707744,45,7,38,9.54651131682892,35.4534886831711
"1990","whose",-0.927983174707744,45,7,38,9.54651131682892,35.4534886831711
"1980","shame",-0.929672805130075,157,22,135,26.4130092400417,130.586990759958
"1960","right now",-0.930006565259491,502,25,477,29.9810832432227,472.018916756777
"2010","eyes see",-0.930191733305566,55,6,49,8.4679498188151,46.5320501811849
"2010","girl cause",-0.930191733305566,55,6,49,8.4679498188151,46.5320501811849
"1980","last night",-0.931593417772723,144,20,124,24.2259447806752,119.774055219325
"2000","killing",-0.932553118999623,85,19,66,22.8722834130593,62.1277165869407
"1980","dont stop",-0.933937752338261,317,47,270,53.3307256630142,263.669274336986
"2000","blow",-0.934086453768012,318,78,240,85.569248533563,232.430751466437
"1970","number one",-0.934556935018234,96,10,86,13.1373976169374,82.8626023830626
"1980","now youre",-0.935254624692252,183,26,157,30.7871381587748,152.212861841225
"1970","hear",-0.935310205720953,1398,179,1219,191.313352796651,1206.68664720335
"1980","yesterday",-0.937943043096551,131,18,113,22.0388803213087,108.961119678691
"1980","last time",-0.938737554851803,71,9,62,11.944736662694,59.055263337306
"1980","test",-0.938737554851803,71,9,62,11.944736662694,59.055263337306
"1980","written",-0.938737554851803,71,9,62,11.944736662694,59.055263337306
"1980","yeah thats",-0.938737554851803,71,9,62,11.944736662694,59.055263337306
"2000","bite",-0.941550227008607,81,18,63,21.7959406642094,59.2040593357906
"2000","just go",-0.941550227008607,81,18,63,21.7959406642094,59.2040593357906
"2000","every night",-0.942608463807151,185,44,141,49.7808521343055,135.219147865694
"1980","want get",-0.942943594406849,98,13,85,16.4871013090706,81.5128986909294
"2010","everything",-0.943570799314799,1269,183,1086,195.378696728661,1073.62130327134
"1990","louder",-0.943766574375966,72,12,60,15.2744181069263,56.7255818930737
"2010","took",-0.945424865615225,553,77,476,85.1413863600863,467.858613639914
"1970","im gonna",-0.94587834210769,1035,131,904,141.637568057606,893.362431942394
"1970","better",-0.945987022013039,1655,213,1442,226.483261000327,1428.51673899967
"1970","let go let",-0.946232016928915,121,13,108,16.5585949130148,104.441405086985
"1990","drug",-0.946726399848893,56,9,47,11.8801029720538,44.1198970279462
"1990","drum",-0.946726399848893,56,9,47,11.8801029720538,44.1198970279462
"1990","heart can",-0.946726399848893,56,9,47,11.8801029720538,44.1198970279462
"1990","just just",-0.946726399848893,56,9,47,11.8801029720538,44.1198970279462
"1990","now ill",-0.946726399848893,56,9,47,11.8801029720538,44.1198970279462
"1990","trick",-0.946726399848893,56,9,47,11.8801029720538,44.1198970279462
"1990","places",-0.947021359080246,119,21,98,25.2452188156143,93.7547811843857
"1990","sound",-0.948233993462768,405,78,327,85.9186018514603,319.08139814854
"1960","say love",-0.95014012402094,184,8,176,10.9890823042888,173.010917695711
"1960","wanna go",-0.95014012402094,184,8,176,10.9890823042888,173.010917695711
"2000","box",-0.950348598198572,48,10,38,12.9161129861982,35.0838870138018
"2000","situation",-0.950348598198572,48,10,38,12.9161129861982,35.0838870138018
"2000","youbaby",-0.950348598198572,48,10,38,12.9161129861982,35.0838870138018
"2000","youre like",-0.950348598198572,48,10,38,12.9161129861982,35.0838870138018
"1960","night long",-0.952004053285964,242,11,231,14.4530321610755,227.546967838925
"1970","calling",-0.952057661823085,218,25,193,29.8328404217953,188.167159578205
"2000","lied",-0.952315581252888,77,17,60,20.7195979153596,56.2804020846404
"2010","fantasy",-0.95614222673022,122,15,107,18.7834523253717,103.216547674628
"1980","know never",-0.957999499582965,78,10,68,13.1223867561991,64.8776132438009
"1980","law",-0.957999499582965,78,10,68,13.1223867561991,64.8776132438009
"1980","one im",-0.957999499582965,78,10,68,13.1223867561991,64.8776132438009
"1980","youre feeling",-0.957999499582965,78,10,68,13.1223867561991,64.8776132438009
"1970","cant",-0.960624729406774,5338,706,4632,730.494046658457,4607.50595334154
"1970","seeing",-0.960664281153823,71,7,64,9.71620032085995,61.2837996791401
"2010","filled",-0.961445228147744,78,9,69,12.0090924703196,65.9909075296804
"2010","know never",-0.961445228147744,78,9,69,12.0090924703196,65.9909075296804
"2010","pimp",-0.961445228147744,78,9,69,12.0090924703196,65.9909075296804
"2000","burnin burnin",-0.963355383026165,31,6,25,8.34165630358633,22.6583436964137
"2000","cant give",-0.963355383026165,31,6,25,8.34165630358633,22.6583436964137
"2000","cause wanna",-0.963355383026165,31,6,25,8.34165630358633,22.6583436964137
"2000","chair",-0.963355383026165,31,6,25,8.34165630358633,22.6583436964137
"2000","credit",-0.963355383026165,31,6,25,8.34165630358633,22.6583436964137
"2000","days go",-0.963355383026165,31,6,25,8.34165630358633,22.6583436964137
"2000","feels right",-0.963355383026165,31,6,25,8.34165630358633,22.6583436964137
"2000","mind cant",-0.963355383026165,31,6,25,8.34165630358633,22.6583436964137
"2000","now feel",-0.963355383026165,31,6,25,8.34165630358633,22.6583436964137
"2000","now hey",-0.963355383026165,31,6,25,8.34165630358633,22.6583436964137
"2000","rains",-0.963355383026165,31,6,25,8.34165630358633,22.6583436964137
"2000","though know",-0.963355383026165,31,6,25,8.34165630358633,22.6583436964137
"2000","wont see",-0.963355383026165,31,6,25,8.34165630358633,22.6583436964137
"2000","youwell",-0.963355383026165,31,6,25,8.34165630358633,22.6583436964137
"1970","ran",-0.963425241534276,88,9,79,12.0426144821926,75.9573855178074
"1990","oh yeah oh",-0.964267585426619,88,15,73,18.6687332417988,69.3312667582012
"1990","ran",-0.964267585426619,88,15,73,18.6687332417988,69.3312667582012
"1990","sister",-0.964267585426619,88,15,73,18.6687332417988,69.3312667582012
"1980","now baby",-0.964346010432721,151,21,130,25.4035948741803,125.59640512582
"1980","streets",-0.964607625056839,177,25,152,29.7777237929133,147.222276207087
"2000","dreamed",-0.965149527111567,73,16,57,19.6432551665097,53.3567448334902
"2000","like one",-0.965149527111567,73,16,57,19.6432551665097,53.3567448334902
"2000","sin",-0.965149527111567,73,16,57,19.6432551665097,53.3567448334902
"2010","last forever",-0.967270726964538,63,7,56,9.69965161064275,53.3003483893573
"2010","resist",-0.967270726964538,63,7,56,9.69965161064275,53.3003483893573
"2010","state",-0.967270726964538,63,7,56,9.69965161064275,53.3003483893573
"2010","yeah now",-0.967270726964538,63,7,56,9.69965161064275,53.3003483893573
"1970","clap",-0.967755720580102,154,17,137,21.0745753438371,132.925424656163
"1980","heres",-0.969919616280136,138,19,119,23.2165304148138,114.783469585186
"2000","everybody",-0.970444615902068,1033,264,769,277.965514890474,755.034485109526
"1960","ahead",-0.972849095725489,165,7,158,9.8543401098242,155.145659890176
"1980","love im",-0.973014105851824,267,39,228,44.9189392808353,222.081060719165
"1990","clothes",-0.973385019172312,211,39,172,44.7625308411312,166.237469158869
"1990","baby youre",-0.973852514047309,145,26,119,30.7609809097821,114.239019090218
"1970","change",-0.977033329372127,823,103,720,112.62581498687,710.37418501313
"2010","baby girl",-0.979015823691801,201,26,175,30.9465075196697,170.05349248033
"1960","mad",-0.97903096397908,262,12,250,15.647497628933,246.352502371067
"1980","ease",-0.979695634007885,85,11,74,14.3000368497041,70.6999631502959
"1980","ill always",-0.979695634007885,85,11,74,14.3000368497041,70.6999631502959
"1970","tired",-0.97972535229577,282,33,249,38.5911054997536,243.408894500246
"2010","beside",-0.980153276116949,144,18,126,22.1706322528977,121.829367747102
"2010","kind",-0.980220430203611,554,77,477,85.2953490840648,468.704650915935
"2000","news",-0.980424625359221,69,15,54,18.5669124176599,50.4330875823401
"1960","lives",-0.984644836922995,185,8,177,11.0488055776817,173.951194422318
"2000","carry",-0.986058546236768,221,53,168,59.4679368739542,161.532063126046
"2000","arms around",-0.986909465581952,44,9,35,11.8397702373483,32.1602297626517
"2000","now need",-0.986909465581952,44,9,35,11.8397702373483,32.1602297626517
"2000","wont go",-0.986909465581952,44,9,35,11.8397702373483,32.1602297626517
"1960","gonna",-0.987787203150255,4550,256,4294,271.740893937576,4278.25910606242
"1990","fill",-0.988597734816544,191,35,156,40.5196369225405,150.480363077459
"1960","clear",-0.989367378534613,224,10,214,13.3780132400038,210.621986759996
"1990","away dont",-0.991224401869005,83,14,69,17.6080097621511,65.3919902378489
"1990","bell",-0.991224401869005,83,14,69,17.6080097621511,65.3919902378489
"2010","war",-0.994066184490506,137,17,120,21.0928931850485,115.907106814951
"2000","tight",-0.997933296873597,354,87,267,95.2563332732116,258.743666726788
"1980","fear",-0.998087731298682,184,26,158,30.9553738864183,153.044626113582
"2010","uh oh",-0.99856452864899,108,13,95,16.6279741896733,91.3720258103267
"2000","just need",-0.998608786256857,65,14,51,17.49056966881,47.50943033119
"1970","though",-0.999782727012047,532,65,467,72.8030784605281,459.196921539472
"1970","twenty",-1.00055439172437,80,8,72,10.9478313474478,69.0521686525522
"1990","livin life",-1.00175882762631,51,8,43,10.8193794924061,40.1806205075939
"1990","shower",-1.00175882762631,51,8,43,10.8193794924061,40.1806205075939
"2000","rich",-1.00185062992648,134,31,103,36.0574820864699,97.9425179135301
"2000","twice",-1.00185062992648,134,31,103,36.0574820864699,97.9425179135301
"2000","crowd",-1.00225665009098,130,30,100,34.9811393376201,95.0188606623799
"1990","coke",-1.00308994317318,40,6,34,8.48578783718126,31.5142121628187
"1990","ears",-1.00308994317318,40,6,34,8.48578783718126,31.5142121628187
"1990","fall apart",-1.00308994317318,40,6,34,8.48578783718126,31.5142121628187
"1990","give im",-1.00308994317318,40,6,34,8.48578783718126,31.5142121628187
"1990","like can",-1.00308994317318,40,6,34,8.48578783718126,31.5142121628187
"1990","minutes",-1.00308994317318,40,6,34,8.48578783718126,31.5142121628187
"1990","see dreams",-1.00308994317318,40,6,34,8.48578783718126,31.5142121628187
"1990","southern",-1.00308994317318,40,6,34,8.48578783718126,31.5142121628187
"1990","wrong right",-1.00308994317318,40,6,34,8.48578783718126,31.5142121628187
"1980","cha",-1.00325514954259,92,12,80,15.4776869432092,76.5223130567908
"1980","nobody else",-1.00325514954259,92,12,80,15.4776869432092,76.5223130567908
"1960","kill",-1.00695633792919,146,6,140,8.71959791535959,137.28040208464
"2000","ill make",-1.00797645010027,158,37,121,42.515538579569,115.484461420431
"2010","apart",-1.01578251393183,279,37,242,42.9555999899893,236.044400010011
"2000","black",-1.01623999885162,428,106,322,115.168674126934,312.831325873066
"1980","shot",-1.01661256426344,223,32,191,37.5165672645179,185.483432735482
"1970","cant say",-1.01734132924929,63,6,57,8.62141718611517,54.3785828138848
"1970","ghost",-1.01734132924929,63,6,57,8.62141718611517,54.3785828138848
"1970","now want",-1.01734132924929,63,6,57,8.62141718611517,54.3785828138848
"1990","aint nothin",-1.01832419679099,99,17,82,21.0023248970236,77.9976751029764
"1990","picture",-1.01913446605599,166,30,136,35.2160195243022,130.783980475698
"1960","theres nothing",-1.01963818150861,186,8,178,11.1085288510746,174.891471148925
"1990","wanna see",-1.01982302494016,262,49,213,55.5819103335373,206.418089666463
"1980","kissing",-1.02004828344148,58,7,51,9.75767220332752,48.2423277966725
"1980","see see",-1.02004828344148,58,7,51,9.75767220332752,48.2423277966725
"1980","younger",-1.02004828344148,58,7,51,9.75767220332752,48.2423277966725
"2000","john",-1.02029792540287,61,13,48,16.4142269199602,44.5857730800398
"2000","kid",-1.02122772952392,178,42,136,47.8972523238183,130.102747676182
"1960","buy",-1.02139739721555,225,10,215,13.4377365133966,211.562263486603
"1980","like man",-1.02175131210215,51,6,45,8.58002210982247,42.4199778901775
"1980","september",-1.02175131210215,51,6,45,8.58002210982247,42.4199778901775
"1980","table",-1.02175131210215,51,6,45,8.58002210982247,42.4199778901775
"1990","chase",-1.02241378890733,78,13,65,16.5472862825035,61.4527137174965
"1990","now tell",-1.02241378890733,78,13,65,16.5472862825035,61.4527137174965
"1990","suddenly",-1.02241378890733,78,13,65,16.5472862825035,61.4527137174965
"1990","time come",-1.02241378890733,78,13,65,16.5472862825035,61.4527137174965
"1990","trying get",-1.02396537707316,62,10,52,13.152971147631,48.847028852369
"2000","kiss",-1.02501965471167,809,205,604,217.690320954882,591.309679045118
"1980","wrap",-1.02629773800631,65,8,57,10.9353222968326,54.0646777031674
"2010","paradise",-1.0292839217245,123,15,108,18.9374150493501,104.06258495065
"1960","know im",-1.03058530859327,580,29,551,34.6394985678669,545.360501432133
"2000","affection",-1.03279157883113,40,8,32,10.7634274884985,29.2365725115015
"2000","em back",-1.03279157883113,40,8,32,10.7634274884985,29.2365725115015
"2000","undercover",-1.03279157883113,40,8,32,10.7634274884985,29.2365725115015
"2000","wanna play",-1.03279157883113,40,8,32,10.7634274884985,29.2365725115015
"1970","price",-1.03374029261256,114,12,102,15.6006596701132,98.3993403298868
"2010","look eyes",-1.03460623590129,152,19,133,23.4023340447254,128.597665955275
"2010","nose",-1.03574779222466,56,6,50,8.62191254279355,47.3780874572064
"2010","can get",-1.03656481091982,356,48,308,54.8107297363304,301.18927026367
"1970","gettin",-1.03693750065682,440,53,387,60.2130724109631,379.786927589037
"1980","clock",-1.03808314574869,72,9,63,12.1129723903376,59.8870276096624
"1980","dont know youre",-1.03808314574869,72,9,63,12.1129723903376,59.8870276096624
"1980","searchin",-1.03808314574869,72,9,63,12.1129723903376,59.8870276096624
"1990","everyone",-1.03890086875008,217,40,177,46.0353990167084,170.964600983292
"1960","girls",-1.03913577894878,942,49,893,56.2593235360873,885.740676463913
"1990","smell",-1.04234122227514,94,16,78,19.941601417376,74.058398582624
"1970","rhyme",-1.04326033205609,89,9,80,12.1794623740357,76.8205376259643
"2010","left",-1.04396716634051,889,126,763,136.872861616848,752.127138383152
"1970","wanted",-1.04517062729884,448,54,394,61.3078555457079,386.692144454292
"1990","ill take",-1.04611651545555,151,27,124,32.0338490853593,118.966150914641
"2000","didnt mean",-1.04626306229957,57,12,45,15.3378841711103,41.6621158288897
"2000","groovin",-1.04626306229957,57,12,45,15.3378841711103,41.6621158288897
"2000","love wanna",-1.04626306229957,57,12,45,15.3378841711103,41.6621158288897
"2000","signs",-1.04626306229957,57,12,45,15.3378841711103,41.6621158288897
"2000","youoh",-1.04626306229957,57,12,45,15.3378841711103,41.6621158288897
"1970","choice",-1.04892479575011,72,7,65,9.85304821270305,62.146951787297
"1970","dont know youre",-1.04892479575011,72,7,65,9.85304821270305,62.146951787297
"2010","fighting",-1.05228147213391,79,9,70,12.163055194298,66.8369448057019
"2010","want make",-1.05228147213391,79,9,70,12.163055194298,66.8369448057019
"1960","side",-1.05375986265787,799,41,758,47.7188954409063,751.281104559094
"1960","thought",-1.05375986265787,799,41,758,47.7188954409063,751.281104559094
"1960","okay",-1.05384085686509,226,10,216,13.4974597867895,212.50254021321
"1980","love always",-1.05387791344145,79,10,69,13.2906224838427,65.7093775161573
"1990","escape",-1.0547369386415,115,20,95,24.3966400318961,90.6033599681039
"1970","know im",-1.05503515970558,580,71,509,79.3717772689968,500.628222731003
"2000","yeah oh",-1.05668617875714,214,51,163,57.5843370634669,156.415662936533
"2000","dont come",-1.05683490819526,86,19,67,23.1413691002718,62.8586308997282
"2000","problems",-1.05683490819526,86,19,67,23.1413691002718,62.8586308997282
"2000","going",-1.05753845031995,1104,282,822,297.070598682558,806.929401317442
"1970","aint nothing",-1.05791910206172,106,11,95,14.5058765353684,91.4941234646316
"2010","town",-1.05874419211294,467,64,403,71.9005920979391,395.099407902061
"1970","ohh",-1.06377048397759,188,21,167,25.7274036665024,162.272596333498
"1970","outta",-1.06377048397759,188,21,167,25.7274036665024,162.272596333498
"2010","youd",-1.0644462610702,412,56,356,63.432642279124,348.567357720876
"2010","cant find",-1.06805047077247,64,7,57,9.8536143346212,54.1463856653788
"1990","skies",-1.06971016834474,89,15,74,18.8808779377283,70.1191220622717
"1990","well im",-1.06971016834474,89,15,74,18.8808779377283,70.1191220622717
"1990","horse",-1.07074069646949,46,7,39,9.75865601275846,36.2413439872415
"1990","say just",-1.07074069646949,46,7,39,9.75865601275846,36.2413439872415
"1990","smiles",-1.07074069646949,46,7,39,9.75865601275846,36.2413439872415
"1980","drinks",-1.07266992758811,86,11,75,14.4682725773477,71.5317274226523
"1990","night",-1.07285591872806,3598,738,2860,763.296615954455,2834.70338404555
"1990","begin",-1.07415697558214,110,19,91,23.3359165522485,86.6640834477515
"1990","dance floor",-1.07415697558214,110,19,91,23.3359165522485,86.6640834477515
"1990","tell im",-1.07415697558214,110,19,91,23.3359165522485,86.6640834477515
"1980","morning",-1.07575122538389,509,77,432,85.6319853705812,423.368014629419
"1990","cute",-1.07657537598154,57,9,48,12.0922476679833,44.9077523320167
"2010","others",-1.07769833695969,109,13,96,16.7819369136517,92.2180630863483
"2000","times",-1.08027835768916,626,157,469,168.447640195001,457.552359804999
"2010","reach",-1.08097566306309,224,29,195,34.4876501711742,189.512349828826
"1990","theyre",-1.08188536552985,472,91,381,100.132296478739,371.867703521261
"2010","corner",-1.0830897478475,131,16,115,20.1691168411778,110.830883158822
"2000","mack",-1.08395563617972,78,17,61,20.9886836025721,57.0113163974279
"2000","one im",-1.08395563617972,78,17,61,20.9886836025721,57.0113163974279
"2000","lies",-1.0847450858771,289,70,219,77.7657636044016,211.234236395598
"1960","brand",-1.08658709887717,148,6,142,8.83904446214534,139.160955537855
"1960","lead",-1.09106942339108,188,8,180,11.2279753978603,176.77202460214
"2000","able",-1.09131702684427,36,7,29,9.68708473964864,26.3129152603514
"2000","got give",-1.09131702684427,36,7,29,9.68708473964864,26.3129152603514
"2000","juice",-1.09131702684427,36,7,29,9.68708473964864,26.3129152603514
"2000","say never",-1.09131702684427,36,7,29,9.68708473964864,26.3129152603514
"2000","skinny",-1.09131702684427,36,7,29,9.68708473964864,26.3129152603514
"2000","usa",-1.09131702684427,36,7,29,9.68708473964864,26.3129152603514
"1960","every",-1.09388872780897,2061,112,1949,123.089666462713,1937.91033353729
"1970","dream",-1.09624605791478,789,98,691,107.972986664204,681.027013335796
"1990","eyes",-1.0963753861182,1714,346,1368,363.616008823217,1350.38399117678
"1990","simple",-1.09698827053299,131,23,108,27.7909551667686,103.209044833231
"2000","byamandah",-1.10105692134939,74,16,58,19.9123408537222,54.0876591462778
"2000","byamandah editor",-1.10105692134939,74,16,58,19.9123408537222,54.0876591462778
"1990","watchin",-1.10106100343866,84,14,70,17.8201544580807,66.1798455419193
"1990","like yeah",-1.10145488199448,68,11,57,14.4258393232082,53.5741606767919
"1960","play",-1.10444178364636,1125,59,1066,67.1886825669832,1057.81131743302
"2010","baby cant",-1.1046840581227,124,15,109,19.0913777733286,104.908622226671
"2010","everybody everybody",-1.10545225938801,72,8,64,11.0853161264489,60.9146838735512
"1990","na na na na",-1.10709870008806,831,164,667,176.292242317441,654.707757682559
"1990","remind",-1.10830361152068,162,29,133,34.3674407405841,127.632559259416
"1970","give give give",-1.11315557143698,64,6,58,8.75826507795827,55.2417349220417
"2000","fade away",-1.11543477996571,49,10,39,13.1851986734107,35.8148013265894
"2000","well take",-1.11543477996571,49,10,39,13.1851986734107,35.8148013265894
"1980","dime",-1.11665607796503,100,13,87,16.8235727643578,83.1764272356422
"1980","love right",-1.11665607796503,100,13,87,16.8235727643578,83.1764272356422
"1970","can get",-1.11793433952447,356,42,314,48.7178494961429,307.282150503857
"1990","loud",-1.119047765319,208,38,170,44.1260967533426,163.873903246657
"1990","love never",-1.12048332924188,100,17,83,21.2144695929532,78.7855304070468
"1990","really love",-1.12048332924188,100,17,83,21.2144695929532,78.7855304070468
"2010","cant get",-1.12053359521732,330,44,286,50.8076989128906,279.192301087109
"2000","book",-1.12107981004484,70,15,55,18.8359981048724,51.1640018951276
"2000","come let",-1.12107981004484,70,15,55,18.8359981048724,51.1640018951276
"2000","day night",-1.12107981004484,70,15,55,18.8359981048724,51.1640018951276
"2000","hoping",-1.12107981004484,70,15,55,18.8359981048724,51.1640018951276
"2000","melody",-1.12107981004484,70,15,55,18.8359981048724,51.1640018951276
"2000","shed",-1.12133565886179,115,26,89,30.9448540294332,84.0551459705668
"1960","bay",-1.1229204739671,169,7,162,10.0932332033957,158.906766796604
"1960","mei",-1.1229204739671,169,7,162,10.0932332033957,158.906766796604
"1970","baby know",-1.12790124853172,181,20,161,24.7694684236007,156.230531576399
"1990","family",-1.13043661234344,152,27,125,32.2459937812888,119.754006218711
"1990","played",-1.13043661234344,152,27,125,32.2459937812888,119.754006218711
"2010","whole",-1.13318954316388,613,85,528,94.3791497987937,518.620850201206
"1980","breathing",-1.13356373013874,59,7,52,9.9259079309711,49.0740920690289
"1980","cloud",-1.13356373013874,59,7,52,9.9259079309711,49.0740920690289
"1980","faster",-1.13356373013874,59,7,52,9.9259079309711,49.0740920690289
"1980","sell",-1.13356373013874,59,7,52,9.9259079309711,49.0740920690289
"2010","closer",-1.13404865157966,232,30,202,35.7193519630019,196.280648036998
"1980","girl just",-1.13417397679718,66,8,58,11.1035580244761,54.8964419755239
"1980","open eyes",-1.13417397679718,66,8,58,11.1035580244761,54.8964419755239
"1980","way dont",-1.13417397679718,66,8,58,11.1035580244761,54.8964419755239
"1970","go let go",-1.13420853334045,107,11,96,14.6427244272115,92.3572755727885
"1970","ha ha ha",-1.13504220227222,132,14,118,18.0639217232889,113.936078276711
"1970","thousand",-1.1354497815937,173,19,154,23.6746852888559,149.325314711144
"1990","late night",-1.13719258427223,79,13,66,16.759430978433,62.240569021567
"1980","let",-1.13911175603056,4927,801,4126,828.897430099908,4098.10256990009
"1970","dreamed",-1.140177084099,73,7,66,9.98989610454615,63.0101038954538
"1970","good love",-1.140177084099,73,7,66,9.98989610454615,63.0101038954538
"1970","time get",-1.140177084099,73,7,66,9.98989610454615,63.0101038954538
"1990","lord",-1.1404701206013,359,68,291,76.1599458387019,282.840054161298
"1990","believe im",-1.14098612872235,52,8,44,11.0315241883356,40.9684758116644
"1990","best can",-1.14098612872235,52,8,44,11.0315241883356,40.9684758116644
"1990","cop",-1.14098612872235,52,8,44,11.0315241883356,40.9684758116644
"1990","puttin",-1.14098612872235,52,8,44,11.0315241883356,40.9684758116644
"1990","wrapped",-1.14098612872235,52,8,44,11.0315241883356,40.9684758116644
"1990","yeah can",-1.14098612872235,52,8,44,11.0315241883356,40.9684758116644
"1980","vision",-1.14139743070076,73,9,64,12.2812081179812,60.7187918820188
"2000","felt",-1.1419729522344,325,79,246,87.4528483440502,237.54715165595
"1980","im afraid",-1.14241592478319,52,6,46,8.74825783746605,43.251742162534
"1980","rent",-1.14241592478319,52,6,46,8.74825783746605,43.251742162534
"1980","troubles",-1.14241592478319,52,6,46,8.74825783746605,43.251742162534
"1990","hair",-1.1424232508668,369,70,299,78.2813927979972,290.718607202003
"2000","sees",-1.14457821033265,66,14,52,17.7596553560225,48.2403446439775
"2000","smilin",-1.14457821033265,66,14,52,17.7596553560225,48.2403446439775
"2000","theyd",-1.14457821033265,66,14,52,17.7596553560225,48.2403446439775
"1990","know youll",-1.14821627166881,95,16,79,20.1537461133055,74.8462538866945
"1990","let hear",-1.14821627166881,95,16,79,20.1537461133055,74.8462538866945
"1990","plans",-1.14821627166881,95,16,79,20.1537461133055,74.8462538866945
"2000","deeper",-1.15078361078833,99,22,77,26.6394830340338,72.3605169659662
"2000","want see",-1.15078361078833,99,22,77,26.6394830340338,72.3605169659662
"1980","oh youre",-1.15342571749854,80,10,70,13.4588582114862,66.5411417885138
"1980","question",-1.15342571749854,80,10,70,13.4588582114862,66.5411417885138
"1960","somewhere",-1.1536147823731,229,10,219,13.6766296069681,215.323370393032
"1970","given",-1.15606150373775,124,13,111,16.9691385885441,107.030861411456
"1990","blew",-1.15926709341745,41,6,35,8.6979325331108,32.3020674668892
"1990","damn dont",-1.15926709341745,41,6,35,8.6979325331108,32.3020674668892
"1990","keep keep",-1.15926709341745,41,6,35,8.6979325331108,32.3020674668892
"1990","one else can",-1.15926709341745,41,6,35,8.6979325331108,32.3020674668892
"1990","willing",-1.15926709341745,41,6,35,8.6979325331108,32.3020674668892
"1990","windows",-1.15926709341745,41,6,35,8.6979325331108,32.3020674668892
"2010","snow",-1.15931697412402,110,13,97,16.9358996376302,93.0641003623698
"2000","got feeling",-1.16137270651019,95,21,74,25.5631402851839,69.4368597148161
"1960","walk away",-1.16173248265852,170,7,163,10.1529564767886,159.847043523211
"2000","con",-1.16189052618504,45,9,36,12.1088559245608,32.8911440754392
"1980","tear",-1.16219726054028,193,27,166,32.4694954352105,160.530504564789
"1990","shit",-1.16262664024577,896,177,719,190.08164755286,705.91835244714
"1990","fly",-1.16413045509514,764,150,614,162.078547690162,601.921452309838
"2010","sometimes",-1.16470780561561,442,60,382,68.0515239984777,373.948476001522
"1980","hear say",-1.16649294596104,114,15,99,19.1788729513679,94.8211270486321
"1980","cant let",-1.16708987144254,134,18,116,22.5435875042394,111.456412495761
"2000","hardest",-1.16761110617368,32,6,26,8.61074199079879,23.3892580092012
"2000","lisa",-1.16761110617368,32,6,26,8.61074199079879,23.3892580092012
"2000","love youll",-1.16761110617368,32,6,26,8.61074199079879,23.3892580092012
"2000","pen",-1.16761110617368,32,6,26,8.61074199079879,23.3892580092012
"2000","puts",-1.16761110617368,32,6,26,8.61074199079879,23.3892580092012
"2000","starlight",-1.16761110617368,32,6,26,8.61074199079879,23.3892580092012
"2000","start new",-1.16761110617368,32,6,26,8.61074199079879,23.3892580092012
"2000","thin",-1.16761110617368,32,6,26,8.61074199079879,23.3892580092012
"1970","favorite",-1.16820431685147,99,10,89,13.5479412924667,85.4520587075333
"1970","hanging",-1.16975265251177,149,16,133,20.3903358846216,128.609664115378
"2010","part",-1.17020512209866,338,45,293,52.0394007047182,285.960599295282
"1970","stay",-1.17166315596987,1204,152,1052,164.76486177909,1039.23513822091
"2010","leave",-1.17253133296021,1265,181,1084,194.762845832747,1070.23715416725
"2010","bone",-1.17266846233438,65,7,58,10.0075770585997,54.9924229414003
"1990","broken heart",-1.1736824100549,111,19,92,23.548061248178,87.451938751822
"1970","can go",-1.17529158941243,198,22,176,27.0958825849334,170.904117415067
"1990","tall",-1.17913351845536,74,12,62,15.6987074987853,58.3012925012147
"2010","fall love",-1.1793611213896,254,33,221,39.1065318905279,214.893468109472
"1990","wont stop",-1.17970821796999,90,15,75,19.0930226336578,70.9069773663421
"1990","feels like",-1.18083462516096,168,30,138,35.6403089161613,132.359691083839
"2010","nights",-1.18329091073613,387,52,335,59.5835741796626,327.416425820337
"1970","city",-1.18338057828221,545,66,479,74.5821010544884,470.417898945512
"2010","come back",-1.18721279003297,240,31,209,36.9510537548295,203.04894624517
"1980","smell",-1.18745408252232,94,12,82,15.8141583984963,78.1858416015037
"2000","back now",-1.18771221400602,87,19,68,23.4104547874842,63.5895452125158
"2010","celebrate",-1.18982461585206,88,10,78,13.5487197101042,74.4512802898958
"2010","dreamin",-1.18982461585206,88,10,78,13.5487197101042,74.4512802898958
"2000","blame",-1.1959210231137,263,63,200,70.7695357368776,192.230464263122
"2010","ask",-1.19773635637575,498,68,430,76.6734365412712,421.326563458729
"1990","bring back",-1.19868233630857,106,18,88,22.4873377685304,83.5126622314696
"2000","played",-1.20358202290781,152,35,117,40.9010244562943,111.098975543706
"2000","away dont",-1.20397813189599,83,18,65,22.3341120386344,60.6658879613656
"1990","help",-1.20418584478726,765,150,615,162.290692386092,602.709307613908
"2000","emotions",-1.20502086026553,58,12,46,15.6069698583228,42.3930301416772
"2000","lets dance",-1.20502086026553,58,12,46,15.6069698583228,42.3930301416772
"2000","radio",-1.20542967730067,180,42,138,48.4354236982432,131.564576301757
"2010","dreamed",-1.20598912414053,73,8,65,11.2392788504273,61.7607211495727
"2010","jet",-1.20598912414053,73,8,65,11.2392788504273,61.7607211495727
"1960","else",-1.20664838709052,625,31,594,37.3270458705462,587.672954129454
"2000","missing",-1.20878118160292,188,44,144,50.5881091959429,137.411890804057
"2000","really wanna",-1.20878118160292,188,44,144,50.5881091959429,137.411890804057
"1960","clothes",-1.20940977581507,211,9,202,12.6016106858964,198.398389314104
"1960","cup",-1.21029670036504,151,6,145,9.01821428232397,141.981785717676
"1970","fly away",-1.21045635512002,91,9,82,12.4531581577219,78.5468418422781
"1970","insane",-1.21045635512002,91,9,82,12.4531581577219,78.5468418422781
"1970","know well",-1.21045635512002,91,9,82,12.4531581577219,78.5468418422781
"1970","baby thats",-1.21220300917904,65,6,59,8.89511296980137,56.1048870301986
"1970","bone",-1.21220300917904,65,6,59,8.89511296980137,56.1048870301986
"1970","race",-1.21220300917904,65,6,59,8.89511296980137,56.1048870301986
"1970","whoa oh oh oh",-1.21220300917904,65,6,59,8.89511296980137,56.1048870301986
"1990","girl look",-1.21300451394214,58,9,49,12.3043923639128,45.6956076360872
"1990","human",-1.21300451394214,58,9,49,12.3043923639128,45.6956076360872
"1990","seasons",-1.21300451394214,58,9,49,12.3043923639128,45.6956076360872
"1990","see see",-1.21300451394214,58,9,49,12.3043923639128,45.6956076360872
"2010","like like",-1.21851211994785,318,42,276,48.9601462251491,269.039853774851
"2000","clown",-1.2195578063419,41,8,33,11.032513175711,29.9674868242891
"2000","finally found",-1.2195578063419,41,8,33,11.032513175711,29.9674868242891
"2000","gonna alright",-1.2195578063419,41,8,33,11.032513175711,29.9674868242891
"2000","physical",-1.2195578063419,41,8,33,11.032513175711,29.9674868242891
"2000","things never",-1.2195578063419,41,8,33,11.032513175711,29.9674868242891
"2000","world will",-1.2195578063419,41,8,33,11.032513175711,29.9674868242891
"1970","shot",-1.22026968763633,223,25,198,30.5170798810108,192.482920118989
"1990","feel like im",-1.22130420424585,47,7,40,9.97080070868799,37.029199291312
"1990","ill find",-1.22130420424585,47,7,40,9.97080070868799,37.029199291312
"1990","sat",-1.22130420424585,47,7,40,9.97080070868799,37.029199291312
"1970","just one",-1.22395426252107,215,24,191,29.4222967462661,185.577703253734
"2010","lose",-1.22673618129122,684,95,589,105.310503201264,578.689496798736
"1990","back back",-1.22673909688982,101,17,84,21.4266142888827,79.5733857111173
"1990","come around",-1.22823150229178,69,11,58,14.6379840191377,54.3620159808623
"1990","news",-1.22823150229178,69,11,58,14.6379840191377,54.3620159808623
"1990","stood",-1.22823150229178,69,11,58,14.6379840191377,54.3620159808623
"1980","mess",-1.22850079506009,207,29,178,34.8247956222206,172.175204377779
"1970","thang",-1.22982662362122,125,13,112,17.1059864803872,107.894013519613
"1980","taken",-1.23034172469516,108,14,94,18.1694585855064,89.8305414144936
"2000","clear",-1.23433490207205,224,53,171,60.2751939355916,163.724806064408
"1970","spread",-1.23433544509491,74,7,67,10.1267439963892,63.8732560036107
"2010","become",-1.23515752353982,96,11,85,14.7804215019318,81.2195784980682
"2010","paid",-1.23515752353982,96,11,85,14.7804215019318,81.2195784980682
"2010","smokin",-1.23515752353982,96,11,85,14.7804215019318,81.2195784980682
"2010","worlds",-1.23515752353982,96,11,85,14.7804215019318,81.2195784980682
"1960","keep",-1.23644204687698,2547,139,2408,152.11517733165,2394.88482266835
"1960","baby dont",-1.23857200178776,366,17,349,21.8587180617919,344.141281938208
"2010","take away",-1.24029692966856,191,24,167,29.4068802798852,161.593119720115
"2010","dying",-1.24363379181155,81,9,72,12.470980642255,68.529019357745
"2010","goes around",-1.24363379181155,81,9,72,12.470980642255,68.529019357745
"2010","never leave",-1.24363379181155,81,9,72,12.470980642255,68.529019357745
"1960","tryin",-1.24401554249718,516,25,491,30.817209070723,485.182790929277
"2000","day just",-1.24406584181844,54,11,43,14.530627109473,39.469372890527
"2000","just good",-1.24406584181844,54,11,43,14.530627109473,39.469372890527
"2000","youre love",-1.24406584181844,54,11,43,14.530627109473,39.469372890527
"2000","can dance",-1.24442093315409,75,16,59,20.1814265409347,54.8185734590653
"2000","nasty",-1.2462011105298,112,25,87,30.1375969677958,81.8624030322042
"1980","believe believe",-1.24623049298646,67,8,59,11.2717937521197,55.7282062478803
"1980","dare",-1.24623049298646,67,8,59,11.2717937521197,55.7282062478803
"1980","show love",-1.24623049298646,67,8,59,11.2717937521197,55.7282062478803
"1980","record",-1.24856487014386,74,9,65,12.4494438456248,61.5505561543752
"1980","spread",-1.24856487014386,74,9,65,12.4494438456248,61.5505561543752
"1980","ahh",-1.25164315801829,60,7,53,10.0941436586147,49.9058563413853
"1980","worth",-1.2518482329554,272,39,233,45.7601179190532,226.239882080947
"1960","breaking",-1.25263943214132,152,6,146,9.07793755571684,142.922062444283
"1960","look eyes",-1.25263943214132,152,6,146,9.07793755571684,142.922062444283
"1980","escape",-1.25406893692828,115,15,100,19.3471086790115,95.6528913209885
"2000","little thing",-1.25540030267814,108,24,84,29.0612542189459,78.9387457810541
"1980","bite",-1.25654527094136,81,10,71,13.6270939391298,67.3729060608702
"1980","cant deny",-1.25654527094136,81,10,71,13.6270939391298,67.3729060608702
"1980","dollars",-1.25654527094136,81,10,71,13.6270939391298,67.3729060608702
"1960","closer",-1.2569781909202,232,10,222,13.8557994271468,218.144200572853
"1990","worlds",-1.25835543250133,96,16,80,20.365890809235,75.634109190765
"1970","dont tell",-1.25849149691119,117,12,105,16.0112033456425,100.988796654358
"2010","now come",-1.25956155625219,58,6,52,8.92983799075047,49.0701620092495
"2010","seasons",-1.25956155625219,58,6,52,8.92983799075047,49.0701620092495
"2010","younger",-1.25956155625219,58,6,52,8.92983799075047,49.0701620092495
"2010","wondering",-1.26210557720588,126,15,111,19.3993032212855,106.600696778715
"1990","just one",-1.26295812286945,215,39,176,45.6111096248493,169.388890375151
"1970","away dont",-1.26355702738473,83,8,75,11.3583750229771,71.6416249770229
"2010","never let",-1.26609445682752,177,22,155,27.2514021441868,149.748597855813
"1980","cant make",-1.26809831407581,53,6,47,8.91649356510963,44.0835064348904
"1980","feed",-1.26809831407581,53,6,47,8.91649356510963,44.0835064348904
"1980","good baby",-1.26809831407581,53,6,47,8.91649356510963,44.0835064348904
"1980","headed",-1.26809831407581,53,6,47,8.91649356510963,44.0835064348904
"1980","hug",-1.26809831407581,53,6,47,8.91649356510963,44.0835064348904
"1980","like just",-1.26876828924843,88,11,77,14.8047440326349,73.1952559673651
"2000","heads",-1.26952823439713,71,15,56,19.1050837920848,51.8949162079152
"1970","dont go",-1.27429385470734,167,18,149,22.8535979377974,144.146402062203
"1990","south",-1.27692914129669,112,19,93,23.7602059441075,88.2397940558925
"1970","clear",-1.27735330975005,224,25,199,30.6539277728539,193.346072227146
"1970","baby baby baby baby",-1.27878766531728,134,14,120,18.3376175069751,115.662382493025
"1970","twice",-1.27878766531728,134,14,120,18.3376175069751,115.662382493025
"1980","anyway",-1.27896012056038,122,16,106,20.5247587725165,101.475241227483
"1980","bust",-1.27896012056038,122,16,106,20.5247587725165,101.475241227483
"1960","spend",-1.27981960583853,291,13,278,17.3794725573263,273.620527442674
"2010","green",-1.28152673209575,170,21,149,26.1736630763376,143.826336923662
"2010","motherfucker",-1.28192697086358,104,12,92,16.0121232937595,87.9878767062406
"2010","theyve",-1.28192697086358,104,12,92,16.0121232937595,87.9878767062406
"1980","now now",-1.28426049767833,95,12,83,15.9823941261399,79.0176058738601
"1970","mine",-1.2849985914967,1033,129,904,141.36387227392,891.63612772608
"1990","baby tonight",-1.2872079797103,53,8,45,11.2436688842652,41.7563311157348
"1990","chasing",-1.2872079797103,53,8,45,11.2436688842652,41.7563311157348
"1990","like ive",-1.2872079797103,53,8,45,11.2436688842652,41.7563311157348
"2010","go let",-1.28789564795461,141,17,124,21.7087440809623,119.291255919038
"2000","attack",-1.29098947353892,50,10,40,13.4542843606231,36.5457156393769
"2000","right baby",-1.29098947353892,50,10,40,13.4542843606231,36.5457156393769
"2000","aint aint",-1.29235791106933,37,7,30,9.9561704268611,27.0438295731389
"2000","hold arms",-1.29235791106933,37,7,30,9.9561704268611,27.0438295731389
"2000","im gonna take",-1.29235791106933,37,7,30,9.9561704268611,27.0438295731389
"2000","life will",-1.29235791106933,37,7,30,9.9561704268611,27.0438295731389
"2000","want feel",-1.29235791106933,37,7,30,9.9561704268611,27.0438295731389
"1980","every time",-1.29735214113577,356,52,304,59.8919190411137,296.108080958886
"1960","wake",-1.29818734538981,330,15,315,19.7086802196484,310.291319780352
"2000","tryin get",-1.29870735403175,67,14,53,18.028741043235,48.971258956765
"2010","hear",-1.30098519398896,1398,200,1198,215.239888121882,1182.76011187812
"1980","dont try",-1.30232535121594,102,13,89,17.1600442196449,84.8399557803551
"2000","flow",-1.30237701576092,177,41,136,47.6281666366058,129.371833363394
"2000","ahead",-1.30379039285729,165,38,127,44.3991383900563,120.600861609944
"1990","right time",-1.3047437224903,75,12,63,15.9108521947149,59.0891478052851
"1970","father",-1.30544895295854,126,13,113,17.2428343722303,108.75716562777
"1980","cause got",-1.30565862717787,149,20,129,25.0671234188931,123.932876581107
"1990","boo",-1.3060795544054,128,22,106,27.15452107898,100.84547892102
"1970","cup",-1.30722057083417,151,16,135,20.6640316683078,130.335968331692
"2010","feel right",-1.3098983163547,74,8,66,11.3932415744058,62.6067584255942
"1960","worry",-1.31173773336803,292,13,279,17.4391958307192,274.560804169281
"2010","cant let",-1.31405504318674,134,16,118,20.6310050131131,113.368994986887
"1970","beneath",-1.31437993054754,66,6,60,9.03196086164446,56.9680391383555
"1970","oh girl",-1.31437993054754,66,6,60,9.03196086164446,56.9680391383555
"1970","turn lights",-1.31437993054754,66,6,60,9.03196086164446,56.9680391383555
"1990","making",-1.31671981898685,367,69,298,77.8571034061381,289.142896593862
"2010","still love",-1.31865075207677,156,19,137,24.0181849406392,131.981815059361
"1970","middle",-1.32029764304426,289,33,256,39.5490407426553,249.450959257345
"1970","hey hey hey",-1.32129026580716,297,34,263,40.6438238774001,256.3561761226
"1960","yet",-1.32197329356101,174,7,167,10.3918495703601,163.60815042964
"1980","gotta gotta",-1.32245120451558,109,14,95,18.33769431315,90.66230568685
"1980","like know",-1.32245120451558,109,14,95,18.33769431315,90.66230568685
"1990","go dont let go",-1.32380955247136,42,6,36,8.91007722904033,33.0899227709597
"1990","goi",-1.32380955247136,42,6,36,8.91007722904033,33.0899227709597
"1990","like move",-1.32380955247136,42,6,36,8.91007722904033,33.0899227709597
"1990","still want",-1.32380955247136,42,6,36,8.91007722904033,33.0899227709597
"1990","things say",-1.32380955247136,42,6,36,8.91007722904033,33.0899227709597
"1990","wanna kiss",-1.32380955247136,42,6,36,8.91007722904033,33.0899227709597
"2000","war",-1.32381398794952,137,31,106,36.8647391481073,100.135260851893
"1990","sick",-1.32412534742825,149,26,123,31.6095596935002,117.3904403065
"2010","live",-1.32475864957042,1210,172,1038,186.294896013932,1023.70510398607
"2000","breakin",-1.32501333275443,88,19,69,23.6795404746967,64.3204595253033
"2000","oh yeah oh",-1.32501333275443,88,19,69,23.6795404746967,64.3204595253033
"2010","sorry",-1.32595975366112,306,40,266,47.1125935374076,258.887406462592
"1970","clean",-1.32674265030663,176,19,157,24.0852289643852,151.914771035615
"1970","number",-1.3269477517895,241,27,214,32.9803419341866,208.019658065813
"2010","well well",-1.32748552566847,97,11,86,14.9343842259103,82.0656157740897
"2010","yes im",-1.32748552566847,97,11,86,14.9343842259103,82.0656157740897
"1980","swear",-1.32784773321088,299,43,256,50.3024825654298,248.69751743457
"1970","feel",-1.32878462724942,3697,482,3215,505.926656143933,3191.07334385607
"2010","south",-1.32981821076856,112,13,99,17.2438250855871,94.7561749144129
"2000","work work",-1.33277350595865,63,13,50,16.9523982943851,46.0476017056149
"2000","yeah now",-1.33277350595865,63,13,50,16.9523982943851,46.0476017056149
"2010","keeps",-1.33422496138279,285,37,248,43.8793763338601,241.12062366614
"1990","fingers",-1.33700264703266,102,17,85,21.6387589848122,80.3612410151878
"1990","man im",-1.33700264703266,102,17,85,21.6387589848122,80.3612410151878
"1970","everyone",-1.34147571762314,217,24,193,29.6959925299523,187.304007470048
"1990","pull",-1.34364050056673,282,52,230,59.8248042521279,222.175195747872
"2010","aint nobody",-1.34398128447306,82,9,73,12.6249433662334,69.3750566337666
"2010","angels",-1.34398128447306,82,9,73,12.6249433662334,69.3750566337666
"1990","life",-1.34764903048812,2901,590,2311,615.431762891571,2285.56823710843
"2000","aint right",-1.34798618589368,46,9,37,12.3779416117733,33.6220583882267
"2000","im saying",-1.34798618589368,46,9,37,12.3779416117733,33.6220583882267
"2000","smiles",-1.34798618589368,46,9,37,12.3779416117733,33.6220583882267
"1960","four",-1.35571078921665,195,8,187,11.6460383116104,183.35396168839
"1990","breathing",-1.3557683449477,59,9,50,12.5165370598424,46.4834629401576
"1990","sell",-1.3557683449477,59,9,50,12.5165370598424,46.4834629401576
"1970","baby cause",-1.35645510566572,84,8,76,11.4952229148202,72.5047770851798
"1970","lyin",-1.35645510566572,84,8,76,11.4952229148202,72.5047770851798
"1980","lifetime",-1.35947490457005,75,9,66,12.6176795732683,62.3823204267317
"2000","dont tell",-1.36001699456803,117,26,91,31.4830254038581,85.5169745961419
"1990","book",-1.36050606781619,70,11,59,14.8501287150672,55.1498712849328
"1990","never get",-1.36050606781619,70,11,59,14.8501287150672,55.1498712849328
"1990","without without",-1.36050606781619,70,11,59,14.8501287150672,55.1498712849328
"1980","drag",-1.36233508280287,68,8,60,11.4400294797633,56.5599705202367
"1980","heart beat",-1.36233508280287,68,8,60,11.4400294797633,56.5599705202367
"1980","aint nobody",-1.36314278458437,82,10,72,13.7953296667734,68.2046703332266
"1980","rock rock",-1.36314278458437,82,10,72,13.7953296667734,68.2046703332266
"2010","ready",-1.36430021503886,571,78,493,87.9127153916985,483.087284608301
"2010","light",-1.36462247472609,1015,143,872,156.272164838133,858.727835161867
"1960","everybody",-1.36478440639129,1033,53,980,61.6941414148388,971.305858585161
"1980","cried",-1.36486358736354,163,22,141,27.4224236059032,135.577576394097
"1980","flowers",-1.37172823280115,89,11,78,14.9729797602784,74.0270202397216
"2010","cant take",-1.37237856229927,164,20,144,25.2498867324668,138.750113267533
"2000","know go",-1.37277587706795,59,12,47,15.8760555455353,43.1239444544647
"2000","now theres",-1.37277587706795,59,12,47,15.8760555455353,43.1239444544647
"2000","steps",-1.37277587706795,59,12,47,15.8760555455353,43.1239444544647
"1980","hard say",-1.37412579754343,61,7,54,10.2623793862583,50.7376206137417
"1980","oh lord",-1.37412579754343,61,7,54,10.2623793862583,50.7376206137417
"1970","ear",-1.37576228862102,110,11,99,15.0532681027408,94.9467318972592
"1970","know really",-1.37576228862102,110,11,99,15.0532681027408,94.9467318972592
"2010","torn",-1.37751222052922,59,6,53,9.08380071472892,49.9161992852711
"2010","view",-1.37751222052922,59,6,53,9.08380071472892,49.9161992852711
"1990","back baby",-1.37931651899481,48,7,41,10.1829454046175,37.8170545953825
"1990","box",-1.37931651899481,48,7,41,10.1829454046175,37.8170545953825
"1990","boyfriend",-1.37931651899481,48,7,41,10.1829454046175,37.8170545953825
"1990","embrace",-1.37931651899481,48,7,41,10.1829454046175,37.8170545953825
"1990","peace mind",-1.37931651899481,48,7,41,10.1829454046175,37.8170545953825
"2010","asking",-1.38181532423505,90,10,80,13.8566451580611,76.1433548419389
"1960","harder",-1.382883499564,155,6,149,9.25710737589546,145.742892624105
"1960","long time",-1.382883499564,155,6,149,9.25710737589546,145.742892624105
"1980","become",-1.38411086099828,96,12,84,16.1506298537835,79.8493701462165
"2000","dont know just",-1.38629870622911,33,6,27,8.87982767801125,24.1201723219887
"2000","life without",-1.38629870622911,33,6,27,8.87982767801125,24.1201723219887
"2000","like need",-1.38629870622911,33,6,27,8.87982767801125,24.1201723219887
"2000","look body",-1.38629870622911,33,6,27,8.87982767801125,24.1201723219887
"2000","melt",-1.38629870622911,33,6,27,8.87982767801125,24.1201723219887
"2000","mind know",-1.38629870622911,33,6,27,8.87982767801125,24.1201723219887
"1970","runs",-1.38730386231353,93,9,84,12.7268539414081,80.2731460585919
"1970","tight",-1.3873646755395,354,41,313,48.4441537124567,305.555846287543
"2010","believe believe",-1.39292822906681,67,7,60,10.3155025065566,56.6844974934434
"2010","know way",-1.39292822906681,67,7,60,10.3155025065566,56.6844974934434
"2000","find another",-1.39501741639943,76,16,60,20.4505122281471,55.5494877718529
"2010","ends",-1.39513495601295,135,16,119,20.7849677370916,114.215032262908
"2010","never knew",-1.39513495601295,135,16,119,20.7849677370916,114.215032262908
"1980","just good",-1.39859901767139,54,6,48,9.08472929275321,44.9152707072468
"1980","tell now",-1.39859901767139,54,6,48,9.08472929275321,44.9152707072468
"1980","hope",-1.40670515451281,523,78,445,87.9872855575913,435.012714442409
"1970","true",-1.40673284610745,1022,127,895,139.858545463646,882.141454536354
"1990","walkin",-1.40739107612827,129,22,107,27.3666657749096,101.63333422509
"1970","ball",-1.40963049755837,169,18,151,23.1272937214836,145.872706278516
"1990","light",-1.40970849448014,1015,200,815,215.326866368475,799.673133631525
"1990","wit",-1.41037470114543,765,149,616,162.290692386092,602.709307613908
"1990","matter",-1.41107377189671,533,102,431,113.07312293044,419.92687706956
"1990","im coming",-1.41293195646027,92,15,77,19.5173120255169,72.4826879744831
"1990","dont understand",-1.41564986156399,108,18,90,22.9116271603894,85.0883728396106
"1980","friend",-1.41722880957398,649,98,551,109.184987240682,539.815012759318
"1980","go home",-1.41726482345947,110,14,96,18.5059300407936,91.4940699592064
"1980","instead",-1.41726482345947,110,14,96,18.5059300407936,91.4940699592064
"2000","growing",-1.41815404794742,42,8,34,11.3015988629234,30.6984011370766
"2000","never want",-1.41815404794742,42,8,34,11.3015988629234,30.6984011370766
"2000","yeah get",-1.41815404794742,42,8,34,11.3015988629234,30.6984011370766
"1970","space",-1.41815531410343,119,12,107,16.2848991293287,102.715100870671
"1970","arm",-1.41958753878479,67,6,61,9.16880875348756,57.8311912465124
"1970","dare",-1.41958753878479,67,6,61,9.16880875348756,57.8311912465124
"1970","tell youre",-1.41958753878479,67,6,61,9.16880875348756,57.8311912465124
"1970","twist",-1.41958753878479,67,6,61,9.16880875348756,57.8311912465124
"2000","cant let go",-1.42008842089283,55,11,44,14.7997127966854,40.2002872033146
"2000","tell can",-1.42008842089283,55,11,44,14.7997127966854,40.2002872033146
"2000","vain",-1.42008842089283,55,11,44,14.7997127966854,40.2002872033146
"1980","things",-1.42010309997139,1560,245,1315,262.447735123982,1297.55226487602
"1970","rap",-1.42229118815144,102,10,92,13.958484967996,88.041515032004
"1970","see can",-1.42229118815144,102,10,92,13.958484967996,88.041515032004
"2010","longer",-1.42245094389766,98,11,87,15.0883469498887,82.9116530501113
"2010","word",-1.42463137455811,343,45,298,52.8092143246105,290.19078567539
"2000","set free",-1.42552289729785,72,15,57,19.3741694792973,52.6258305207027
"2010","shoes",-1.42617428713892,172,21,151,26.4815885242945,145.518411475706
"1990","bone",-1.42623266090291,65,10,55,13.7894052354196,51.2105947645804
"1960","still love",-1.42734665387418,156,6,150,9.31683064928833,146.683169350712
"1980","yes",-1.42814176881555,1017,157,860,171.095735013519,845.904264986481
"1970","dont like",-1.42949917247227,136,14,122,18.6113132906613,117.388686709339
"1960","started",-1.42995635610177,315,14,301,18.8128311187553,296.187168881245
"1960","white",-1.42995635610177,315,14,301,18.8128311187553,296.187168881245
"1970","awhile",-1.43104554511533,76,7,69,10.4004397800754,65.5995602199246
"1970","girl love",-1.43104554511533,76,7,69,10.4004397800754,65.5995602199246
"1970","like youre",-1.43104554511533,76,7,69,10.4004397800754,65.5995602199246
"1970","time time",-1.43191332038232,194,21,173,26.548491017561,167.451508982439
"1990","pretend",-1.43353850806107,124,21,103,26.3059422952619,97.6940577047381
"2010","heart",-1.43857139659028,2871,419,2452,442.026980542148,2428.97301945785
"1990","breaks",-1.44013984548416,54,8,46,11.4558135801947,42.5441864198053
"1990","need little",-1.44013984548416,54,8,46,11.4558135801947,42.5441864198053
"1990","oh know",-1.44013984548416,54,8,46,11.4558135801947,42.5441864198053
"1990","right cause",-1.44013984548416,54,8,46,11.4558135801947,42.5441864198053
"1980","knock",-1.44424840574586,164,22,142,27.5906593335468,136.409340666453
"1980","love like",-1.44584430723735,301,43,258,50.638954020717,250.361045979283
"2010","lost",-1.44604373703655,635,87,548,97.7663297263198,537.23367027368
"2000","bird",-1.44690064422713,93,20,73,25.024968910759,67.975031089241
"1960","voice",-1.44723368118293,177,7,170,10.5710193905387,166.428980609461
"2010","built",-1.44733604583816,83,9,74,12.7789060902119,70.2210939097881
"2000","feeling",-1.44922573605708,922,232,690,248.09700360989,673.90299639011
"1970","lately",-1.45185964658022,85,8,77,11.6320708066633,73.3679291933367
"1970","want say",-1.45185964658022,85,8,77,11.6320708066633,73.3679291933367
"1990","loves",-1.45641124106362,514,98,416,109.042373707779,404.957626292221
"1990","falls",-1.4586600655405,87,14,73,18.4565885458693,68.5434114541307
"1990","oh just",-1.4586600655405,87,14,73,18.4565885458693,68.5434114541307
"1990","poison",-1.4586600655405,87,14,73,18.4565885458693,68.5434114541307
"1970","just another",-1.46037363923052,111,11,100,15.1901159945839,95.8098840054161
"2000","wanna wanna",-1.46072273143132,68,14,54,18.2978267304474,49.7021732695526
"2010","let go let",-1.46597478748286,121,14,107,18.6294896013932,102.370510398607
"2010","nobody",-1.46814009516824,718,99,619,110.545235816532,607.454764183468
"2000","im sure",-1.46857321163027,89,19,70,23.9486261619091,65.0513738380909
"2010","one day",-1.4714417462585,158,19,139,24.3261103885961,133.673889611404
"1990","round",-1.47188918567769,727,141,586,154.229193940769,572.77080605923
"1980","pocket",-1.47312812064011,83,10,73,13.963565394417,69.036434605583
"1980","bridge",-1.47402167199585,76,9,67,12.7859153009119,63.2140846990881
"1980","case",-1.47402167199585,76,9,67,12.7859153009119,63.2140846990881
"1980","said im",-1.47402167199585,76,9,67,12.7859153009119,63.2140846990881
"1980","take back",-1.47402167199585,76,9,67,12.7859153009119,63.2140846990881
"1990","movin",-1.47472183699844,192,34,158,40.7317816184701,151.26821838153
"1980","one thing",-1.47523739467428,204,28,176,34.3200884392899,169.67991156071
"1960","can go",-1.47580553361986,198,8,190,11.825208131789,186.174791868211
"2000","show way",-1.47654670965455,51,10,41,13.7233700478356,37.2766299521644
"1980","awake",-1.47785752148773,90,11,79,15.141215487922,74.858784512078
"2010","empty",-1.47820683904061,136,16,120,20.9389304610701,115.06106953893
"2010","go get",-1.47820683904061,136,16,120,20.9389304610701,115.06106953893
"1970","will love",-1.47921061638222,94,9,85,12.8637018332512,81.1362981667488
"2010","sure",-1.48098222983678,560,76,484,86.2191254279355,473.780874572064
"1980","simple",-1.4810467866515,131,17,114,22.0388803213087,108.961119678691
"1980","got money",-1.4823617244238,69,8,61,11.6082652074069,57.3917347925931
"1980","return",-1.4823617244238,69,8,61,11.6082652074069,57.3917347925931
"1980","riding",-1.4823617244238,69,8,61,11.6082652074069,57.3917347925931
"1980","spending",-1.4823617244238,69,8,61,11.6082652074069,57.3917347925931
"1980","tell ya",-1.4823617244238,69,8,61,11.6082652074069,57.3917347925931
"1970","let",-1.48834274536611,4927,645,4282,674.249563110943,4252.75043688906
"1980","house",-1.48967599699188,417,61,356,70.154298427372,346.845701572628
"1970","telling",-1.49096560985103,260,29,231,35.5804518792055,224.419548120795
"1990","longer",-1.49104069945548,98,16,82,20.7901802010941,77.2098197989059
"1990","mans",-1.49104069945548,98,16,82,20.7901802010941,77.2098197989059
"1990","cars",-1.49573332958254,156,27,129,33.0945725650069,122.905427434993
"1990","ten",-1.49573332958254,156,27,129,33.0945725650069,122.905427434993
"1960","think",-1.49576682761296,2640,143,2497,157.669441757187,2482.33055824281
"1990","feel alright",-1.49629116598323,43,6,37,9.12222192496986,33.8777780750301
"1990","get em",-1.49629116598323,43,6,37,9.12222192496986,33.8777780750301
"1990","good thing",-1.49629116598323,43,6,37,9.12222192496986,33.8777780750301
"1990","let go dont let",-1.49629116598323,43,6,37,9.12222192496986,33.8777780750301
"1990","mess around",-1.49629116598323,43,6,37,9.12222192496986,33.8777780750301
"1960","heaven",-1.49695337886464,432,20,412,25.8004541057215,406.199545894278
"1980","pretty",-1.49702352632762,487,72,415,81.9307993624224,405.069200637578
"1990","early",-1.49810816115947,71,11,60,15.0622734109967,55.9377265890033
"1990","written",-1.49810816115947,71,11,60,15.0622734109967,55.9377265890033
"2010","mac",-1.49930104487955,60,6,54,9.23776343870738,50.7622365612926
"1970","choose",-1.50083158758652,120,12,108,16.4217470211718,103.578252978828
"1970","one else",-1.50083158758652,120,12,108,16.4217470211718,103.578252978828
"1980","champagne",-1.50085923732651,62,7,55,10.4306151139018,51.5693848860982
"1980","know gotta",-1.50085923732651,62,7,55,10.4306151139018,51.5693848860982
"2000","cares",-1.50154644686429,64,13,51,17.2214839815976,46.7785160184024
"2000","give give give",-1.50154644686429,64,13,51,17.2214839815976,46.7785160184024
"2000","hold hand",-1.50154644686429,64,13,51,17.2214839815976,46.7785160184024
"2000","never seen",-1.50154644686429,64,13,51,17.2214839815976,46.7785160184024
"2000","theres just",-1.50154644686429,64,13,51,17.2214839815976,46.7785160184024
"2000","wont tell",-1.50154644686429,64,13,51,17.2214839815976,46.7785160184024
"1990","ones",-1.50186006085034,218,39,179,46.2475437126379,171.752456287362
"1990","know get",-1.50463491475977,60,9,51,12.7286817557719,47.2713182442281
"1990","quiet",-1.50463491475977,60,9,51,12.7286817557719,47.2713182442281
"2000","em now",-1.50601717643028,38,7,31,10.2252561140736,27.7747438859264
"2000","gone gone",-1.50601717643028,38,7,31,10.2252561140736,27.7747438859264
"2000","magic magic",-1.50601717643028,38,7,31,10.2252561140736,27.7747438859264
"2000","please let",-1.50601717643028,38,7,31,10.2252561140736,27.7747438859264
"2000","startin",-1.50601717643028,38,7,31,10.2252561140736,27.7747438859264
"2000","ya baby",-1.50601717643028,38,7,31,10.2252561140736,27.7747438859264
"2010","cant get enough",-1.50833900370845,68,7,61,10.469465230535,57.530534769465
"2010","shinin",-1.50833900370845,68,7,61,10.469465230535,57.530534769465
"2010","build",-1.50970065763195,114,13,101,17.551750533544,96.448249466456
"2010","romance",-1.50970065763195,114,13,101,17.551750533544,96.448249466456
"1990","flame",-1.5109133912256,82,13,69,17.3958650662216,64.6041349337784
"1970","eight",-1.51130976896662,103,10,93,14.0953328598391,88.9046671401609
"1970","holdin",-1.51130976896662,103,10,93,14.0953328598391,88.9046671401609
"1970","rough",-1.51130976896662,103,10,93,14.0953328598391,88.9046671401609
"2000","love love love",-1.51140371818483,381,92,289,102.521646827948,278.478353172052
"1990","whole world",-1.51189042749441,130,22,108,27.5788104708391,102.421189529161
"2010","called",-1.51243256725355,231,29,202,35.5653892390234,195.434610760977
"1990","game",-1.51500042881736,644,124,520,136.621184178618,507.378815821382
"1990","drive",-1.51519929671824,340,63,277,72.1291966160408,267.870803383959
"2000","wake",-1.51603974076925,330,79,251,88.7982767801126,241.201723219887
"1960","one time",-1.51669365520516,199,8,191,11.8849314051819,187.115068594818
"1960","one one",-1.51780481573855,158,6,152,9.43627719607408,148.563722803926
"1990","never let",-1.51823328981081,177,31,146,37.5496111795271,139.450388820473
"2010","aint nothin",-1.51999685665856,99,11,88,15.2423096738672,83.7576903261328
"2010","till",-1.52426370496999,692,95,597,106.542204993092,585.457795006908
"2010","case",-1.52745377893346,76,8,68,11.7011670223627,64.2988329776373
"2010","mami",-1.52745377893346,76,8,68,11.7011670223627,64.2988329776373
"1960","shine",-1.52782318945241,395,18,377,23.5906929901852,371.409307009815
"1960","lookin",-1.52935959492008,471,22,449,28.1296617680436,442.870338231956
"1980","baby youre",-1.52968747613265,145,19,126,24.3941805083188,120.605819491681
"1980","cant believe",-1.52968747613265,145,19,126,24.3941805083188,120.605819491681
"2000","losing",-1.53154591185728,155,35,120,41.7082815179316,113.291718482068
"1980","doesnt mean",-1.5337302483254,55,6,49,9.25296502039679,45.7470349796032
"1980","just got",-1.5337302483254,55,6,49,9.25296502039679,45.7470349796032
"1980","liked",-1.5337302483254,55,6,49,9.25296502039679,45.7470349796032
"2010","lead",-1.533934584122,188,23,165,28.9449921079498,159.05500789205
"1990","bird",-1.53594806560973,93,15,78,19.7294567214464,73.2705432785536
"1990","come now",-1.53594806560973,93,15,78,19.7294567214464,73.2705432785536
"2010","breath",-1.53641681070661,260,33,227,40.0303082343986,219.969691765601
"1990","cant wait",-1.53898612007135,146,25,121,30.9731256057116,115.026874394288
"1990","havent",-1.54094955915813,125,21,104,26.5180869911915,98.4819130088085
"1970","run",-1.54263548215037,1088,135,953,148.890506325291,939.109493674709
"1970","trip",-1.54315257704714,129,13,116,17.6533780477596,111.34662195224
"1990","back love",-1.54444447788324,49,7,42,10.3950901005471,38.604909899453
"1990","chose",-1.54444447788324,49,7,42,10.3950901005471,38.604909899453
"1990","get ready",-1.54444447788324,49,7,42,10.3950901005471,38.604909899453
"1990","make smile",-1.54444447788324,49,7,42,10.3950901005471,38.604909899453
"1990","stop just",-1.54444447788324,49,7,42,10.3950901005471,38.604909899453
"2000","know better",-1.54466079622153,47,9,38,12.6470272989857,34.3529727010143
"2000","pillow",-1.54466079622153,47,9,38,12.6470272989857,34.3529727010143
"2000","time can",-1.54466079622153,47,9,38,12.6470272989857,34.3529727010143
"2000","want ill",-1.54466079622153,47,9,38,12.6470272989857,34.3529727010143
"2000","way things",-1.54466079622153,47,9,38,12.6470272989857,34.3529727010143
"1970","chain",-1.54970898908633,86,8,78,11.7689186985064,74.2310813014936
"1970","problems",-1.54970898908633,86,8,78,11.7689186985064,74.2310813014936
"1970","thinkin bout",-1.54970898908633,86,8,78,11.7689186985064,74.2310813014936
"1980","smile",-1.55333859871548,583,87,496,98.0814292162059,484.918570783794
"2010","baby know",-1.55445940164453,181,22,159,27.8672530401006,153.132746959899
"2010","live life",-1.55551010867395,122,14,108,18.7834523253717,103.216547674628
"2000","always",-1.55832415929883,1781,456,1325,479.241608925395,1301.7583910746
"2010","will come",-1.560525797633,107,12,95,16.4740114656948,90.5259885343052
"1980","funny",-1.56343824739056,192,26,166,32.301259707567,159.698740292433
"2000","baby dont",-1.56391989085659,366,88,278,98.4853615197612,267.514638480239
"2000","never knew",-1.56925037834768,135,30,105,36.3265677736824,98.6734322263176
"2000","longer",-1.56951173406275,98,21,77,26.3703973468213,71.6296026531787
"2000","mans",-1.56951173406275,98,21,77,26.3703973468213,71.6296026531787
"1990","fly like",-1.57177244713511,66,10,56,14.0015499313491,51.9984500686509
"1990","smilin",-1.57177244713511,66,10,56,14.0015499313491,51.9984500686509
"1980","keep",-1.57227277530186,2547,405,2142,428.496398308193,2118.50360169181
"1970","plans",-1.57337032793635,95,9,86,13.0005497250943,81.9994502749057
"2010","friends",-1.57542466212884,762,105,657,117.319595671584,644.680404328416
"1990","outta",-1.57788746305764,188,33,155,39.8832028347519,148.116797165248
"2000","simple",-1.57963240222764,131,29,102,35.2502250248326,95.7497749751674
"1980","wanna know",-1.58055082996889,212,29,183,35.6659742604385,176.334025739561
"2010","wild",-1.58200601018898,479,64,415,73.7481447856806,405.251855214319
"2010","lying",-1.58492024559742,92,10,82,14.164570606018,77.835429393982
"1980","watch",-1.5865330072789,697,105,592,117.260302167574,579.739697832426
"1980","doctor",-1.58708126250067,91,11,80,15.3094512155656,75.6905487844344
"1980","repeat",-1.58708126250067,91,11,80,15.3094512155656,75.6905487844344
"2010","yeah yeah yeah",-1.59085033425172,913,127,786,140.567966992331,772.432033007669
"1980","call baby",-1.59210374521222,77,9,68,12.9541510285555,64.0458489714445
"1980","know id",-1.59210374521222,77,9,68,12.9541510285555,64.0458489714445
"2000","finger",-1.59246078106797,94,20,74,25.2940545979715,68.7059454020285
"1980","get together",-1.59267537251795,98,12,86,16.4871013090706,81.5128986909294
"1960","high",-1.5984038325485,790,39,751,47.1813859803704,742.81861401963
"1970","changed",-1.60082306251782,155,16,139,21.2114232356802,133.78857676432
"1970","harder",-1.60082306251782,155,16,139,21.2114232356802,133.78857676432
"2010","beach",-1.60240871357952,130,15,115,20.0151541171993,109.984845882801
"2010","whole world",-1.60240871357952,130,15,115,20.0151541171993,109.984845882801
"2010","saturday",-1.60305059379716,115,13,102,17.7057132575225,97.2942867424775
"2000","west",-1.60311318301622,212,49,163,57.046165689042,154.953834310958
"2000","drum",-1.6052038191936,56,11,45,15.0687984838979,40.9312015161021
"2000","im right",-1.6052038191936,56,11,45,15.0687984838979,40.9312015161021
"2000","nothing left",-1.6052038191936,56,11,45,15.0687984838979,40.9312015161021
"1980","hours",-1.60619019798297,70,8,62,11.7765009350505,58.2234990649496
"1990","rather",-1.61122335160083,178,31,147,37.7617558754566,140.238244124543
"1980","pick",-1.61208920901321,186,25,161,31.2918453417055,154.708154658295
"2010","cant believe",-1.61285359684762,145,17,128,22.3245949768762,122.675405023124
"1960","wonder",-1.61515575299006,493,23,470,29.4435737826869,463.556426217313
"1980","candy",-1.61823105757497,146,19,127,24.5624162359624,121.437583764038
"2000","cause really",-1.61846198523939,34,6,28,9.14891336522372,24.8510866347763
"2000","karma",-1.61846198523939,34,6,28,9.14891336522372,24.8510866347763
"2000","lesson",-1.61846198523939,34,6,28,9.14891336522372,24.8510866347763
"2000","love oh oh",-1.61846198523939,34,6,28,9.14891336522372,24.8510866347763
"2000","mine im",-1.61846198523939,34,6,28,9.14891336522372,24.8510866347763
"2000","need can",-1.61846198523939,34,6,28,9.14891336522372,24.8510866347763
"2000","seas",-1.61846198523939,34,6,28,9.14891336522372,24.8510866347763
"2000","shock",-1.61846198523939,34,6,28,9.14891336522372,24.8510866347763
"2000","vacation",-1.61846198523939,34,6,28,9.14891336522372,24.8510866347763
"1960","real",-1.62252926954174,1354,70,1284,80.8653121739513,1273.13468782605
"2010","slim",-1.62479414672865,61,6,55,9.39172616268583,51.6082738373142
"2010","think",-1.62666211305821,2640,383,2257,406.461591303125,2233.53840869688
"2010","drama",-1.62712530739537,69,7,62,10.6234279545135,58.3765720454865
"2000","cant feel",-1.62795875500787,43,8,35,11.5706845501359,31.4293154498641
"2000","im way",-1.62795875500787,43,8,35,11.5706845501359,31.4293154498641
"2000","like nobody",-1.62795875500787,43,8,35,11.5706845501359,31.4293154498641
"2000","never find another",-1.62795875500787,43,8,35,11.5706845501359,31.4293154498641
"2000","hands",-1.62857618092372,1018,256,762,273.929229582287,744.070770417713
"1980","places",-1.62998656212019,119,15,104,20.0200515895858,98.9799484104142
"2010","couldnt",-1.6365797217878,508,68,440,78.2130637810558,429.786936218944
"1970","age",-1.6387223922349,69,6,63,9.44250453717376,59.5574954628262
"1970","holds",-1.6387223922349,69,6,63,9.44250453717376,59.5574954628262
"1970","say want",-1.6387223922349,69,6,63,9.44250453717376,59.5574954628262
"1970","youll always",-1.6387223922349,69,6,63,9.44250453717376,59.5574954628262
"2010","hot hot",-1.64091998517055,77,8,69,11.8551297463411,65.1448702536589
"2010","lick",-1.64091998517055,77,8,69,11.8551297463411,65.1448702536589
"1970","half",-1.64304582241739,230,25,205,31.4750151239125,198.524984876087
"1990","rings",-1.64484696133898,83,13,70,17.6080097621511,65.3919902378489
"1970","push",-1.6486627401495,164,17,147,22.4430542622681,141.556945737732
"1990","nigga",-1.6490420714679,790,153,637,167.59430978433,622.40569021567
"1970","make right",-1.64994372165182,87,8,79,11.9057665903495,75.0942334096505
"1970","toes",-1.64994372165182,87,8,79,11.9057665903495,75.0942334096505
"1960","though",-1.65014283231255,532,25,507,31.7727814450089,500.227218554991
"1990","wondering",-1.65159150515799,126,21,105,26.730231687121,99.269768312879
"2010","mistake",-1.65817838908206,108,12,96,16.6279741896733,91.3720258103267
"1990","billy",-1.65938480737773,61,9,52,12.9408264517014,48.0591735482986
"1990","looks like",-1.65938480737773,61,9,52,12.9408264517014,48.0591735482986
"1990","oh lord",-1.65938480737773,61,9,52,12.9408264517014,48.0591735482986
"1990","play play",-1.65938480737773,61,9,52,12.9408264517014,48.0591735482986
"1980","keeps",-1.66021848100367,285,40,245,47.9471823784197,237.05281762158
"2010","lil",-1.66185960603919,226,28,198,34.7955756191311,191.204424380869
"1990","lines",-1.66310011209033,94,15,79,19.941601417376,74.058398582624
"2000","learned",-1.66451303719108,148,33,115,39.8246817074444,108.175318292556
"1990","love got",-1.66866885304268,142,24,118,30.1245468219935,111.875453178007
"1970","paid",-1.66973335715547,96,9,87,13.1373976169374,82.8626023830626
"1970","whoa oh oh",-1.66973335715547,96,9,87,13.1373976169374,82.8626023830626
"1990","memories",-1.67135716852536,163,28,135,34.5795854365137,128.420414563486
"2000","post",-1.67167107166094,52,10,42,13.992455735048,38.007544264952
"2000","puttin",-1.67167107166094,52,10,42,13.992455735048,38.007544264952
"2000","shoulders",-1.67167107166094,52,10,42,13.992455735048,38.007544264952
"2000","wrapped",-1.67167107166094,52,10,42,13.992455735048,38.007544264952
"1970","theres something",-1.67170774915641,122,12,110,16.6954428048579,105.304557195142
"1980","building",-1.67331499913398,56,6,50,9.42120074804036,46.5787992519596
"1980","hed",-1.67331499913398,56,6,50,9.42120074804036,46.5787992519596
"1980","screaming",-1.67331499913398,56,6,50,9.42120074804036,46.5787992519596
"1980","time got",-1.67331499913398,56,6,50,9.42120074804036,46.5787992519596
"2000","last night",-1.67386707023751,144,32,112,38.7483389585946,105.251661041405
"1990","go dont let",-1.67631759487795,44,6,38,9.33436662089939,34.6656333791006
"1990","id love",-1.67631759487795,44,6,38,9.33436662089939,34.6656333791006
"1990","inspiration",-1.67631759487795,44,6,38,9.33436662089939,34.6656333791006
"1990","oh ooh",-1.67631759487795,44,6,38,9.33436662089939,34.6656333791006
"2000","baby thats",-1.67828631560059,65,13,52,17.49056966881,47.50943033119
"2000","drove",-1.67828631560059,65,13,52,17.49056966881,47.50943033119
"2000","forgive",-1.679982067883,82,17,65,22.0650263514219,59.9349736485781
"2010","know ill",-1.6828074362745,168,20,148,25.8657376283807,142.134262371619
"1990","standing",-1.68405600470825,307,56,251,65.1284216503662,241.871578349634
"1990","hood",-1.6875791018264,184,32,152,39.0346240510338,144.965375948966
"2010","everythings",-1.69048075672377,93,10,83,14.3185333299964,78.6814666700036
"2010","hotel",-1.69048075672377,93,10,83,14.3185333299964,78.6814666700036
"1990","im back",-1.69099375032249,105,17,88,22.2751930726008,82.7248069273992
"2010","yesterday",-1.69258568416916,131,15,116,20.1691168411778,110.830883158822
"1990","one one",-1.69463882935219,158,27,131,33.518861956866,124.481138043134
"1960","talking",-1.69714467095379,323,14,309,19.2906173058983,303.709382694102
"1970","thats",-1.69872579916411,2727,350,2377,373.184201056128,2353.81579894387
"2010","know can",-1.70150319846255,241,30,211,37.105016478808,203.894983521192
"2000","everywhere",-1.70346518327177,237,55,182,63.7733078693536,173.226692130646
"2000","glad",-1.70464460229077,217,50,167,58.3915941251043,158.608405874896
"1990","can find",-1.71147919308352,78,12,66,16.5472862825035,61.4527137174965
"1970","hurts",-1.71181521449916,148,15,133,20.2534879927785,127.746512007221
"1960","whatever",-1.71352465625506,343,15,328,20.4850827737558,322.514917226244
"1980","around world",-1.71362388717481,78,9,69,13.1223867561991,64.8776132438009
"1990","away oh",-1.71637682427612,50,7,43,10.6072347964766,39.3927652035234
"1990","man can",-1.71637682427612,50,7,43,10.6072347964766,39.3927652035234
"1990","tired",-1.71691670458706,282,51,231,59.8248042521279,222.175195747872
"1960","save",-1.71902840938215,304,13,291,18.1558751114337,285.844124888566
"1990","love feel",-1.71930084294389,89,14,75,18.8808779377283,70.1191220622717
"1970","gonna get",-1.72203779227214,272,30,242,37.2226265813226,234.777373418677
"1990","believe believe",-1.72272422755848,67,10,57,14.2136946272786,52.7863053727214
"1990","bad",-1.72532668770518,1258,248,1010,266.878027479351,991.121972520649
"1990","hes",-1.72754885518118,841,163,678,178.413689276736,662.586310723264
"1970","found",-1.7299342770244,723,87,636,98.9410258025598,624.05897419744
"2000","againi",-1.73156610917052,39,7,32,10.494341801286,28.505658198714
"2000","away know",-1.73156610917052,39,7,32,10.494341801286,28.505658198714
"2000","fortune",-1.73156610917052,39,7,32,10.494341801286,28.505658198714
"2000","kiss kiss",-1.73156610917052,39,7,32,10.494341801286,28.505658198714
"2000","mind dont",-1.73156610917052,39,7,32,10.494341801286,28.505658198714
"1980","cause know",-1.73194501977043,214,29,185,36.0024457157257,177.997554284274
"1980","heads",-1.73370573436851,71,8,63,11.944736662694,59.055263337306
"1980","never meant",-1.73370573436851,71,8,63,11.944736662694,59.055263337306
"2000","looks like",-1.73393366398261,61,12,49,16.4142269199602,44.5857730800398
"2000","store",-1.73393366398261,61,12,49,16.4142269199602,44.5857730800398
"2000","love like",-1.7348143505818,301,71,230,80.9947918509511,220.005208149049
"2000","baby cant",-1.73751926172364,124,27,97,33.3666252143453,90.6333747856547
"2010","dont leave",-1.74091960446112,124,14,110,19.0913777733286,104.908622226671
"1980","lovin",-1.74239859539275,625,93,532,105.147329777236,519.852670222764
"1960","hell",-1.74284206170629,402,18,384,24.0087559039353,377.991244096065
"1990","okay",-1.7452248691153,226,40,186,47.9447012800741,178.055298719926
"2000","mei",-1.7458822164453,169,38,131,45.4754811389061,123.524518861094
"1970","now just",-1.74596217267837,79,7,72,10.8109834556047,68.1890165443953
"1970","want make",-1.74596217267837,79,7,72,10.8109834556047,68.1890165443953
"1990","miles",-1.7489324300914,169,29,140,35.8524536120908,133.147546387909
"2010","difference",-1.7491845523595,70,7,63,10.7773906784919,59.2226093215081
"2010","london",-1.7491845523595,70,7,63,10.7773906784919,59.2226093215081
"2000","good enough",-1.75141665926053,48,9,39,12.9161129861982,35.0838870138018
"2000","rude",-1.75141665926053,48,9,39,12.9161129861982,35.0838870138018
"2000","want body",-1.75141665926053,48,9,39,12.9161129861982,35.0838870138018
"2000","well get",-1.75141665926053,48,9,39,12.9161129861982,35.0838870138018
"1970","crime",-1.75247398109795,70,6,64,9.57935242901686,60.4206475709831
"1970","just know",-1.75247398109795,70,6,64,9.57935242901686,60.4206475709831
"1970","just might",-1.75247398109795,70,6,64,9.57935242901686,60.4206475709831
"1970","wont give",-1.75247398109795,70,6,64,9.57935242901686,60.4206475709831
"1970","youre looking",-1.75247398109795,70,6,64,9.57935242901686,60.4206475709831
"2010","call call",-1.75386453475699,62,6,56,9.54568888666429,52.4543111133357
"2010","hurting",-1.75386453475699,62,6,56,9.54568888666429,52.4543111133357
"2010","need say",-1.75386453475699,62,6,56,9.54568888666429,52.4543111133357
"2010","snap",-1.75386453475699,62,6,56,9.54568888666429,52.4543111133357
"1970","ya ya",-1.75661949772,157,16,141,21.4851190193664,135.514880980634
"2010","can find",-1.75739795726086,78,8,70,12.0090924703196,65.9909075296804
"2010","come go",-1.75739795726086,78,8,70,12.0090924703196,65.9909075296804
"2010","rules",-1.75814590750271,109,12,97,16.7819369136517,92.2180630863483
"2000","feel right",-1.75922027021673,74,15,59,19.9123408537222,54.0876591462778
"2000","gonna miss",-1.75922027021673,74,15,59,19.9123408537222,54.0876591462778
"1990","nothing left",-1.76507940329513,56,8,48,11.8801029720538,44.1198970279462
"1990","problem",-1.76540817564922,127,21,106,26.9423763830505,100.057623616949
"1980","got got got",-1.76650728964739,64,7,57,10.767086569189,53.232913430811
"1990","oh love",-1.76870027768304,111,18,93,23.548061248178,87.451938751822
"1960","outside",-1.77071474217756,205,8,197,12.2432710455392,192.756728954461
"2000","gas",-1.77384027037399,91,19,72,24.4867975363341,66.5132024636659
"2010","anything",-1.77601154547888,636,86,550,97.9202924502982,538.079707549702
"1980","wrong",-1.78032213877249,946,144,802,159.150998350825,786.849001649175
"1980","got love",-1.78043847106537,168,22,146,28.2636022441211,139.736397755879
"1990","almost",-1.78348989229279,185,32,153,39.2467687469634,145.753231253037
"1990","summertime",-1.7886518933457,73,11,62,15.4865628028558,57.5134371971442
"1960","told",-1.78914458874109,780,38,742,46.5841532464417,733.415846753558
"1990","wanna dance",-1.79429229330257,95,15,80,20.1537461133055,74.8462538866945
"1970","wed",-1.7953948183271,191,20,171,26.1379473420317,164.862052657968
"1960","wrong",-1.79571901763219,946,47,899,56.4982166296587,889.501783370341
"2010","went",-1.79900673657248,378,49,329,58.1979096638565,319.802090336144
"2000","hollywood",-1.79905113660348,57,11,46,15.3378841711103,41.6621158288897
"2000","just tell",-1.79905113660348,57,11,46,15.3378841711103,41.6621158288897
"2000","way say",-1.79905113660348,57,11,46,15.3378841711103,41.6621158288897
"1960","just let",-1.80097170959333,164,6,158,9.79461683643133,154.205383163569
"1960","doubt",-1.80135595278737,185,7,178,11.0488055776817,173.951194422318
"1960","story",-1.80135595278737,185,7,178,11.0488055776817,173.951194422318
"1990","feel way",-1.80428291495106,180,31,149,38.1860452673157,141.813954732684
"2000","go go",-1.80682630785326,266,62,204,71.576792798515,194.423207201485
"2000","faded",-1.80738526295448,70,14,56,18.8359981048724,51.1640018951276
"2000","give time",-1.80738526295448,70,14,56,18.8359981048724,51.1640018951276
"2000","see dont",-1.80738526295448,70,14,56,18.8359981048724,51.1640018951276
"2000","youre looking",-1.80738526295448,70,14,56,18.8359981048724,51.1640018951276
"1990","king",-1.80888593422066,138,23,115,29.2759680382754,108.724031961725
"1980","letting",-1.8126332060934,100,12,88,16.8235727643578,83.1764272356422
"2000","grow",-1.81371681611276,210,48,162,56.5079943146171,153.492005685383
"2000","inside",-1.8147182794216,991,248,743,266.66391602755,724.33608397245
"1990","dont let",-1.8154996391567,324,59,265,68.7348814811682,255.265118518832
"1980","cause just",-1.81718623299888,57,6,51,9.58943647568394,47.4105635243161
"1980","just tell",-1.81718623299888,57,6,51,9.58943647568394,47.4105635243161
"1980","never will",-1.81718623299888,57,6,51,9.58943647568394,47.4105635243161
"1970","loose",-1.81827341739502,115,11,104,15.7375075619563,99.2624924380437
"1990","belong belong",-1.81981025550944,62,9,53,13.152971147631,48.847028852369
"1990","drinking",-1.81981025550944,62,9,53,13.152971147631,48.847028852369
"1990","much time",-1.81981025550944,62,9,53,13.152971147631,48.847028852369
"1990","ohi",-1.81981025550944,62,9,53,13.152971147631,48.847028852369
"1980","changed",-1.82293586462455,155,20,135,26.0765377847546,128.923462215245
"2000","will always",-1.82620010267324,137,30,107,36.8647391481073,100.135260851893
"2010","see can",-1.82757526435086,102,11,91,15.7041978458025,86.2958021541975
"1980","late night",-1.83848882305048,79,9,70,13.2906224838427,65.7093775161573
"1980","noise",-1.83848882305048,79,9,70,13.2906224838427,65.7093775161573
"2000","editor",-1.84171895462135,104,22,82,27.9849114700961,76.0150885299039
"2000","monday",-1.84539667658456,83,17,66,22.3341120386344,60.6658879613656
"2000","cant get",-1.84620794614171,330,78,252,88.7982767801126,241.201723219887
"2000","im gonna get",-1.84839827497214,44,8,36,11.8397702373483,32.1602297626517
"2000","wont make",-1.84839827497214,44,8,36,11.8397702373483,32.1602297626517
"1960","stay",-1.8497186013983,1204,61,1143,71.9068211650202,1132.09317883498
"1970","stand",-1.84979330335637,804,97,707,110.025705041851,693.974294958149
"1990","say",-1.84991844334026,4757,971,3786,1009.17231853678,3747.82768146322
"1970","hits",-1.8559472806465,80,7,73,10.9478313474478,69.0521686525522
"1990","dont care",-1.85660362955133,355,65,290,75.3113670549837,279.688632945016
"1990","soon",-1.85823294046316,294,53,241,62.3705406032823,231.629459396718
"2010","dont know im",-1.86038346661113,110,12,98,16.9358996376302,93.0641003623698
"2010","hour",-1.86038346661113,110,12,98,16.9358996376302,93.0641003623698
"2010","make lose",-1.86038346661113,110,12,98,16.9358996376302,93.0641003623698
"2000","baby wanna",-1.86271964914565,66,13,53,17.7596553560225,48.2403446439775
"2000","beneath",-1.86271964914565,66,13,53,17.7596553560225,48.2403446439775
"2000","love baby love",-1.86271964914565,66,13,53,17.7596553560225,48.2403446439775
"2000","crowded",-1.8632370148274,35,6,29,9.41799905243618,25.5820009475638
"2000","just watch",-1.8632370148274,35,6,29,9.41799905243618,25.5820009475638
"2000","kicked",-1.8632370148274,35,6,29,9.41799905243618,25.5820009475638
"2000","maybe ill",-1.8632370148274,35,6,29,9.41799905243618,25.5820009475638
"2000","now hes",-1.8632370148274,35,6,29,9.41799905243618,25.5820009475638
"2000","now will",-1.8632370148274,35,6,29,9.41799905243618,25.5820009475638
"2000","one way",-1.8632370148274,35,6,29,9.41799905243618,25.5820009475638
"2000","shade",-1.8632370148274,35,6,29,9.41799905243618,25.5820009475638
"2000","stay dont",-1.8632370148274,35,6,29,9.41799905243618,25.5820009475638
"2000","us can",-1.8632370148274,35,6,29,9.41799905243618,25.5820009475638
"2000","whyd",-1.8632370148274,35,6,29,9.41799905243618,25.5820009475638
"2000","yeah yeah oh",-1.8632370148274,35,6,29,9.41799905243618,25.5820009475638
"1990","aint got time",-1.8635232197859,45,6,39,9.54651131682892,35.4534886831711
"1990","company",-1.8635232197859,45,6,39,9.54651131682892,35.4534886831711
"1990","im comin",-1.8635232197859,45,6,39,9.54651131682892,35.4534886831711
"1990","im proud",-1.8635232197859,45,6,39,9.54651131682892,35.4534886831711
"1990","ive done",-1.8635232197859,45,6,39,9.54651131682892,35.4534886831711
"1990","wait minute",-1.8635232197859,45,6,39,9.54651131682892,35.4534886831711
"2010","every night",-1.86729346870739,185,22,163,28.4831039360144,156.516896063986
"1970","want get",-1.86887885926452,98,9,89,13.4110934006236,84.5889065993764
"1970","never meant",-1.86890444118287,71,6,65,9.71620032085995,61.2837996791401
"1970","test",-1.86890444118287,71,6,65,9.71620032085995,61.2837996791401
"1990","woke",-1.86972415053736,101,16,85,21.4266142888827,79.5733857111173
"2010","baby aint",-1.87441876181863,71,7,64,10.9313534024704,60.0686465975296
"2010","just say",-1.87441876181863,71,7,64,10.9313534024704,60.0686465975296
"2010","wanna tell",-1.87441876181863,71,7,64,10.9313534024704,60.0686465975296
"2000","aint good",-1.87595507199182,53,10,43,14.2615414222605,38.7384585777395
"2000","decide",-1.87595507199182,53,10,43,14.2615414222605,38.7384585777395
"2000","good baby",-1.87595507199182,53,10,43,14.2615414222605,38.7384585777395
"2010","jesus",-1.87680660171511,79,8,71,12.163055194298,66.8369448057019
"2010","noise",-1.87680660171511,79,8,71,12.163055194298,66.8369448057019
"2010","waited",-1.87680660171511,79,8,71,12.163055194298,66.8369448057019
"1980","hurry",-1.87747510970361,142,18,124,23.8894733253881,118.110526674612
"1990","dont",-1.87763645382786,11587,2398,9189,2458.12059173548,9128.87940826452
"1990","anything want",-1.87891367276596,68,10,58,14.4258393232082,53.5741606767919
"1990","look around",-1.87891367276596,68,10,58,14.4258393232082,53.5741606767919
"1990","wouldnt",-1.87915394658749,421,78,343,89.3129169863328,331.687083013667
"1980","happy",-1.87997462083607,520,76,444,87.4825783746605,432.51742162534
"1970","ride",-1.87997577443756,898,109,789,122.889406875102,775.110593124898
"1960","oh baby",-1.8838865170215,387,17,370,23.1129068030422,363.887093196958
"2010","listening",-1.88639164352805,63,6,57,9.69965161064275,53.3003483893573
"2010","shop",-1.88639164352805,63,6,57,9.69965161064275,53.3003483893573
"2000","foot",-1.88810678044515,79,16,63,21.2577692897845,57.7422307102155
"2010","oh just",-1.88934233437828,87,9,78,13.3947569861257,73.6052430138743
"2010","oh night",-1.88934233437828,87,9,78,13.3947569861257,73.6052430138743
"2010","see youre",-1.88934233437828,87,9,78,13.3947569861257,73.6052430138743
"2010","every",-1.89215675214584,2061,295,1766,317.317174119598,1743.6828258804
"2010","little love",-1.89623951966882,118,13,105,18.1676014294578,99.8323985705422
"1980","cant stop",-1.90047996281997,236,32,204,39.7036317238844,196.296368276116
"1980","tired",-1.90065048677497,282,39,243,47.442475195489,234.557524804511
"1980","drove",-1.90515397309876,65,7,58,10.9353222968326,54.0646777031674
"2000","afraid",-1.90615514330288,239,55,184,64.3114792437785,174.688520756222
"1980","place",-1.90654186161369,943,143,800,158.646291167894,784.353708832106
"2010","boss",-1.9093172236668,95,10,85,14.6264587779533,80.3735412220467
"2010","run away",-1.9093172236668,95,10,85,14.6264587779533,80.3735412220467
"1960","dark",-1.90937149093425,329,14,315,19.6489569462555,309.351043053744
"2000","seem",-1.91265214657376,295,69,226,79.3802777276764,215.619722272324
"1970","special",-1.918181497976,201,21,180,27.5064262604627,173.493573739537
"2010","hello",-1.92289045629549,156,18,138,24.0181849406392,131.981815059361
"1990","killing",-1.92602482466737,85,13,72,18.0322991540102,66.9677008459898
"2000","love good",-1.92671076605233,62,12,50,16.6833126071727,45.3166873928273
"1980","go ahead",-1.9267328755341,101,12,89,16.9918084920014,84.0081915079986
"1980","loose",-1.93010946235485,115,14,101,19.3471086790115,95.6528913209885
"1980","saturday",-1.93010946235485,115,14,101,19.3471086790115,95.6528913209885
"2000","kill",-1.93029905422313,146,32,114,39.2865103330195,106.71348966698
"2000","looked",-1.93144182655959,203,46,157,54.6243945041298,148.37560549587
"2000","somebody",-1.93181166372163,672,165,507,180.825581806775,491.174418193225
"2010","theyre",-1.9322465534279,472,62,410,72.6704057178314,399.329594282169
"2000","friday",-1.93524763931434,92,19,73,24.7558832235465,67.2441167764535
"2000","pour",-1.93524763931434,92,19,73,24.7558832235465,67.2441167764535
"2000","say youre",-1.93524763931434,92,19,73,24.7558832235465,67.2441167764535
"2000","baby want",-1.9364842103084,75,15,60,20.1814265409347,54.8185734590653
"2000","danced",-1.9364842103084,75,15,60,20.1814265409347,54.8185734590653
"1990","get girl",-1.93659806069964,57,8,49,12.0922476679833,44.9077523320167
"1990","love aint",-1.93659806069964,57,8,49,12.0922476679833,44.9077523320167
"1990","shows",-1.93659806069964,57,8,49,12.0922476679833,44.9077523320167
"1960","huh",-1.93789698752464,618,29,589,36.9089829567961,581.091017043204
"1960","outta",-1.94130096416179,188,7,181,11.2279753978603,176.77202460214
"1990","live",-1.95544127121327,1210,237,973,256.695082074733,953.304917925267
"1980","green",-1.95939126801577,170,22,148,28.6000736994082,141.399926300592
"2000","wear",-1.96171438875171,183,41,142,49.2426807598806,133.757319240119
"1970","night oh",-1.96439765958976,90,8,82,12.3163102658788,77.6836897341212
"2010","yeah know",-1.96484747453205,111,12,99,17.0898623616086,93.9101376383913
"1960","half",-1.96490448612545,230,9,221,13.736352880361,216.263647119639
"1980","gonna gonna",-1.96518614694049,58,6,52,9.75767220332752,48.2423277966725
"1980","gonna good",-1.96518614694049,58,6,52,9.75767220332752,48.2423277966725
"1980","know im gonna",-1.96518614694049,58,6,52,9.75767220332752,48.2423277966725
"1980","bound",-1.96660902757562,80,9,71,13.4588582114862,66.5411417885138
"1980","movie",-1.96660902757562,80,9,71,13.4588582114862,66.5411417885138
"1980","now get",-1.96660902757562,80,9,71,13.4588582114862,66.5411417885138
"2010","love know",-1.96713459729052,149,17,132,22.94044587279,126.05955412721
"2000","afternoon",-1.96779051312304,49,9,40,13.1851986734107,35.8148013265894
"2000","things make",-1.96779051312304,49,9,40,13.1851986734107,35.8148013265894
"2000","wanna show",-1.96779051312304,49,9,40,13.1851986734107,35.8148013265894
"1970","bite",-1.96832985473115,81,7,74,11.0846792392909,69.9153207607091
"1970","bodys",-1.96832985473115,81,7,74,11.0846792392909,69.9153207607091
"2000","painted",-1.96833754631714,40,7,33,10.7634274884985,29.2365725115015
"2000","southern",-1.96833754631714,40,7,33,10.7634274884985,29.2365725115015
"2000","still cant",-1.96833754631714,40,7,33,10.7634274884985,29.2365725115015
"2000","time right",-1.96833754631714,40,7,33,10.7634274884985,29.2365725115015
"2000","upi",-1.96833754631714,40,7,33,10.7634274884985,29.2365725115015
"2000","want let",-1.96833754631714,40,7,33,10.7634274884985,29.2365725115015
"2010","finally",-1.97108256478019,201,24,177,30.9465075196697,170.05349248033
"1970","steal",-1.97156989582131,99,9,90,13.5479412924667,85.4520587075333
"1970","every night",-1.9731747495794,185,19,166,25.3168599909731,159.683140009027
"1970","anyone",-1.97371769648228,134,13,121,18.3376175069751,115.662382493025
"1970","cant let",-1.97371769648228,134,13,121,18.3376175069751,115.662382493025
"2000","letter",-1.9738189311639,88,18,70,23.6795404746967,64.3204595253033
"1960","phone",-1.97639075078019,311,13,298,18.5739380251838,292.426061974816
"1970","needs",-1.97705121715524,235,25,210,32.159254583128,202.840745416872
"1970","think im",-1.97705121715524,235,25,210,32.159254583128,202.840745416872
"1990","bigger",-1.98571432870705,63,9,54,13.3651158435605,49.6348841564395
"1990","state",-1.98571432870705,63,9,54,13.3651158435605,49.6348841564395
"1970","im hot",-1.98689986159985,108,10,98,14.7795723190546,93.2204276809454
"1970","asleep",-1.9879354004397,72,6,66,9.85304821270305,62.146951787297
"2000","yeah thats",-1.99154987134386,71,14,57,19.1050837920848,51.8949162079152
"1960","livin",-1.99175184688267,351,15,336,20.9628689608988,330.037131039101
"1970","lets go",-1.99239248203756,202,21,181,27.6432741523058,174.356725847694
"1990","gas",-1.9967257252641,91,14,77,19.3051673295874,71.6948326704126
"1980","taste",-1.99873338722336,224,30,194,37.6848029921615,186.315197007839
"1960","got love",-1.99909359148427,168,6,162,10.0335099300028,157.966490069997
"1980","can love",-1.99936424687051,73,8,65,12.2812081179812,60.7187918820188
"1980","time get",-1.99936424687051,73,8,65,12.2812081179812,60.7187918820188
"2010","baby can",-2.00037913459454,194,23,171,29.8687684518205,164.131231548179
"2000","find somebody",-2.00129062065025,58,11,47,15.6069698583228,42.3930301416772
"2000","go can",-2.00129062065025,58,11,47,15.6069698583228,42.3930301416772
"2000","go cant",-2.00129062065025,58,11,47,15.6069698583228,42.3930301416772
"2000","now come",-2.00129062065025,58,11,47,15.6069698583228,42.3930301416772
"2010","choice",-2.00273429747908,72,7,65,11.0853161264489,60.9146838735512
"2010","love much",-2.00273429747908,72,7,65,11.0853161264489,60.9146838735512
"2010","tell baby",-2.00273429747908,72,7,65,11.0853161264489,60.9146838735512
"2010","underneath",-2.00273429747908,72,7,65,11.0853161264489,60.9146838735512
"1990","workin",-2.00351765525262,102,16,86,21.6387589848122,80.3612410151878
"1970","love like",-2.0046583332498,301,33,268,41.1912154447725,259.808784555228
"1970","now know",-2.00604597152136,177,18,159,24.2220768562283,152.777923143772
"1990","shadows",-2.00617988634637,80,12,68,16.9715756743625,63.0284243256375
"1990","twenty",-2.00617988634637,80,12,68,16.9715756743625,63.0284243256375
"1990","found",-2.00824625613528,723,138,585,153.380615157051,569.619384842949
"2000","think youre",-2.00914510555876,163,36,127,43.8609670156314,119.139032984369
"1980","piece",-2.01094754795316,157,20,137,26.4130092400417,130.586990759958
"1980","home",-2.01107611811691,1475,228,1247,248.147698274277,1226.85230172572
"1980","break",-2.01400584385923,977,148,829,164.366305907776,812.633694092224
"2000","silly",-2.01701850658832,84,17,67,22.6031977258468,61.3968022741532
"1960","gonna get",-2.01907323156148,272,11,261,16.2447303628617,255.755269637138
"1970","baby can",-2.02017250825475,194,20,174,26.548491017561,167.451508982439
"2010","cant change",-2.02226090677991,64,6,58,9.8536143346212,54.1463856653788
"2010","get ya",-2.02226090677991,64,6,58,9.8536143346212,54.1463856653788
"2010","hole",-2.02226090677991,64,6,58,9.8536143346212,54.1463856653788
"2010","minds",-2.02226090677991,64,6,58,9.8536143346212,54.1463856653788
"2010","never love",-2.02226090677991,64,6,58,9.8536143346212,54.1463856653788
"2010","ya know",-2.02226090677991,64,6,58,9.8536143346212,54.1463856653788
"1970","dirty",-2.02846220038834,244,26,218,33.3908856097159,210.609114390284
"1980","gun",-2.03120457388824,191,25,166,32.1330239799234,158.866976020077
"1980","feels",-2.03322512852689,446,64,382,75.0331345290357,370.966865470964
"1960","like way",-2.03900491463993,211,8,203,12.6016106858964,198.398389314104
"1980","got one",-2.03940675195959,109,13,96,18.33769431315,90.66230568685
"1990","oh got",-2.04017476030757,69,10,59,14.6379840191377,54.3620159808623
"1990","thought id",-2.04017476030757,69,10,59,14.6379840191377,54.3620159808623
"1990","youve gone",-2.04017476030757,69,10,59,14.6379840191377,54.3620159808623
"2000","anyway",-2.04059585080574,122,26,96,32.8284538399204,89.1715461600796
"2010","mama",-2.04347286756792,460,60,400,70.8228530300899,389.17714696991
"1980","dont think",-2.0443577429162,284,39,245,47.7789466507761,236.221053349224
"2010","let go let go",-2.04456512879714,104,11,93,16.0121232937595,87.9878767062406
"1970","cut",-2.04692901503185,236,25,211,32.2961024749711,203.703897525029
"1990","dont say",-2.04793075414631,124,20,104,26.3059422952619,97.6940577047381
"1970","theres nothing",-2.05138371671912,186,19,167,25.4537078828162,160.546292117184
"1980","way feel",-2.05150208836418,171,22,149,28.7683094270518,142.231690572948
"2000","disguise",-2.054586881205,67,13,54,18.028741043235,48.971258956765
"2000","know way",-2.054586881205,67,13,54,18.028741043235,48.971258956765
"2000","show love",-2.054586881205,67,13,54,18.028741043235,48.971258956765
"2000","youre alone",-2.054586881205,67,13,54,18.028741043235,48.971258956765
"1990","aint right",-2.05756841364304,46,6,40,9.75865601275846,36.2413439872415
"1990","back around",-2.05756841364304,46,6,40,9.75865601275846,36.2413439872415
"1990","hey now",-2.05756841364304,46,6,40,9.75865601275846,36.2413439872415
"1990","see got",-2.05756841364304,46,6,40,9.75865601275846,36.2413439872415
"1990","sink",-2.05756841364304,46,6,40,9.75865601275846,36.2413439872415
"1990","take slow",-2.05756841364304,46,6,40,9.75865601275846,36.2413439872415
"1990","theres way",-2.05756841364304,46,6,40,9.75865601275846,36.2413439872415
"1990","thing know",-2.05756841364304,46,6,40,9.75865601275846,36.2413439872415
"1990","want leave",-2.05756841364304,46,6,40,9.75865601275846,36.2413439872415
"1990","now dont",-2.06092895555851,172,29,143,36.4888876998794,135.511112300121
"1990","write",-2.06092895555851,172,29,143,36.4888876998794,135.511112300121
"1990","dont stop",-2.06328460278986,317,57,260,67.2498686096615,249.750131390338
"2010","need love",-2.067903320104,180,21,159,27.7132903161221,152.286709683878
"1980","dont wanna",-2.06991601617149,771,115,656,129.709746013199,641.290253986801
"1980","chains",-2.07095027062368,88,10,78,14.8047440326349,73.1952559673651
"2010","nasty",-2.07149558444931,112,12,100,17.2438250855871,94.7561749144129
"1980","say goodbye",-2.07340030873864,178,23,155,29.9459595205569,148.054040479443
"2000","lead",-2.07417913351254,188,42,146,50.5881091959429,137.411890804057
"1970","go now",-2.07628124811745,100,9,91,13.6847891843098,86.3152108156902
"1970","youre never",-2.07628124811745,100,9,91,13.6847891843098,86.3152108156902
"2000","get next",-2.07894203782696,45,8,37,12.1088559245608,32.8911440754392
"2000","matter say",-2.07894203782696,45,8,37,12.1088559245608,32.8911440754392
"2000","shades",-2.07894203782696,45,8,37,12.1088559245608,32.8911440754392
"1990","sheets",-2.07950808534994,52,7,45,11.0315241883356,40.9684758116644
"1990","steppin",-2.07950808534994,52,7,45,11.0315241883356,40.9684758116644
"2010","trust",-2.07991989799661,239,29,210,36.7970910308511,202.202908969149
"1970","forgive",-2.0830482932048,82,7,75,11.221527131134,70.778472868866
"1970","showed",-2.0830482932048,82,7,75,11.221527131134,70.778472868866
"1970","gotta gotta",-2.08783979834132,109,10,99,14.9164202108977,94.0835797891023
"1970","whisper",-2.08783979834132,109,10,99,14.9164202108977,94.0835797891023
"2000","cant tell",-2.08901680527962,54,10,44,14.530627109473,39.469372890527
"2000","now wanna",-2.08901680527962,54,10,44,14.530627109473,39.469372890527
"2000","oh know",-2.08901680527962,54,10,44,14.530627109473,39.469372890527
"2000","one youre",-2.08901680527962,54,10,44,14.530627109473,39.469372890527
"2000","talks",-2.08901680527962,54,10,44,14.530627109473,39.469372890527
"1980","doubt",-2.09621087998445,185,24,161,31.1236096140619,153.876390385938
"2010","one else",-2.10225710306429,120,13,107,18.4755268774148,101.524473122585
"1970","exactly",-2.10949187863453,73,6,67,9.98989610454615,63.0101038954538
"1970","just hold",-2.10949187863453,73,6,67,9.98989610454615,63.0101038954538
"1970","oh cant",-2.10949187863453,73,6,67,9.98989610454615,63.0101038954538
"1990","gentle",-2.11384635894955,58,8,50,12.3043923639128,45.6956076360872
"1990","gotta make",-2.11384635894955,58,8,50,12.3043923639128,45.6956076360872
"1990","grill",-2.11384635894955,58,8,50,12.3043923639128,45.6956076360872
"1990","night can",-2.11384635894955,58,8,50,12.3043923639128,45.6956076360872
"2000","broken",-2.11536706780512,329,77,252,88.5291910929001,240.4708089071
"1980","mistakes",-2.117165503107,59,6,53,9.9259079309711,49.0740920690289
"1970","know just",-2.11781091974746,237,25,212,32.4329503668142,204.567049633186
"2000","baby cant see",-2.11984060130417,36,6,30,9.68708473964864,26.3129152603514
"2000","dont know can",-2.11984060130417,36,6,30,9.68708473964864,26.3129152603514
"2000","due",-2.11984060130417,36,6,30,9.68708473964864,26.3129152603514
"2000","ill hold",-2.11984060130417,36,6,30,9.68708473964864,26.3129152603514
"2000","love ever",-2.11984060130417,36,6,30,9.68708473964864,26.3129152603514
"2000","theres place",-2.11984060130417,36,6,30,9.68708473964864,26.3129152603514
"2000","want im",-2.11984060130417,36,6,30,9.68708473964864,26.3129152603514
"2010","know feel",-2.12410753778934,81,8,73,12.470980642255,68.529019357745
"1990","sent",-2.12536637344293,130,21,109,27.5788104708391,102.421189529161
"2010","flowers",-2.12653318762134,89,9,80,13.7026824340826,75.2973175659174
"2010","well im",-2.12653318762134,89,9,80,13.7026824340826,75.2973175659174
"2000","state",-2.12723107192113,63,12,51,16.9523982943851,46.0476017056149
"2010","looked",-2.13390870883935,203,24,179,31.2544329676266,171.745567032373
"2010","fever",-2.13404160689214,73,7,66,11.2392788504273,61.7607211495727
"1980","can keep",-2.13730213097415,74,8,66,12.4494438456248,61.5505561543752
"1980","doors",-2.13730213097415,74,8,66,12.4494438456248,61.5505561543752
"1980","tall",-2.13730213097415,74,8,66,12.4494438456248,61.5505561543752
"1990","bang bang",-2.1409593407558,103,16,87,21.8509036807418,81.1490963192582
"1990","want go",-2.1409593407558,103,16,87,21.8509036807418,81.1490963192582
"1990","tender",-2.14148139293898,92,14,78,19.5173120255169,72.4826879744831
"1980","need know",-2.14533985517621,172,22,150,28.9365451546954,143.063454845305
"2010","walked",-2.15539667391937,218,26,192,33.5638738273035,184.436126172697
"1990","heard",-2.15543074167884,586,110,476,124.316791814706,461.683208185294
"1990","can handle",-2.15691019115495,64,9,55,13.57726053949,50.42273946051
"1990","dont even know",-2.15691019115495,64,9,55,13.57726053949,50.42273946051
"1990","get ya",-2.15691019115495,64,9,55,13.57726053949,50.42273946051
"1990","minds",-2.15691019115495,64,9,55,13.57726053949,50.42273946051
"1990","theres just",-2.15691019115495,64,9,55,13.57726053949,50.42273946051
"1960","dont need",-2.1579292788306,395,17,378,23.5906929901852,371.409307009815
"1980","today",-2.15873953114112,377,53,324,63.4248693216289,313.575130678371
"1980","anybody",-2.1594096149652,131,16,115,22.0388803213087,108.961119678691
"2010","get home",-2.16136336558614,65,6,59,10.0075770585997,54.9924229414003
"2010","hung",-2.16136336558614,65,6,59,10.0075770585997,54.9924229414003
"2010","know say",-2.16136336558614,65,6,59,10.0075770585997,54.9924229414003
"1980","okay",-2.16315046820007,226,30,196,38.0212744474486,187.978725552551
"1980","brown",-2.16768102963317,138,17,121,23.2165304148138,114.783469585186
"1990","dem",-2.16778024683991,241,42,199,51.1268717190171,189.873128280983
"1980","pray",-2.16916271794046,206,27,179,34.6565598945771,171.343440105423
"2010","cross",-2.17246172895346,136,15,121,20.9389304610701,115.06106953893
"2010","held",-2.17246172895346,136,15,121,20.9389304610701,115.06106953893
"1990","satisfied",-2.17457287081716,125,20,105,26.5180869911915,98.4819130088085
"1970","win",-2.17597132653,196,20,176,26.8221868012472,169.177813198753
"1980","dont get",-2.17850308572908,145,18,127,24.3941805083188,120.605819491681
"1970","making love",-2.18297073140472,101,9,92,13.8216370761529,87.1783629238471
"1990","damn",-2.18375875692344,486,90,396,103.102322221752,382.897677778248
"2000","family",-2.18434193327322,152,33,119,40.9010244562943,111.098975543706
"1970","friday",-2.1849631896465,92,8,84,12.590006049565,79.409993950435
"1970","love yeah",-2.19063321757924,110,10,100,15.0532681027408,94.9467318972592
"2000","saw",-2.19234326240927,425,101,324,114.361417065296,310.638582934704
"1980","arm",-2.19347112361016,67,7,60,11.2717937521197,55.7282062478803
"2000","hands air",-2.19468210501616,85,17,68,22.8722834130593,62.1277165869407
"2000","least",-2.19468210501616,85,17,68,22.8722834130593,62.1277165869407
"1970","built",-2.20004334002947,83,7,76,11.3583750229771,71.6416249770229
"1990","cross",-2.20290976398896,136,22,114,28.8516786464163,107.148321353584
"1970","places",-2.20562440441105,119,11,108,16.2848991293287,102.715100870671
"1990","believing",-2.20634925411892,70,10,60,14.8501287150672,55.1498712849328
"1990","give time",-2.20634925411892,70,10,60,14.8501287150672,55.1498712849328
"1990","shots",-2.20634925411892,70,10,60,14.8501287150672,55.1498712849328
"2010","never ever",-2.21090451877602,144,16,128,22.1706322528977,121.829367747102
"1990","later",-2.2112002059553,98,15,83,20.7901802010941,77.2098197989059
"1990","tonight im",-2.2112002059553,98,15,83,20.7901802010941,77.2098197989059
"2000","im happy",-2.21160204011593,59,11,48,15.8760555455353,43.1239444544647
"2000","say word",-2.21571911333399,41,7,34,11.032513175711,29.9674868242891
"1960","getting",-2.21624598201877,609,28,581,36.3714734962602,572.62852650374
"1970","gave",-2.21723167195969,466,53,413,63.7711175988836,402.228882401116
"2000","places",-2.21838997475758,119,25,94,32.021196778283,86.978803221717
"1970","else",-2.22124615517781,625,73,552,85.5299324019362,539.470067598064
"1980","picture",-2.22292532168714,166,21,145,27.9271307888339,138.072869211166
"1990","forgot",-2.22420175907403,87,13,74,18.4565885458693,68.5434114541307
"1990","toes",-2.22420175907403,87,13,74,18.4565885458693,68.5434114541307
"1960","just one",-2.22538652382008,215,8,207,12.8405037794679,202.159496220532
"1990","right",-2.22869784578926,3946,799,3147,837.122970137932,3108.87702986207
"1960","cause youre",-2.23218334145473,194,7,187,11.5863150382175,182.413684961782
"1970","low low",-2.23350209429021,74,6,68,10.1267439963892,63.8732560036107
"1970","relax",-2.23350209429021,74,6,68,10.1267439963892,63.8732560036107
"1970","standin",-2.23350209429021,74,6,68,10.1267439963892,63.8732560036107
"1990","stop",-2.23535613787885,1555,306,1249,329.885002170422,1225.11499782958
"2000","went",-2.23633884993982,378,89,289,101.714389766311,276.285610233689
"2000","working",-2.24215962008968,140,30,110,37.6719962097447,102.328003790255
"2010","let show",-2.24895156731935,90,9,81,13.8566451580611,76.1433548419389
"1990","wife",-2.25134862209359,131,21,110,27.7909551667686,103.209044833231
"2000","bad bad",-2.253641412818,68,13,55,18.2978267304474,49.7021732695526
"2000","beats",-2.253641412818,68,13,55,18.2978267304474,49.7021732695526
"2000","feel im",-2.253641412818,68,13,55,18.2978267304474,49.7021732695526
"2000","wasted",-2.253641412818,68,13,55,18.2978267304474,49.7021732695526
"2010","confused",-2.25601770628045,98,10,88,15.0883469498887,82.9116530501113
"1960","rockin",-2.25663027699894,173,6,167,10.3321262969672,162.667873703033
"1980","style",-2.25732408647082,207,27,180,34.8247956222206,172.175204377779
"1990","apologize",-2.25813713105527,47,6,41,9.97080070868799,37.029199291312
"1990","grows",-2.25813713105527,47,6,41,9.97080070868799,37.029199291312
"1990","time oh",-2.25813713105527,47,6,41,9.97080070868799,37.029199291312
"1990","time youre",-2.25813713105527,47,6,41,9.97080070868799,37.029199291312
"1990","love life",-2.26058889989783,76,11,65,16.1229968906444,59.8770031093556
"2000","dont like",-2.26470927829938,136,29,107,36.5956534608949,99.4043465391051
"2010","saved",-2.26825498895223,74,7,67,11.3932415744058,62.6067584255942
"1960","beautiful",-2.26918419153601,515,23,492,30.7574857973301,484.24251420267
"1990","go like",-2.27017803948406,53,7,46,11.2436688842652,41.7563311157348
"1990","headed",-2.27017803948406,53,7,46,11.2436688842652,41.7563311157348
"1990","wanting",-2.27017803948406,53,7,46,11.2436688842652,41.7563311157348
"1990","whos",-2.27273049596334,457,84,373,96.950126039796,360.049873960204
"1980","see want",-2.2729830193468,60,6,54,10.0941436586147,49.9058563413853
"1980","youre ready",-2.2729830193468,60,6,54,10.0941436586147,49.9058563413853
"2010","rush",-2.27402357046751,137,15,122,21.0928931850485,115.907106814951
"1980","right time",-2.27851635524626,75,8,67,12.6176795732683,62.3823204267317
"1980","side side",-2.27851635524626,75,8,67,12.6176795732683,62.3823204267317
"1980","staring",-2.27851635524626,75,8,67,12.6176795732683,62.3823204267317
"1990","talkin",-2.2788566030254,335,60,275,71.0684731363931,263.931526863607
"1990","starts",-2.28054715793811,142,23,119,30.1245468219935,111.875453178007
"1990","way make",-2.28197225744469,104,16,88,22.0630483766713,81.9369516233287
"2000","oh whoa",-2.28246943031414,111,23,88,29.8685112805833,81.1314887194167
"1980","im glad",-2.28483184956637,104,12,92,17.4965156749321,86.5034843250679
"1980","long long",-2.28483184956637,104,12,92,17.4965156749321,86.5034843250679
"1990","somebodys",-2.28796619071487,115,18,97,24.3966400318961,90.6033599681039
"2000","earth",-2.28915642066531,132,28,104,35.519310712045,96.480689287955
"1970","booty",-2.29009176893828,256,27,229,35.0330603118331,220.966939688167
"1970","small",-2.29524490153541,111,10,101,15.1901159945839,95.8098840054161
"1990","cloud",-2.29661285704854,59,8,51,12.5165370598424,46.4834629401576
"1990","faster",-2.29661285704854,59,8,51,12.5165370598424,46.4834629401576
"1990","hard find",-2.29661285704854,59,8,51,12.5165370598424,46.4834629401576
"1990","hiding",-2.29661285704854,59,8,51,12.5165370598424,46.4834629401576
"1990","control",-2.29696682456207,371,67,304,78.7056821898562,292.294317810144
"2010","outside",-2.30201901571792,205,24,181,31.5623584155835,173.437641584416
"2010","beneath",-2.3035953080188,66,6,60,10.1615397825781,55.8384602174219
"2010","ill go",-2.3035953080188,66,6,60,10.1615397825781,55.8384602174219
"1980","wont let",-2.30721982516609,221,29,192,37.1800958092307,183.819904190769
"2000","can know",-2.31049784371518,55,10,45,14.7997127966854,40.2002872033146
"2000","eyes see",-2.31049784371518,55,10,45,14.7997127966854,40.2002872033146
"2000","give one",-2.31049784371518,55,10,45,14.7997127966854,40.2002872033146
"2000","now love",-2.31081873531473,77,15,62,20.7195979153596,56.2804020846404
"2010","night long",-2.31208910543324,242,29,213,37.2589792027864,204.741020797214
"1970","even though",-2.31217310385602,155,15,140,21.2114232356802,133.78857676432
"2010","bust",-2.31637564236775,122,13,109,18.7834523253717,103.216547674628
"2010","youre just",-2.31637564236775,122,13,109,18.7834523253717,103.216547674628
"2000","got mind",-2.31909833423562,46,8,38,12.3779416117733,33.6220583882267
"2000","picked",-2.31909833423562,46,8,38,12.3779416117733,33.6220583882267
"2000","want want want",-2.31909833423562,46,8,38,12.3779416117733,33.6220583882267
"2000","rise",-2.32378105237008,90,18,72,24.2177118491216,65.7822881508784
"1990","just keep",-2.32828995741409,137,22,115,29.0638233423458,107.936176657654
"1990","hell",-2.33072501044245,402,73,329,85.2821677636717,316.717832236328
"1990","hung",-2.33322042204765,65,9,56,13.7894052354196,51.2105947645804
"1990","race",-2.33322042204765,65,9,56,13.7894052354196,51.2105947645804
"2000","girl oh",-2.33522221234737,64,12,52,17.2214839815976,46.7785160184024
"1970","sayin",-2.33546992798538,181,18,163,24.7694684236007,156.230531576399
"2010","two",-2.33701824591597,967,132,835,148.881954087167,818.118045912833
"2010","think im",-2.3397773455819,235,28,207,36.1812401349372,198.818759865063
"1980","brothers",-2.34291059014128,68,7,61,11.4400294797633,56.5599705202367
"2000","one can",-2.35947801677967,103,21,82,27.7158257828836,75.2841742171164
"1970","baby want",-2.35989728517868,75,6,69,10.2635918882323,64.7364081117677
"1970","know whats",-2.35989728517868,75,6,69,10.2635918882323,64.7364081117677
"1970","search",-2.35989728517868,75,6,69,10.2635918882323,64.7364081117677
"1990","never never",-2.36224740517588,121,19,102,25.6695082074733,95.3304917925267
"1990","take hand",-2.36224740517588,121,19,102,25.6695082074733,95.3304917925267
"1960","lovers",-2.36896007435468,218,8,210,13.0196735996465,204.980326400354
"2010","devil",-2.37629138093113,99,10,89,15.2423096738672,83.7576903261328
"2010","got time",-2.37629138093113,99,10,89,15.2423096738672,83.7576903261328
"1970","matter",-2.37808079379129,533,61,472,72.9399263523712,460.060073647629
"2000","hook",-2.37822857378183,86,17,69,23.1413691002718,62.8586308997282
"1960","telling",-2.37891108979029,260,10,250,15.5280510821472,244.471948917853
"2000","fate",-2.38042403236958,73,14,59,19.6432551665097,53.3567448334902
"2000","passed",-2.38042403236958,73,14,59,19.6432551665097,53.3567448334902
"2010","cat",-2.38223575869225,83,8,75,12.7789060902119,70.2210939097881
"1970","whatcha",-2.38281138898199,173,17,156,23.6746852888559,149.325314711144
"1960","late",-2.38294405980663,421,18,403,25.1434980983999,395.8565019016
"1960","stand",-2.38473237529832,804,38,766,48.0175118078706,755.982488192129
"1980","oh yeah",-2.38716012626238,542,78,464,91.1837643828192,450.816235617181
"2000","bad boys",-2.38756050336515,37,6,31,9.9561704268611,27.0438295731389
"2000","believe just",-2.38756050336515,37,6,31,9.9561704268611,27.0438295731389
"2000","cant remember",-2.38756050336515,37,6,31,9.9561704268611,27.0438295731389
"2000","dont think can",-2.38756050336515,37,6,31,9.9561704268611,27.0438295731389
"2000","feel inside",-2.38756050336515,37,6,31,9.9561704268611,27.0438295731389
"2000","friday night",-2.38756050336515,37,6,31,9.9561704268611,27.0438295731389
"2000","messin",-2.38756050336515,37,6,31,9.9561704268611,27.0438295731389
"2000","now im gonna",-2.38756050336515,37,6,31,9.9561704268611,27.0438295731389
"2000","til end",-2.38756050336515,37,6,31,9.9561704268611,27.0438295731389
"1970","just little",-2.3913540961637,274,29,245,37.4963223650088,236.503677634991
"2010","set",-2.39505242837577,395,50,345,60.8152759714902,334.18472402851
"2010","gets",-2.39593023050825,352,44,308,54.1948788404166,297.805121159583
"1970","plan",-2.40164062747594,112,10,102,15.326963886427,96.673036113573
"1970","one can",-2.40212184106475,103,9,94,14.0953328598391,88.9046671401609
"1970","ten",-2.40362453965176,156,15,141,21.3482711275233,134.651728872477
"2000","im man",-2.40386686947176,99,20,79,26.6394830340338,72.3605169659662
"1990","keeps",-2.40452057594846,285,50,235,60.4612383399165,224.538761660084
"2010","nobodys",-2.40529237599465,75,7,68,11.5472042983842,63.4527957016158
"2010","hope",-2.40816637781312,523,68,455,80.5225046407326,442.477495359267
"1980","im tired",-2.4092852969745,105,12,93,17.6647514025757,87.3352485974243
"1970","driving",-2.40969653933716,121,11,110,16.5585949130148,104.441405086985
"1970","youll see",-2.40969653933716,121,11,110,16.5585949130148,104.441405086985
"1970","gonna make",-2.41206068276276,266,28,238,36.401539230264,229.598460769736
"1980","find another",-2.42291497733184,76,8,68,12.7859153009119,63.2140846990881
"1980","im getting",-2.42291497733184,76,8,68,12.7859153009119,63.2140846990881
"1980","like youre",-2.42291497733184,76,8,68,12.7859153009119,63.2140846990881
"1980","married",-2.42291497733184,76,8,68,12.7859153009119,63.2140846990881
"1990","died",-2.42600902788428,116,18,98,24.6087847278257,91.3912152721743
"1990","call baby",-2.42698417953081,77,11,66,16.3351415865739,60.6648584134261
"2000","bodies",-2.42769297785908,51,9,42,13.7233700478356,37.2766299521644
"2000","will let",-2.42769297785908,51,9,42,13.7233700478356,37.2766299521644
"2000","sweetest",-2.42968321256652,60,11,49,16.1451412327477,43.8548587672523
"1980","love get",-2.43250481308539,61,6,55,10.2623793862583,50.7376206137417
"1980","position",-2.43250481308539,61,6,55,10.2623793862583,50.7376206137417
"1980","silence",-2.43250481308539,61,6,55,10.2623793862583,50.7376206137417
"1980","cant keep",-2.43252359441385,98,11,87,16.4871013090706,81.5128986909294
"1980","confused",-2.43252359441385,98,11,87,16.4871013090706,81.5128986909294
"1970","ahead",-2.43613564817364,165,16,149,22.5799021541112,142.420097845889
"2010","making",-2.43790417151573,367,46,321,56.5043197000935,310.495680299907
"1970","shout",-2.44440267358861,139,13,126,19.0218569661906,119.978143033809
"2000","plan",-2.44733950625158,112,23,89,30.1375969677958,81.8624030322042
"1990","went",-2.4473676599976,378,68,310,80.1906950613629,297.809304938637
"2010","dont ask",-2.44885793732022,67,6,61,10.3155025065566,56.6844974934434
"2010","show love",-2.44885793732022,67,6,61,10.3155025065566,56.6844974934434
"2010","soft",-2.44885793732022,67,6,61,10.3155025065566,56.6844974934434
"2000","wanna dance",-2.45287999972397,95,19,76,25.5631402851839,69.4368597148161
"1990","theres",-2.45428153385341,1942,384,1558,411.98499949515,1530.01500050485
"2000","return",-2.45964875965557,69,13,56,18.5669124176599,50.4330875823401
"2000","spell",-2.45964875965557,69,13,56,18.5669124176599,50.4330875823401
"1970","loud",-2.46137064164229,208,21,187,28.4643615033644,179.535638496636
"2010","baby",-2.46413640235565,9098,1347,7751,1400.752862756,7697.247137244
"1990","annie",-2.46493477121555,48,6,42,10.1829454046175,37.8170545953825
"1990","get im",-2.46493477121555,48,6,42,10.1829454046175,37.8170545953825
"1990","instrumental",-2.46493477121555,48,6,42,10.1829454046175,37.8170545953825
"1980","know well",-2.46522275488096,91,10,81,15.3094512155656,75.6905487844344
"1990","cant tell",-2.46659159133873,54,7,47,11.4558135801947,42.5441864198053
"1990","new york city",-2.46659159133873,54,7,47,11.4558135801947,42.5441864198053
"1990","shirt",-2.46659159133873,54,7,47,11.4558135801947,42.5441864198053
"1990","swallow",-2.46659159133873,54,7,47,11.4558135801947,42.5441864198053
"1960","dance dance",-2.47016807508638,177,6,171,10.5710193905387,166.428980609461
"1980","guy",-2.47129217706321,243,32,211,40.8812818173894,202.118718182611
"2000","drown",-2.47314736818821,42,7,35,11.3015988629234,30.6984011370766
"2000","gotta move",-2.47314736818821,42,7,35,11.3015988629234,30.6984011370766
"2000","learning",-2.47314736818821,42,7,35,11.3015988629234,30.6984011370766
"2000","pumpin",-2.47314736818821,42,7,35,11.3015988629234,30.6984011370766
"2000","things say",-2.47314736818821,42,7,35,11.3015988629234,30.6984011370766
"2000","toe",-2.47314736818821,42,7,35,11.3015988629234,30.6984011370766
"2000","want oh",-2.47314736818821,42,7,35,11.3015988629234,30.6984011370766
"2010","flow",-2.47350248922202,177,20,157,27.2514021441868,149.748597855813
"2000","round",-2.47775808485979,727,177,550,195.62529460346,531.37470539654
"1990","older",-2.48104015741635,83,12,71,17.6080097621511,65.3919902378489
"1990","right back",-2.48104015741635,83,12,71,17.6080097621511,65.3919902378489
"1990","cause got",-2.48258861539075,149,24,125,31.6095596935002,117.3904403065
"1970","baby baby baby",-2.48437922118011,267,28,239,36.5383871221071,230.461612877893
"1990","reasons",-2.4846976263812,60,8,52,12.7286817557719,47.2713182442281
"1990","stayed",-2.4846976263812,60,8,52,12.7286817557719,47.2713182442281
"1990","arms",-2.48574835936289,556,103,453,117.95245093682,438.04754906318
"1990","goin",-2.48574835936289,556,103,453,117.95245093682,438.04754906318
"1970","flying",-2.48861154123802,76,6,70,10.4004397800754,65.5995602199246
"1960","fight",-2.49411782555497,483,21,462,28.8463410487581,454.153658951242
"2000","secret",-2.49468291571979,179,39,140,48.1663380110307,130.833661988969
"1980","baby ill",-2.49559738768005,127,15,112,21.3659374107344,105.634062589266
"1980","lovely",-2.49559738768005,127,15,112,21.3659374107344,105.634062589266
"1980","join",-2.49572558571771,69,7,62,11.6082652074069,57.3917347925931
"1980","stood",-2.49572558571771,69,7,62,11.6082652074069,57.3917347925931
"1970","felt",-2.49622054027263,325,35,290,44.4755648490068,280.524435150993
"2010","bill",-2.49883507479928,100,10,90,15.3962723978456,84.6037276021544
"2010","chill",-2.50113932246541,92,9,83,14.164570606018,77.835429393982
"2010","coast",-2.50113932246541,92,9,83,14.164570606018,77.835429393982
"2010","promises",-2.50113932246541,92,9,83,14.164570606018,77.835429393982
"1970","smoke",-2.50138597931094,200,20,180,27.3695783686196,172.63042163138
"2010","warm",-2.50336644013427,237,28,209,36.4891655828941,200.510834417106
"2010","im hot",-2.50548606536514,108,11,97,16.6279741896733,91.3720258103267
"2010","strange",-2.50548606536514,108,11,97,16.6279741896733,91.3720258103267
"2000","repeat",-2.50716688564811,91,18,73,24.4867975363341,66.5132024636659
"2000","message",-2.50750660749144,78,15,63,20.9886836025721,57.0113163974279
"1970","rollin",-2.50756162373462,183,18,165,25.0431642072869,157.956835792713
"1990","care",-2.51369737048821,702,132,570,148.925576542531,553.074423457469
"1970","fantasy",-2.51422657248715,122,11,111,16.6954428048579,105.304557195142
"2010","baby cause",-2.5151888580374,84,8,76,12.9328688141903,71.0671311858097
"2010","silly",-2.5151888580374,84,8,76,12.9328688141903,71.0671311858097
"2010","want love",-2.51728497045702,185,21,164,28.4831039360144,156.516896063986
"1960","running",-2.51739084482297,365,15,350,21.798994788399,343.201005211601
"2010","says",-2.51810016255498,361,45,316,55.5805433562227,305.419456643777
"2000","answer",-2.52876009221592,171,37,134,46.0136525133311,124.986347486669
"1970","got feeling",-2.531228492728,95,8,87,13.0005497250943,81.9994502749057
"2010","loving",-2.53422215979301,504,65,439,77.597212885142,426.402787114858
"1960","leaving",-2.53696533689876,200,7,193,11.9446546785748,188.055345321425
"2000","love got",-2.53905646879426,142,30,112,38.2101675841696,103.78983241583
"1970","working",-2.54308585867207,140,13,127,19.1587048580337,120.841295141966
"2010","see us",-2.54507513110099,76,7,69,11.7011670223627,64.2988329776373
"2010","take time",-2.54995937092242,155,17,138,23.8642222166607,131.135777783339
"2000","bus",-2.55042599055291,65,12,53,17.49056966881,47.50943033119
"2000","ohoh",-2.55042599055291,65,12,53,17.49056966881,47.50943033119
"2000","thats im",-2.55042599055291,65,12,53,17.49056966881,47.50943033119
"2000","things",-2.55061072537155,1560,392,1168,419.773672051441,1140.22632794856
"1980","getting",-2.55152723554045,609,88,521,102.455558134939,506.544441865061
"1980","glad",-2.55211021047436,217,28,189,36.5071528986564,180.492847101344
"1990","love much",-2.55284160270172,72,10,62,15.2744181069263,56.7255818930737
"1990","well make",-2.55284160270172,72,10,62,15.2744181069263,56.7255818930737
"2010","earth",-2.56200095296019,132,14,118,20.3230795651562,111.676920434844
"1970","guy",-2.56369544928257,243,25,218,33.2540377178728,209.745962282127
"1970","know dont",-2.56369544928257,243,25,218,33.2540377178728,209.745962282127
"1980","alright alright",-2.56409819906421,99,11,88,16.6553370367142,82.3446629632858
"1970","drinks",-2.5641283348684,86,7,79,11.7689186985064,74.2310813014936
"1970","time dont",-2.5641283348684,86,7,79,11.7689186985064,74.2310813014936
"1970","will make",-2.5641283348684,86,7,79,11.7689186985064,74.2310813014936
"2000","body body",-2.56750522651996,87,17,70,23.4104547874842,63.5895452125158
"2000","biggie",-2.56841059993786,47,8,39,12.6470272989857,34.3529727010143
"2000","come know",-2.56841059993786,47,8,39,12.6470272989857,34.3529727010143
"2000","grows",-2.56841059993786,47,8,39,12.6470272989857,34.3529727010143
"2000","shelter",-2.56841059993786,47,8,39,12.6470272989857,34.3529727010143
"2000","time oh",-2.56841059993786,47,8,39,12.6470272989857,34.3529727010143
"2000","looks",-2.56912061467258,196,43,153,52.7407946936426,143.259205306357
"1980","baby please",-2.57040987545845,77,8,69,12.9541510285555,64.0458489714445
"1990","wings",-2.57257614028993,128,20,108,27.15452107898,100.84547892102
"2000","letting",-2.58197894707784,100,20,80,26.9085687212462,73.0914312787538
"2000","love never",-2.58197894707784,100,20,80,26.9085687212462,73.0914312787538
"1980","minute",-2.58355967501504,251,33,218,42.2271676385381,208.772832361462
"1970","turn around",-2.58634246627181,218,22,196,29.8328404217953,188.167159578205
"2010","thinkin",-2.58660608601508,362,45,317,55.7345060802012,306.265493919799
"1990","different",-2.59535807953399,198,33,165,42.0046497940473,155.995350205953
"1990","single",-2.59535807953399,198,33,165,42.0046497940473,155.995350205953
"1970","fear",-2.59540280741533,184,18,166,25.18001209913,158.81998790087
"1970","wanna go",-2.59540280741533,184,18,166,25.18001209913,158.81998790087
"1980","busy",-2.59560389300322,62,6,56,10.4306151139018,51.5693848860982
"1980","go know",-2.59560389300322,62,6,56,10.4306151139018,51.5693848860982
"1980","im wrong",-2.59560389300322,62,6,56,10.4306151139018,51.5693848860982
"1980","need say",-2.59560389300322,62,6,56,10.4306151139018,51.5693848860982
"1970","lights",-2.6040888797892,465,52,413,63.6342697070405,401.365730292959
"2010","guess",-2.61043795076672,484,62,422,74.5179584055728,409.482041594427
"2010","freak",-2.61137940669168,186,21,165,28.6370666599929,157.362933340007
"1980","first",-2.61444179584097,706,103,603,118.774423716366,587.225576283634
"1970","throw",-2.61769490369115,441,49,392,60.3499203028062,380.650079697194
"1990","love baby",-2.61842218675458,421,76,345,89.3129169863328,331.687083013667
"2010","plus",-2.62360111481295,101,10,91,15.5502351218241,85.4497648781759
"1980","never never",-2.62468758200631,121,14,107,20.3565230448729,100.643476955127
"1970","heat",-2.62645527827649,210,21,189,28.7380572870506,181.261942712949
"2010","moon",-2.62811008637349,268,32,236,41.2620100262263,226.737989973774
"1970","never thought",-2.62871097164693,105,9,96,14.3690286435253,90.6309713564747
"1970","girl youre",-2.62875986109509,132,12,120,18.0639217232889,113.936078276711
"2010","use",-2.62881807951732,290,35,255,44.6491899537523,245.350810046248
"1960","nothin",-2.63264947335112,487,21,466,29.0852341423296,457.91476585767
"1960","lets go",-2.64150135674107,202,7,195,12.0641012253605,189.935898774639
"1970","go let",-2.64323140222025,141,13,128,19.2955527498768,121.704447250123
"1980","follow",-2.64490240903116,218,28,190,36.6753886263,181.3246113737
"1990","safe",-2.64659245017629,134,21,113,28.4273892545572,105.572610745443
"1990","tree",-2.64761910494273,84,12,72,17.8201544580807,66.1798455419193
"1990","wont come",-2.64761910494273,84,12,72,17.8201544580807,66.1798455419193
"1980","faded",-2.65181352257129,70,7,63,11.7765009350505,58.2234990649496
"1980","just know",-2.65181352257129,70,7,63,11.7765009350505,58.2234990649496
"1980","melody",-2.65181352257129,70,7,63,11.7765009350505,58.2234990649496
"2000","every",-2.65310095453656,2061,522,1539,554.585601344885,1506.41439865512
"1980","whoa whoa whoa",-2.65314420369991,85,9,76,14.3000368497041,70.6999631502959
"1980","party",-2.65498607249562,694,101,593,116.755594984643,577.244405015357
"2000","named",-2.65524866859176,61,11,50,16.4142269199602,44.5857730800398
"2000","gonna make",-2.65846862174875,266,60,206,71.576792798515,194.423207201485
"1990","rule",-2.66132066638898,101,15,86,21.4266142888827,79.5733857111173
"1990","great",-2.66303475066807,145,23,122,30.7609809097821,114.239019090218
"1980","figure",-2.66551675200421,107,12,95,18.0012228578628,88.9987771421372
"2000","chances",-2.66574709147979,38,6,32,10.2252561140736,27.7747438859264
"2000","like say",-2.66574709147979,38,6,32,10.2252561140736,27.7747438859264
"2000","need now",-2.66574709147979,38,6,32,10.2252561140736,27.7747438859264
"2000","see sun",-2.66574709147979,38,6,32,10.2252561140736,27.7747438859264
"2000","travel",-2.66574709147979,38,6,32,10.2252561140736,27.7747438859264
"2000","trigger",-2.66574709147979,38,6,32,10.2252561140736,27.7747438859264
"2000","wo wo",-2.66574709147979,38,6,32,10.2252561140736,27.7747438859264
"1980","bet",-2.66632610211962,225,29,196,37.853038719805,187.146961280195
"1990","can know",-2.66852239164323,55,7,48,11.6679582761242,43.3320417238758
"1990","wanna come",-2.66852239164323,55,7,48,11.6679582761242,43.3320417238758
"1990","york city",-2.66852239164323,55,7,48,11.6679582761242,43.3320417238758
"2000","everybody knows",-2.67044088765921,52,9,43,13.992455735048,38.007544264952
"2000","hall",-2.67044088765921,52,9,43,13.992455735048,38.007544264952
"2000","wanna feel",-2.67044088765921,52,9,43,13.992455735048,38.007544264952
"2000","yeah can",-2.67044088765921,52,9,43,13.992455735048,38.007544264952
"2010","never gonna",-2.67147795595504,239,28,211,36.7970910308511,202.202908969149
"2000","folks",-2.67238576851301,70,13,57,18.8359981048724,51.1640018951276
"1990","want girl",-2.67768627789772,49,6,43,10.3950901005471,38.604909899453
"1990","well know",-2.67768627789772,49,6,43,10.3950901005471,38.604909899453
"1990","slim",-2.67791142846841,61,8,53,12.9408264517014,48.0591735482986
"2010","wont",-2.68265118384576,2313,328,1985,356.115780562169,1956.88421943783
"1990","im going",-2.68624864656669,156,25,131,33.0945725650069,122.905427434993
"2010","honey",-2.68709182918559,421,53,368,64.8183067949301,356.18169320507
"2010","evil",-2.68752785935527,77,7,70,11.8551297463411,65.1448702536589
"1980","closer",-2.68850747543125,232,30,202,39.0306888133101,192.96931118669
"1970","like never",-2.68968019925247,87,7,80,11.9057665903495,75.0942334096505
"1970","youre going",-2.68968019925247,87,7,80,11.9057665903495,75.0942334096505
"1980","sure",-2.68994289718577,560,80,480,94.2120074804036,465.787992519596
"2000","new york",-2.69059154410762,168,36,132,45.2063954516937,122.793604548306
"2000","every single",-2.69597237178736,92,18,74,24.7558832235465,67.2441167764535
"2000","get floor",-2.69597237178736,92,18,74,24.7558832235465,67.2441167764535
"1980","know wanna",-2.69819820185161,100,11,89,16.8235727643578,83.1764272356422
"1990","youre alone",-2.70051769218422,67,9,58,14.2136946272786,52.7863053727214
"1990","admit",-2.70151989834199,90,13,77,19.0930226336578,70.9069773663421
"1990","awake",-2.70151989834199,90,13,77,19.0930226336578,70.9069773663421
"1990","let tell",-2.70151989834199,90,13,77,19.0930226336578,70.9069773663421
"1960","angel",-2.70680036873045,288,11,277,17.2003027371477,270.799697262852
"2000","please",-2.7110143603015,1038,256,782,279.310943326536,758.689056673464
"1970","hold",-2.71654948484091,1726,213,1513,236.199461321187,1489.80053867881
"2000","fun",-2.71975765860658,423,99,324,113.823245690872,309.176754309128
"1970","wasnt",-2.7199641581625,245,25,220,33.527733501559,211.472266498441
"1980","go go",-2.7218168739091,266,35,231,44.7507035531917,221.249296446808
"1990","sitting",-2.72570452347255,107,16,91,22.6994824644599,84.3005175355401
"1970","youre gone",-2.72813294829666,124,11,113,16.9691385885441,107.030861411456
"1970","shed",-2.73120398705817,115,10,105,15.7375075619563,99.2624924380437
"1990","begging",-2.732877773613,73,10,63,15.4865628028558,57.5134371971442
"1990","benz",-2.732877773613,73,10,63,15.4865628028558,57.5134371971442
"1990","fate",-2.732877773613,73,10,63,15.4865628028558,57.5134371971442
"1990","sin",-2.732877773613,73,10,63,15.4865628028558,57.5134371971442
"2000","good thing",-2.74010270946965,43,7,36,11.5706845501359,31.4293154498641
"2000","long night",-2.74010270946965,43,7,36,11.5706845501359,31.4293154498641
"2000","settle",-2.74010270946965,43,7,36,11.5706845501359,31.4293154498641
"2000","stops",-2.74010270946965,43,7,36,11.5706845501359,31.4293154498641
"2000","washed",-2.74010270946965,43,7,36,11.5706845501359,31.4293154498641
"2000","way walk",-2.74010270946965,43,7,36,11.5706845501359,31.4293154498641
"1970","want dont",-2.74470231744696,106,9,97,14.5058765353684,91.4941234646316
"2000","thoughts",-2.7455517541359,118,24,94,31.7521110910705,86.2478889089295
"2010","shakin",-2.74810283289866,69,6,63,10.6234279545135,58.3765720454865
"2010","spending",-2.74810283289866,69,6,63,10.6234279545135,58.3765720454865
"2010","therell",-2.74810283289866,69,6,63,10.6234279545135,58.3765720454865
"1980","hey baby",-2.74825159508687,122,14,108,20.5247587725165,101.475241227483
"2010","fingers",-2.75054331542356,102,10,92,15.7041978458025,86.2958021541975
"2010","workin",-2.75054331542356,102,10,92,15.7041978458025,86.2958021541975
"1960","lies",-2.75221409632775,289,11,278,17.2600260105406,271.739973989459
"2010","kisses",-2.75502444105845,118,12,106,18.1676014294578,99.8323985705422
"2010","know need",-2.75502444105845,118,12,106,18.1676014294578,99.8323985705422
"1990","mary",-2.75863303798961,96,14,82,20.365890809235,75.634109190765
"2000","love one",-2.76236526775364,88,17,71,23.6795404746967,64.3204595253033
"2010","wherever",-2.76275857726831,94,9,85,14.4724960539749,79.5275039460251
"2010","will find",-2.76275857726831,94,9,85,14.4724960539749,79.5275039460251
"1970","wave",-2.77182662689109,97,8,89,13.2742455087805,83.7257544912195
"1990","fair",-2.77264373271635,79,11,68,16.759430978433,62.240569021567
"1990","fighting",-2.77264373271635,79,11,68,16.759430978433,62.240569021567
"1990","storm",-2.77264373271635,79,11,68,16.759430978433,62.240569021567
"2000","till",-2.77343106264041,692,167,525,186.207295551024,505.792704448976
"2000","got hold",-2.77739034865281,57,10,47,15.3378841711103,41.6621158288897
"2000","oh yeah yeah",-2.77739034865281,57,10,47,15.3378841711103,41.6621158288897
"2000","must",-2.77933514908074,696,168,528,187.283638299874,508.716361700126
"1990","youre gone",-2.78159577419458,124,19,105,26.3059422952619,97.6940577047381
"1990","night long",-2.78874696558148,242,41,201,51.3390164149466,190.660983585053
"2010","lean",-2.7902699120259,270,32,238,41.5699354741832,228.430064525817
"2000","nothing can",-2.79083299724143,114,23,91,30.6757683422207,83.3242316577793
"2000","price",-2.79083299724143,114,23,91,30.6757683422207,83.3242316577793
"2010","hold",-2.79498733811445,1726,241,1485,265.739661586816,1460.26033841318
"2000","smooth",-2.79531463894502,75,14,61,20.1814265409347,54.8185734590653
"2010","nice",-2.79571572196475,233,27,206,35.8733146869803,197.12668531302
"1990","skin",-2.79578468102315,146,23,123,30.9731256057116,115.026874394288
"1980","hook",-2.79910250299566,86,9,77,14.4682725773477,71.5317274226523
"1960","gets",-2.81001538345855,352,14,338,21.0225922342916,330.977407765708
"1990","ha ha",-2.81674240934185,237,40,197,50.278292935299,186.721707064701
"1970","like just",-2.81724370274634,88,7,81,12.0426144821926,75.9573855178074
"1990","just take",-2.81816663714137,85,12,73,18.0322991540102,66.9677008459898
"2010","fun",-2.81902343200787,423,53,370,65.126232242887,357.873767757113
"2010","oh baby",-2.81903451377288,387,48,339,59.5835741796626,327.416425820337
"2000","kissed",-2.82450499531225,97,19,78,26.1013116596088,70.8986883403912
"2000","ecstasy",-2.82645413507223,48,8,40,12.9161129861982,35.0838870138018
"2000","machine",-2.82645413507223,48,8,40,12.9161129861982,35.0838870138018
"2010","law",-2.83257823191362,78,7,71,12.0090924703196,65.9909075296804
"2010","mack",-2.83257823191362,78,7,71,12.0090924703196,65.9909075296804
"2010","oh can",-2.83257823191362,78,7,71,12.0090924703196,65.9909075296804
"2010","still",-2.83449513248895,1843,258,1585,283.753300292295,1559.2466997077
"1980","girl dont",-2.83543494199295,165,20,145,27.7588950611904,137.24110493881
"1970","ill give",-2.83553392760606,178,17,161,24.3589247480714,153.641075251929
"1980","never ever",-2.83615023880604,144,17,127,24.2259447806752,119.774055219325
"2000","dont know im",-2.84017684178565,110,22,88,29.5994255933708,80.4005744066291
"1980","eat",-2.840970905974,172,21,151,28.9365451546954,143.063454845305
"1980","make love",-2.84843139735882,254,33,221,42.7318748214688,211.268125178531
"1960","friend",-2.85009808643688,649,29,620,38.7604044319752,610.239595568025
"1970","let know",-2.85267121536284,297,31,266,40.6438238774001,256.3561761226
"1980","now",-2.85500395256157,6525,1047,5478,1097.73812287435,5427.26187712565
"2010","didnt",-2.85847847114211,868,116,752,133.6396444133,734.3603555867
"1960","fear",-2.85895698467413,184,6,178,10.9890823042888,173.010917695711
"1980","come home",-2.87435387578195,79,8,71,13.2906224838427,65.7093775161573
"1990","im right",-2.87575723308481,56,7,49,11.8801029720538,44.1198970279462
"1990","keep movin",-2.87575723308481,56,7,49,11.8801029720538,44.1198970279462
"1990","forever ever",-2.87607496496037,62,8,54,13.152971147631,48.847028852369
"1990","girl cant",-2.87607496496037,62,8,54,13.152971147631,48.847028852369
"1990","let go dont",-2.87607496496037,62,8,54,13.152971147631,48.847028852369
"1990","let hold",-2.87607496496037,62,8,54,13.152971147631,48.847028852369
"1990","now see",-2.87607496496037,62,8,54,13.152971147631,48.847028852369
"1990","one two three",-2.87607496496037,62,8,54,13.152971147631,48.847028852369
"1990","see ya",-2.87607496496037,62,8,54,13.152971147631,48.847028852369
"2010","eight",-2.8796169173029,103,10,93,15.858160569781,87.141839430219
"2010","rose",-2.8796169173029,103,10,93,15.858160569781,87.141839430219
"2010","rough",-2.8796169173029,103,10,93,15.858160569781,87.141839430219
"1990","mistake",-2.88027969096833,108,16,92,22.9116271603894,85.0883728396106
"2010","dead",-2.88721353415287,204,23,181,31.4083956916051,172.591604308395
"2000","lots",-2.88802843775491,62,11,51,16.6833126071727,45.3166873928273
"2000","thats just",-2.8900661490785,93,18,75,25.024968910759,67.975031089241
"1990","wasted",-2.89119160463603,68,9,59,14.4258393232082,53.5741606767919
"2000","test",-2.89163989634632,71,13,58,19.1050837920848,51.8949162079152
"2000","ocean",-2.89407296397442,106,21,85,28.523082844521,77.476917155479
"1990","pass",-2.89520333277207,243,41,202,51.5511611108762,191.448838889124
"1990","go take",-2.89613444560778,50,6,44,10.6072347964766,39.3927652035234
"1990","next time",-2.89613444560778,50,6,44,10.6072347964766,39.3927652035234
"1990","pouring",-2.89613444560778,50,6,44,10.6072347964766,39.3927652035234
"1990","wasting",-2.89613444560778,50,6,44,10.6072347964766,39.3927652035234
"2010","let hear",-2.89697330988661,95,9,86,14.6264587779533,80.3735412220467
"2010","girlfriend",-2.90041015103305,135,14,121,20.7849677370916,114.215032262908
"2010","hours",-2.90190944282586,70,6,64,10.7773906784919,59.2226093215081
"2010","see dont",-2.90190944282586,70,6,64,10.7773906784919,59.2226093215081
"2010","wont give",-2.90190944282586,70,6,64,10.7773906784919,59.2226093215081
"1960","set",-2.91104137978373,395,16,379,23.5906929901852,371.409307009815
"2000","youll find",-2.91902776543421,80,15,65,21.526854976997,58.473145023003
"2000","believed",-2.92124070930727,53,9,44,14.2615414222605,38.7384585777395
"2000","got know",-2.92124070930727,53,9,44,14.2615414222605,38.7384585777395
"2000","wanting",-2.92124070930727,53,9,44,14.2615414222605,38.7384585777395
"2000","whos",-2.92252892626851,457,107,350,122.972159056095,334.027840943905
"1990","empty",-2.92403573241814,136,21,115,28.8516786464163,107.148321353584
"1990","flip",-2.92403573241814,136,21,115,28.8516786464163,107.148321353584
"1990","made",-2.92714431440447,1068,204,864,226.57053525274,841.42946474726
"1980","ray",-2.93205764880509,64,6,58,10.767086569189,53.232913430811
"1980","speed",-2.93205764880509,64,6,58,10.767086569189,53.232913430811
"2010","though",-2.93337181021017,532,68,464,81.9081691565387,450.091830843461
"1990","sugar",-2.94542198889988,254,43,211,53.884752766101,200.115247233899
"1970","self",-2.94677142963893,89,7,82,12.1794623740357,76.8205376259643
"1970","raise",-2.94832055442522,126,11,115,17.2428343722303,108.75716562777
"1990","attention",-2.95167426567859,80,11,69,16.9715756743625,63.0284243256375
"1990","bound",-2.95167426567859,80,11,69,16.9715756743625,63.0284243256375
"1990","makin love",-2.95167426567859,80,11,69,16.9715756743625,63.0284243256375
"2000","ill try",-2.9538062007218,39,6,33,10.494341801286,28.505658198714
"2000","rip",-2.9538062007218,39,6,33,10.494341801286,28.505658198714
"2000","wanna give",-2.9538062007218,39,6,33,10.494341801286,28.505658198714
"2000","want hear",-2.9538062007218,39,6,33,10.494341801286,28.505658198714
"1980","feel like",-2.95513665444059,506,71,435,85.1272781876504,420.87272181235
"1970","cause dont",-2.95842123276444,188,18,170,25.7274036665024,162.272596333498
"1960","talkin",-2.95949391451473,335,13,322,20.0072965866128,314.992703413387
"1960","work",-2.96457863696798,844,39,805,50.4064427435856,793.593557256414
"1980","think im",-2.96863520630581,235,30,205,39.5353959962408,195.464604003759
"1960","dit",-2.97339980810242,186,6,180,11.1085288510746,174.891471148925
"1980","complete",-2.97342065146987,72,7,65,12.1129723903376,59.8870276096624
"1980","see just",-2.97342065146987,72,7,65,12.1129723903376,59.8870276096624
"1980","fingers",-2.97376268242497,102,11,91,17.1600442196449,84.8399557803551
"1980","come get",-2.97387520088794,194,24,170,32.6377311628541,161.362268837146
"2000","babe",-2.97411046235312,675,162,513,181.632838868412,493.367161131588
"1960","really",-2.97570560311195,1880,95,1785,112.279753978603,1767.7202460214
"1980","see im",-2.98024547443713,131,15,116,22.0388803213087,108.961119678691
"1970","dreaming",-2.98034979239978,162,15,147,22.1693584785819,139.830641521418
"1970","brain",-2.98190310065959,108,9,99,14.7795723190546,93.2204276809454
"1970","dont understand",-2.98190310065959,108,9,99,14.7795723190546,93.2204276809454
"2010","gettin",-2.99491278813531,440,55,385,67.7435985505208,372.256401449479
"1970","way feel",-3.00096496455508,171,16,155,23.4009895051697,147.59901049483
"2000","soft",-3.00150379873101,67,12,55,18.028741043235,48.971258956765
"2010","boo",-3.00461649771944,128,13,115,19.7072286692424,108.292771330758
"2000","shake shake",-3.00555188977956,402,93,309,108.17244625941,293.82755374059
"1970","still",-3.00590126974672,1843,227,1616,252.210664666829,1590.78933533317
"2000","sometimes",-3.01097583464374,442,103,339,118.935873747908,323.064126252092
"1980","past",-3.01356338382617,215,27,188,36.1706814433693,178.829318556631
"2000","keep coming",-3.01610493168564,44,7,37,11.8397702373483,32.1602297626517
"2000","pie",-3.01610493168564,44,7,37,11.8397702373483,32.1602297626517
"2000","touching",-3.01610493168564,44,7,37,11.8397702373483,32.1602297626517
"2000","winner",-3.01610493168564,44,7,37,11.8397702373483,32.1602297626517
"2010","pass",-3.02094895454875,243,28,215,37.4129419267649,205.587058073235
"2000","kissing",-3.02218623536282,58,10,48,15.6069698583228,42.3930301416772
"1960","wants",-3.02375932030743,557,24,533,33.2658632798308,523.734136720169
"1970","radio",-3.02502884241332,180,17,163,24.6326205317576,155.367379468242
"2010","know got",-3.02516398625258,213,24,189,32.7940602074112,180.205939792589
"1970","youll find",-3.02543241083276,80,6,74,10.9478313474478,69.0521686525522
"1970","start",-3.03256594252067,753,87,666,103.046462557853,649.953537442147
"2010","get love",-3.03339136016986,96,9,87,14.7804215019318,81.2195784980682
"2010","im looking",-3.03339136016986,96,9,87,14.7804215019318,81.2195784980682
"1990","dont feel",-3.03807563385126,109,16,93,23.1237718563189,85.8762281436811
"1990","got get",-3.03865142613359,92,13,79,19.5173120255169,72.4826879744831
"2000","found",-3.04007214861575,723,174,549,194.54895185461,528.45104814539
"2000","ill always",-3.0433845192329,85,16,69,22.8722834130593,62.1277165869407
"1960","know want",-3.04921379050395,253,9,244,15.1099881683971,237.890011831603
"2010","family",-3.05490755786693,152,16,136,23.4023340447254,128.597665955275
"2010","baby hey",-3.05839492397497,71,6,65,10.9313534024704,60.0686465975296
"2010","early",-3.05839492397497,71,6,65,10.9313534024704,60.0686465975296
"2010","never meant",-3.05839492397497,71,6,65,10.9313534024704,60.0686465975296
"2010","say name",-3.05839492397497,71,6,65,10.9313534024704,60.0686465975296
"2010","seeing",-3.05839492397497,71,6,65,10.9313534024704,60.0686465975296
"2000","dont worry",-3.06089377620861,183,39,144,49.2426807598806,133.757319240119
"1980","ear",-3.0674604966508,110,12,98,18.5059300407936,91.4940699592064
"1990","hurts",-3.06893141068512,148,23,125,31.3974149975707,116.602585002429
"2010","love one",-3.07146041069173,88,8,80,13.5487197101042,74.4512802898958
"2010","never let go",-3.07146041069173,88,8,80,13.5487197101042,74.4512802898958
"2000","get get",-3.07358740114256,546,129,417,146.920785218004,399.079214781996
"1980","kill",-3.07415216188985,146,17,129,24.5624162359624,121.437583764038
"1970","im feelin",-3.07567975240026,118,10,108,16.1480512374856,101.851948762514
"2010","ladies",-3.07774221749927,303,36,267,46.6507053654723,256.349294634528
"1980","band",-3.07889321401893,195,24,171,32.8059668904977,162.194033109502
"1990","just gotta",-3.07901819237141,63,8,55,13.3651158435605,49.6348841564395
"1970","hang",-3.08153168654804,198,19,179,27.0958825849334,170.904117415067
"1990","haters",-3.08635262046458,69,9,60,14.6379840191377,54.3620159808623
"1990","can run",-3.08809505077863,57,7,50,12.0922476679833,44.9077523320167
"1990","groovin",-3.08809505077863,57,7,50,12.0922476679833,44.9077523320167
"1990","hold back",-3.08809505077863,57,7,50,12.0922476679833,44.9077523320167
"1990","hangin",-3.08888895576648,98,14,84,20.7901802010941,77.2098197989059
"1960","cause dont",-3.08927640896917,188,6,182,11.2279753978603,176.77202460214
"1960","fallin",-3.08927640896917,188,6,182,11.2279753978603,176.77202460214
"1970","happen",-3.09941797817267,172,16,156,23.5378373970128,148.462162602987
"1970","get way",-3.10304540115382,109,9,100,14.9164202108977,94.0835797891023
"1980","beer",-3.1051887995008,65,6,59,10.9353222968326,54.0646777031674
"1980","know name",-3.1051887995008,65,6,59,10.9353222968326,54.0646777031674
"1980","save",-3.110647855896,304,40,264,51.1436612036477,252.856338796352
"1960","fall",-3.1114475677296,925,43,882,55.2440278884084,869.755972111592
"1970","dig",-3.11320944632899,207,20,187,28.3275136115213,178.672486388479
"1990","best thing",-3.12003840558559,51,6,45,10.8193794924061,40.1806205075939
"1990","cherry",-3.12003840558559,51,6,45,10.8193794924061,40.1806205075939
"1990","got nothing",-3.12003840558559,51,6,45,10.8193794924061,40.1806205075939
"1990","spark",-3.12003840558559,51,6,45,10.8193794924061,40.1806205075939
"1990","strip",-3.12003840558559,51,6,45,10.8193794924061,40.1806205075939
"2000","hat",-3.12776694314429,63,11,52,16.9523982943851,46.0476017056149
"2010","find love",-3.13019695088882,80,7,73,12.3170179182765,67.6829820817235
"1990","money money",-3.13469066957565,81,11,70,17.1837203702921,63.8162796297079
"1980","phone",-3.13683621615361,311,41,270,52.3213112971527,258.678688702847
"1980","passed",-3.13875665277239,73,7,66,12.2812081179812,60.7187918820188
"1980","sin",-3.13875665277239,73,7,66,12.2812081179812,60.7187918820188
"2010","one time",-3.13944042342201,199,22,177,30.6385820717128,168.361417928287
"2010","middle",-3.14118953296142,289,34,255,44.4952272297739,244.504772770226
"1990","im gonna make",-3.14254188520332,104,15,89,22.0630483766713,81.9369516233287
"1980","kinda",-3.14518720350829,264,34,230,44.4142320979046,219.585767902095
"2000","bang bang",-3.14587818743709,103,20,83,27.7158257828836,75.2841742171164
"2000","sunday",-3.14587818743709,103,20,83,27.7158257828836,75.2841742171164
"1980","spend",-3.14740238712626,291,38,253,48.9565967442812,242.043403255719
"1960","straight",-3.15123301961088,255,9,246,15.2294347151829,239.770565284817
"1980","going",-3.1585966735698,1104,164,940,185.73224331851,918.26775668149
"1980","asked",-3.16420616167409,118,13,105,19.8518158619422,98.1481841380578
"1980","im feelin",-3.16420616167409,118,13,105,19.8518158619422,98.1481841380578
"1980","quit",-3.16420616167409,118,13,105,19.8518158619422,98.1481841380578
"1970","cant deny",-3.16484283459483,81,6,75,11.0846792392909,69.9153207607091
"1970","money money",-3.16484283459483,81,6,75,11.0846792392909,69.9153207607091
"2000","color",-3.16827600535646,90,17,73,24.2177118491216,65.7822881508784
"1970","blood",-3.17458215519638,128,11,117,17.5165301559165,110.483469844083
"1970","boo",-3.17458215519638,128,11,117,17.5165301559165,110.483469844083
"1970","wings",-3.17458215519638,128,11,117,17.5165301559165,110.483469844083
"1980","sail",-3.17583412579288,96,10,86,16.1506298537835,79.8493701462165
"2000","ever want",-3.17976090195626,54,9,45,14.530627109473,39.469372890527
"2000","love yes",-3.17976090195626,54,9,45,14.530627109473,39.469372890527
"1970","just let",-3.18285013344677,164,15,149,22.4430542622681,141.556945737732
"1980","teach",-3.18971219563515,81,8,73,13.6270939391298,67.3729060608702
"1970","oh dont",-3.19368172952167,119,10,109,16.2848991293287,102.715100870671
"1990","love let",-3.1990284862508,110,16,94,23.3359165522485,86.6640834477515
"2000","roof",-3.19931211541467,163,34,129,43.8609670156314,119.139032984369
"2010","water",-3.2021540282252,245,28,217,37.7208673747218,207.279132625278
"1990","stare",-3.2126263952057,93,13,80,19.7294567214464,73.2705432785536
"2010","self",-3.21635117336004,89,8,81,13.7026824340826,75.2973175659174
"2010","back home",-3.21748090429594,72,6,66,11.0853161264489,60.9146838735512
"2010","cos",-3.21748090429594,72,6,66,11.0853161264489,60.9146838735512
"2010","tell tell",-3.21748090429594,72,6,66,11.0853161264489,60.9146838735512
"2010","just one",-3.21811974026212,215,24,191,33.1019856553681,181.898014344632
"1990","wake",-3.2224709267464,330,57,273,70.0077496567454,259.992250343255
"2000","cant get enough",-3.23692397047877,68,12,56,18.2978267304474,49.7021732695526
"2000","feels good",-3.23692397047877,68,12,56,18.2978267304474,49.7021732695526
"1960","think im",-3.23951677704406,235,8,227,14.0349692473254,220.965030752675
"1970","gun",-3.2425589320952,191,18,173,26.1379473420317,164.862052657968
"2010","crowd",-3.24848559723907,130,13,117,20.0151541171993,109.984845882801
"2000","can try",-3.25119297737449,40,6,34,10.7634274884985,29.2365725115015
"2000","champion",-3.25119297737449,40,6,34,10.7634274884985,29.2365725115015
"2000","dice",-3.25119297737449,40,6,34,10.7634274884985,29.2365725115015
"2000","ears",-3.25119297737449,40,6,34,10.7634274884985,29.2365725115015
"2000","love long",-3.25119297737449,40,6,34,10.7634274884985,29.2365725115015
"2000","take care",-3.25119297737449,40,6,34,10.7634274884985,29.2365725115015
"1990","devil",-3.25915750674953,99,14,85,21.0023248970236,77.9976751029764
"1980","explain",-3.26339770789995,126,14,112,21.1977016830908,104.802298316909
"1960","fill",-3.26571244445259,191,6,185,11.4071452180389,179.592854781961
"1960","take away",-3.26571244445259,191,6,185,11.4071452180389,179.592854781961
"1960","full",-3.27334555798955,342,13,329,20.4253595003629,321.574640499637
"2000","breeze",-3.27416733610036,59,10,49,15.8760555455353,43.1239444544647
"2000","love true",-3.27416733610036,59,10,49,15.8760555455353,43.1239444544647
"2000","reality",-3.27416733610036,59,10,49,15.8760555455353,43.1239444544647
"2000","yeah dont",-3.27416733610036,59,10,49,15.8760555455353,43.1239444544647
"2000","youre everything",-3.27416733610036,59,10,49,15.8760555455353,43.1239444544647
"1970","east",-3.27495875538428,101,8,93,13.8216370761529,87.1783629238471
"1970","cars",-3.27687720759925,156,14,142,21.3482711275233,134.651728872477
"2000","youll see",-3.28107612814875,121,24,97,32.5593681527079,88.4406318472921
"1990","losing",-3.28135585843333,155,24,131,32.8824278690774,122.117572130923
"1990","means",-3.28135585843333,155,24,131,32.8824278690774,122.117572130923
"1980","right dont",-3.28144943382295,66,6,60,11.1035580244761,54.8964419755239
"2010","stone",-3.28183997034109,154,16,138,23.7102594926823,130.289740507318
"1990","keys",-3.28586199099064,70,9,61,14.8501287150672,55.1498712849328
"1970","girl dont",-3.28594982636879,165,15,150,22.5799021541112,142.420097845889
"1980","hands",-3.2862977930045,1018,150,868,171.263970741162,846.736029258838
"1990","can work",-3.28657969495407,64,8,56,13.57726053949,50.42273946051
"1980","pain",-3.29014497986878,524,73,451,88.1555212852348,435.844478714765
"1990","itll",-3.29316586949606,133,20,113,28.2152445586277,104.784755441372
"1970","lets get",-3.29367600508566,269,27,242,36.8120829057933,232.187917094207
"2000","write",-3.29448231935466,172,36,136,46.2827382005435,125.717261799456
"1990","girl love",-3.29858386147871,76,10,66,16.1229968906444,59.8770031093556
"1980","space",-3.3002130033056,119,13,106,20.0200515895858,98.9799484104142
"1990","im gonna",-3.30063424043211,1035,196,839,219.569760287065,815.430239712935
"2000","take another",-3.30070933124048,45,7,38,12.1088559245608,32.8911440754392
"1980","scream",-3.30487995515616,155,18,137,26.0765377847546,128.923462215245
"1990","time im",-3.30506954108213,177,28,149,37.5496111795271,139.450388820473
"1990","direction",-3.30534601612197,58,7,51,12.3043923639128,45.6956076360872
"1990","go im",-3.30534601612197,58,7,51,12.3043923639128,45.6956076360872
"2000","ill take",-3.30586053029619,151,31,120,40.6319387690818,110.368061230918
"1970","angels",-3.30622872991479,82,6,76,11.221527131134,70.778472868866
"1970","know much",-3.30622872991479,82,6,76,11.221527131134,70.778472868866
"1970","rock rock",-3.30622872991479,82,6,76,11.221527131134,70.778472868866
"1980","love hear",-3.30699872672196,74,7,67,12.4494438456248,61.5505561543752
"1980","meyou",-3.30699872672196,74,7,67,12.4494438456248,61.5505561543752
"1980","never see",-3.30699872672196,74,7,67,12.4494438456248,61.5505561543752
"1980","saved",-3.30699872672196,74,7,67,12.4494438456248,61.5505561543752
"1980","standin",-3.30699872672196,74,7,67,12.4494438456248,61.5505561543752
"2000","tear",-3.3092082953751,193,41,152,51.9335376320052,141.066462367995
"2000","seems",-3.30963465490599,477,111,366,128.353872800345,348.646127199655
"1960","remember",-3.31080141049184,894,41,853,53.3926064132293,840.607393586771
"1990","theres something",-3.31876961475545,122,18,104,25.8816529034029,96.1183470965971
"1990","break break",-3.32158748865236,82,11,71,17.3958650662216,64.6041349337784
"1990","laughing",-3.32158748865236,82,11,71,17.3958650662216,64.6041349337784
"1980","bomb",-3.32544715785567,97,10,87,16.3188655814271,80.6811344185729
"2000","new",-3.34296419644195,1223,301,922,329.091795460841,893.908204539159
"2000","way make",-3.34334214332188,104,20,84,27.9849114700961,76.0150885299039
"1970","every single",-3.34669020689259,92,7,85,12.590006049565,79.409993950435
"1970","show",-3.34699908257073,1443,174,1269,197.47150792959,1245.52849207041
"1990","eye",-3.34899857919502,263,44,219,55.7940550294668,207.205944970533
"1990","beginning",-3.34917226918897,52,6,46,11.0315241883356,40.9684758116644
"1990","shoulders",-3.34917226918897,52,6,46,11.0315241883356,40.9684758116644
"1980","chicks",-3.35148649738504,82,8,74,13.7953296667734,68.2046703332266
"1980","legs",-3.35148649738504,82,8,74,13.7953296667734,68.2046703332266
"1980","now cant",-3.35148649738504,82,8,74,13.7953296667734,68.2046703332266
"1990","chains",-3.35263518975591,88,12,76,18.6687332417988,69.3312667582012
"1990","never let go",-3.35263518975591,88,12,76,18.6687332417988,69.3312667582012
"2000","treat like",-3.35363485496219,82,15,67,22.0650263514219,59.9349736485781
"2000","cryin",-3.35657263120118,130,26,104,34.9811393376201,95.0188606623799
"1990","small",-3.36307626710884,111,16,95,23.548061248178,87.451938751822
"2000","dont stand",-3.36717842719102,50,8,42,13.4542843606231,36.5457156393769
"2000","girl got",-3.36717842719102,50,8,42,13.4542843606231,36.5457156393769
"2000","gone im",-3.36717842719102,50,8,42,13.4542843606231,36.5457156393769
"2000","grew",-3.36717842719102,50,8,42,13.4542843606231,36.5457156393769
"2000","heart im",-3.36717842719102,50,8,42,13.4542843606231,36.5457156393769
"2010","shout",-3.3755040810839,139,14,125,21.4008186330054,117.599181366995
"1960","friends",-3.37658771667394,762,34,728,45.5091343253699,716.49086567463
"1970","lean",-3.37687107206976,270,27,243,36.9489307976364,233.051069202364
"2000","insane",-3.37905995583337,91,17,74,24.4867975363341,66.5132024636659
"2000","know well",-3.37905995583337,91,17,74,24.4867975363341,66.5132024636659
"2010","can love",-3.37909240355492,73,6,67,11.2392788504273,61.7607211495727
"2010","dude",-3.37909240355492,73,6,67,11.2392788504273,61.7607211495727
"1970","save",-3.38858398483429,304,31,273,41.6017591203018,262.398240879698
"1960","way",-3.3971364144023,4483,239,4244,267.739434620254,4215.26056537975
"1980","fill",-3.39936685824078,191,23,168,32.1330239799234,158.866976020077
"1990","mean",-3.40245939530504,746,138,608,158.259943163431,587.740056836569
"1980","drank",-3.40947452902023,90,9,81,15.141215487922,74.858784512078
"2010","come get",-3.41213136215767,194,21,173,29.8687684518205,164.131231548179
"2010","think youre",-3.41536633001653,163,17,146,25.0959240084884,137.904075991512
"2010","playing",-3.41575123749247,217,24,193,33.409911103325,183.590088896675
"1990","goodbye",-3.42616290742814,410,72,338,86.979325331108,323.020674668892
"1990","cant believe",-3.42829351460196,145,22,123,30.7609809097821,114.239019090218
"1990","beauty",-3.43275364855224,100,14,86,21.2144695929532,78.7855304070468
"1990","go now",-3.43275364855224,100,14,86,21.2144695929532,78.7855304070468
"2000","different",-3.43373463099796,198,42,156,53.2789660680675,144.721033931932
"1970","never never",-3.4342848143325,121,10,111,16.5585949130148,104.441405086985
"2010","ive ever",-3.43740800557543,82,7,75,12.6249433662334,69.3750566337666
"2010","jungle",-3.43740800557543,82,7,75,12.6249433662334,69.3750566337666
"1990","sorry",-3.43963150809559,306,52,254,64.9162769544367,241.083723045563
"2000","can turn",-3.44569004353797,55,9,46,14.7997127966854,40.2002872033146
"2000","joe",-3.44569004353797,55,9,46,14.7997127966854,40.2002872033146
"2000","threw",-3.44569004353797,55,9,46,14.7997127966854,40.2002872033146
"1970","monday",-3.4495403256087,83,6,77,11.3583750229771,71.6416249770229
"2010","big",-3.45501867483259,964,128,836,148.420065915232,815.579934084768
"1990","crying",-3.459667698509,216,35,181,45.8232543207788,170.176745679221
"1980","baby ooh",-3.46074075501386,67,6,61,11.2717937521197,55.7282062478803
"2000","fallin love",-3.46313221834105,78,14,64,20.9886836025721,57.0113163974279
"2000","law",-3.46313221834105,78,14,64,20.9886836025721,57.0113163974279
"2000","somethings",-3.46313221834105,78,14,64,20.9886836025721,57.0113163974279
"2000","suddenly",-3.46313221834105,78,14,64,20.9886836025721,57.0113163974279
"1990","hearts",-3.4671799975095,322,55,267,68.3105920893092,253.689407910691
"1980","dont care",-3.46731188039976,355,47,308,59.7236833134702,295.27631668653
"2000","anywhere",-3.46786732796522,122,24,98,32.8284538399204,89.1715461600796
"1960","back",-3.47129557886924,3938,208,3730,235.190250621138,3702.80974937886
"1990","dont need",-3.47462320766112,395,69,326,83.797154892165,311.202845107835
"1960","change",-3.47799724365462,823,37,786,49.1522540023352,773.847745997665
"1980","comfort",-3.47806480565386,75,7,68,12.6176795732683,62.3823204267317
"2000","cant hold",-3.47864750135343,69,12,57,18.5669124176599,50.4330875823401
"1980","feelin",-3.47888978976538,494,68,426,83.1084494559275,410.891550544073
"1970","pay",-3.4803491862202,322,33,289,44.0650211734775,277.934978826522
"1990","just cant",-3.48049142165149,493,88,405,104.587335093259,388.412664906741
"1980","huh",-3.48824604950502,618,87,531,103.969679683731,514.030320316269
"1980","cant live",-3.4894497532966,113,12,101,19.0106372237243,93.9893627762757
"1990","anytime",-3.4895873150041,71,9,62,15.0622734109967,55.9377265890033
"1990","say name",-3.4895873150041,71,9,62,15.0622734109967,55.9377265890033
"2010","youi",-3.49443800720269,233,26,207,35.8733146869803,197.12668531302
"1990","evil",-3.49528333095764,77,10,67,16.3351415865739,60.6648584134261
"1990","know id",-3.49528333095764,77,10,67,16.3351415865739,60.6648584134261
"1990","beer",-3.49860610988387,65,8,57,13.7894052354196,51.2105947645804
"2010","brand",-3.50391830008651,148,15,133,22.7864831488115,125.213516851188
"1970","youll never",-3.50501314812671,176,16,160,24.0852289643852,151.914771035615
"1990","spin",-3.51226340472246,83,11,72,17.6080097621511,65.3919902378489
"2010","thunder",-3.51274007233601,91,8,83,14.0106078820395,76.9893921179605
"1970","name",-3.51358681351487,977,114,863,133.700390330707,843.299609669293
"2010","follow",-3.51629181500542,218,24,194,33.5638738273035,184.436126172697
"2000","queen",-3.51844054043346,148,30,118,39.8246817074444,108.175318292556
"2000","little bit",-3.52024468836459,419,96,323,112.746902942022,306.253097057978
"1990","spend",-3.52316652472361,291,49,242,61.7341065154937,229.265893484506
"2000","turning",-3.52380572570567,165,34,131,44.3991383900563,120.600861609944
"1970","see im",-3.52493465487275,131,11,120,17.9270738314458,113.072926168554
"1970","want back",-3.52493465487275,131,11,120,17.9270738314458,113.072926168554
"1980","sometimes",-3.52499423174988,442,60,382,74.3601916184614,367.639808381539
"1990","aint way",-3.52733071374155,59,7,52,12.5165370598424,46.4834629401576
"1990","im lookin",-3.52733071374155,59,7,52,12.5165370598424,46.4834629401576
"2010","just let",-3.53017415850902,164,17,147,25.2498867324668,138.750113267533
"2000","heavens",-3.53306766884029,60,10,50,16.1451412327477,43.8548587672523
"2000","million",-3.5331576992517,207,44,163,55.7007372529797,151.29926274702
"1990","say hey",-3.538089628067,89,12,77,18.8808779377283,70.1191220622717
"2010","happy",-3.53944238597808,520,65,455,80.0606164687973,439.939383531203
"2010","mother",-3.54938861770543,172,18,154,26.4815885242945,145.518411475706
"1970","youre just",-3.55683310923886,122,10,112,16.6954428048579,105.304557195142
"2000","aside",-3.55740655764005,41,6,35,11.032513175711,29.9674868242891
"2000","grace",-3.55740655764005,41,6,35,11.032513175711,29.9674868242891
"2000","im doin",-3.55740655764005,41,6,35,11.032513175711,29.9674868242891
"2000","oh come",-3.55740655764005,41,6,35,11.032513175711,29.9674868242891
"2000","pity",-3.55740655764005,41,6,35,11.032513175711,29.9674868242891
"2000","willing",-3.55740655764005,41,6,35,11.032513175711,29.9674868242891
"2000","wont know",-3.55740655764005,41,6,35,11.032513175711,29.9674868242891
"1990","shes got",-3.56651192675345,168,26,142,35.6403089161613,132.359691083839
"1980","cant live without",-3.56839090640396,91,9,82,15.3094512155656,75.6905487844344
"1960","blame",-3.570609004154,263,9,254,15.7072209023258,247.292779097674
"1990","broke",-3.57137031528885,233,38,195,49.4297141515809,183.570285848419
"1980","cause love",-3.57837425571205,121,13,108,20.3565230448729,100.643476955127
"1970","playin",-3.58145303554454,212,20,192,29.0117530707368,182.988246929263
"1990","bleed",-3.58332390940389,53,6,47,11.2436688842652,41.7563311157348
"1990","break break break",-3.58332390940389,53,6,47,11.2436688842652,41.7563311157348
"1990","dont call",-3.58332390940389,53,6,47,11.2436688842652,41.7563311157348
"1990","hug",-3.58332390940389,53,6,47,11.2436688842652,41.7563311157348
"1990","like first",-3.58332390940389,53,6,47,11.2436688842652,41.7563311157348
"1990","wanna take",-3.58362255006973,118,17,101,25.0330741196847,92.9669258803153
"2000","church",-3.58652511938708,74,13,61,19.9123408537222,54.0876591462778
"2010","away dont",-3.59445807346428,83,7,76,12.7789060902119,70.2210939097881
"2010","make go",-3.59445807346428,83,7,76,12.7789060902119,70.2210939097881
"1970","watchin",-3.59472970892292,84,6,78,11.4952229148202,72.5047770851798
"2000","will never",-3.59489029298381,253,55,198,68.078678864753,184.921321135247
"2000","feet",-3.59603226624728,347,78,269,93.3727334627244,253.627266537276
"2010","know mean",-3.60015933538853,100,9,91,15.3962723978456,84.6037276021544
"2010","never know",-3.60015933538853,100,9,91,15.3962723978456,84.6037276021544
"1980","stop",-3.60658167818922,1555,234,1321,261.606556485764,1293.39344351424
"1990","women",-3.6084403978002,201,32,169,42.6410838818359,158.358916118164
"1960","just cant",-3.60850262328086,493,20,473,29.4435737826869,463.556426217313
"1990","years",-3.60955194553362,412,72,340,87.403614722967,324.596385277033
"1960","standing",-3.61469860787473,307,11,296,18.3350449316123,288.664955068388
"1960","somebody",-3.61724592987917,672,29,643,40.1340397200113,631.865960279989
"2000","real love",-3.62714237297099,101,19,82,27.1776544084587,73.8223455915413
"2010","dont stop",-3.63113172001242,317,37,280,48.8061835011706,268.193816498829
"1980","golden",-3.63173264648704,99,10,89,16.6553370367142,82.3446629632858
"1980","im man",-3.63173264648704,99,10,89,16.6553370367142,82.3446629632858
"1980","wash",-3.63173264648704,99,10,89,16.6553370367142,82.3446629632858
"1960","aint",-3.63192947843926,3592,188,3404,214.525998027203,3377.4740019728
"1990","wanna know",-3.6329109126467,212,34,178,44.9746755370607,167.025324462939
"2010","piece",-3.63348177075761,157,16,141,24.1721476646176,132.827852335382
"1980","mouth",-3.63535902442796,179,21,158,30.1141952482004,148.8858047518
"1990","yet",-3.63901354182643,174,27,147,36.9131770917385,137.086822908261
"1980","run run",-3.64296857550045,68,6,62,11.4400294797633,56.5599705202367
"1980","turn turn",-3.64296857550045,68,6,62,11.4400294797633,56.5599705202367
"2000","send",-3.64308202794506,191,40,151,51.3953662575803,139.60463374242
"1970","bought",-3.6445482341395,132,11,121,18.0639217232889,113.936078276711
"1990","everybodys",-3.64477874942183,152,23,129,32.2459937812888,119.754006218711
"1960","bed",-3.64587353682273,350,13,337,20.9031456875059,329.096854312494
"2000","honestly",-3.64914453651174,51,8,43,13.7233700478356,37.2766299521644
"2000","love cause",-3.64914453651174,51,8,43,13.7233700478356,37.2766299521644
"2000","shower",-3.64914453651174,51,8,43,13.7233700478356,37.2766299521644
"1980","force",-3.65187625264967,76,7,69,12.7859153009119,63.2140846990881
"1990","bed",-3.65316130732488,350,60,290,74.2506435753361,275.749356424664
"2010","one thing",-3.65515052870172,204,22,182,31.4083956916051,172.591604308395
"1970","thats way",-3.65582732101341,204,19,185,27.916969935992,176.083030064008
"1990","go back",-3.66391261273755,141,21,120,29.912402126064,111.087597873936
"2010","say youre",-3.66413711053151,92,8,84,14.164570606018,77.835429393982
"2010","surprise",-3.66413711053151,92,8,84,14.164570606018,77.835429393982
"1970","cmon",-3.66714813513163,239,23,216,32.7066461505004,206.2933538495
"1970","never gonna",-3.66714813513163,239,23,216,32.7066461505004,206.2933538495
"2000","share",-3.66822695087374,237,51,186,63.7733078693536,173.226692130646
"2000","run",-3.67894399625408,1088,265,823,292.765227687159,795.234772312841
"1970","star",-3.6894798708638,375,39,336,51.3179594411617,323.682040558838
"2000","key",-3.6940124800557,149,30,119,40.0937673946569,108.906232605343
"2000","ooh yeah",-3.69717699906671,79,14,65,21.2577692897845,57.7422307102155
"1980","ill take",-3.70030309215118,151,17,134,25.4035948741803,125.59640512582
"1990","im crazy",-3.70662102315679,84,11,73,17.8201544580807,66.1798455419193
"2000","bye",-3.7076558113637,183,38,145,49.2426807598806,133.757319240119
"2010","sweeter",-3.70960785222744,75,6,69,11.5472042983842,63.4527957016158
"2010","take look",-3.70960785222744,75,6,69,11.5472042983842,63.4527957016158
"1970","spot",-3.71468463133499,178,16,162,24.3589247480714,153.641075251929
"1990","oh girl",-3.71495159959708,66,8,58,14.0015499313491,51.9984500686509
"1970","making",-3.71637175255042,367,38,329,50.2231763064169,316.776823693583
"2000","heart can",-3.71873523106574,56,9,47,15.0687984838979,40.9312015161021
"2000","hed",-3.71873523106574,56,9,47,15.0687984838979,40.9312015161021
"1970","pain",-3.72050568897803,524,57,467,71.7082953257833,452.291704674217
"2000","crime",-3.7264740296548,70,12,58,18.8359981048724,51.1640018951276
"1980","like girl",-3.72971966794529,92,9,83,15.4776869432092,76.5223130567908
"1980","look back",-3.72971966794529,92,9,83,15.4776869432092,76.5223130567908
"1980","paper",-3.72971966794529,92,9,83,15.4776869432092,76.5223130567908
"1980","whatcha gonna",-3.72971966794529,92,9,83,15.4776869432092,76.5223130567908
"2000","door",-3.73614647412602,597,140,457,160.64415526584,436.35584473416
"1980","baby can",-3.74112712869764,194,23,171,32.6377311628541,161.362268837146
"1980","cause youre",-3.74112712869764,194,23,171,32.6377311628541,161.362268837146
"1990","today",-3.74181321720974,377,65,312,79.9785503654334,297.021449634567
"2010","wind",-3.74597205485239,348,41,307,53.5790279445028,294.420972055497
"1960","youre",-3.74870403252785,6592,357,6235,393.695818205825,6198.30418179417
"1990","park",-3.75079373200215,119,17,102,25.2452188156143,93.7547811843857
"2000","just way",-3.75191014398364,106,20,86,28.523082844521,77.476917155479
"2010","im crazy",-3.75372772167863,84,7,77,12.9328688141903,71.0671311858097
"2010","comes",-3.75444687335523,702,90,612,108.081832232876,593.918167767124
"1970","know youll",-3.76273081456377,95,7,88,13.0005497250943,81.9994502749057
"1980","soul",-3.78509752938377,642,90,552,108.007337147177,533.992662852823
"1980","help",-3.78614139072664,765,109,656,128.700331647337,636.299668352663
"1990","locked",-3.78964464978545,102,14,88,21.6387589848122,80.3612410151878
"1960","wasnt",-3.79300536007279,245,8,237,14.6322019812541,230.367798018746
"2010","love can",-3.7970593645582,182,19,163,28.021215764079,153.978784235921
"2000","changing",-3.79863579195894,61,10,51,16.4142269199602,44.5857730800398
"2010","asked",-3.79953767259953,118,11,107,18.1676014294578,99.8323985705422
"2010","lock",-3.79953767259953,118,11,107,18.1676014294578,99.8323985705422
"1970","respect",-3.80629621124138,124,10,114,16.9691385885441,107.030861411456
"2000","wont come",-3.81009201774321,84,15,69,22.6031977258468,61.3968022741532
"1980","whole world",-3.81030794619753,130,14,116,21.8706445936651,108.129355406335
"2010","control",-3.8161234884389,371,44,327,57.1201705960073,313.879829403993
"1970","somehow",-3.81932911579437,170,15,155,23.2641416133266,146.735858386673
"1960","shot",-3.81988971077201,223,7,216,13.3182899666109,209.681710033389
"1990","someones",-3.82229386392181,54,6,48,11.4558135801947,42.5441864198053
"1990","sing",-3.82565153795471,620,112,508,131.52971147631,488.47028852369
"1980","ill ever",-3.82804303437126,69,6,63,11.6082652074069,57.3917347925931
"1980","youll always",-3.82804303437126,69,6,63,11.6082652074069,57.3917347925931
"1990","even",-3.84334956237118,1219,231,988,258.604384338099,960.395615661901
"2010","babe",-3.84335471932143,675,86,589,103.924838685458,571.075161314542
"1980","crack",-3.85236784541985,85,8,77,14.3000368497041,70.6999631502959
"1980","fit",-3.85236784541985,85,8,77,14.3000368497041,70.6999631502959
"1980","unless",-3.85236784541985,85,8,77,14.3000368497041,70.6999631502959
"1980","scared",-3.85784111492612,195,23,172,32.8059668904977,162.194033109502
"1970","escape",-3.86351713757948,115,9,106,15.7375075619563,99.2624924380437
"1970","hair",-3.86906681199012,369,38,331,50.4968720901031,318.503127909897
"1990","left",-3.86999405815401,889,165,724,188.596634681354,700.403365318646
"2000","georgia",-3.87198544671525,42,6,36,11.3015988629234,30.6984011370766
"2000","im walking",-3.87198544671525,42,6,36,11.3015988629234,30.6984011370766
"2000","tonight yeah",-3.87198544671525,42,6,36,11.3015988629234,30.6984011370766
"2010","land",-3.87265258250951,151,15,136,23.2483713207469,127.751628679253
"1960","special",-3.87538262009261,201,6,195,12.0043779519677,188.995622048032
"2010","say dont",-3.87639410766204,143,14,129,22.0166695289193,120.983330471081
"2010","force",-3.87837712935095,76,6,70,11.7011670223627,64.2988329776373
"2010","peace",-3.88298800671057,167,17,150,25.7117749044022,141.288225095598
"2000","fly like",-3.88637443572432,66,11,55,17.7596553560225,48.2403446439775
"2000","right dont",-3.88637443572432,66,11,55,17.7596553560225,48.2403446439775
"2000","waste time",-3.88637443572432,66,11,55,17.7596553560225,48.2403446439775
"1970","steady",-3.89055893653431,86,6,80,11.7689186985064,74.2310813014936
"1970","want come",-3.89055893653431,86,6,80,11.7689186985064,74.2310813014936
"1980","left",-3.89229762630972,889,128,761,149.561561875141,739.438438124859
"2000","baby dont know",-3.89410322082115,47,7,40,12.6470272989857,34.3529727010143
"2000","feel like im",-3.89410322082115,47,7,40,12.6470272989857,34.3529727010143
"2000","gonna run",-3.89410322082115,47,7,40,12.6470272989857,34.3529727010143
"1990","boom",-3.89942455953056,305,51,254,64.7041322585071,240.295867741493
"1990","come home",-3.90020756371318,79,10,69,16.759430978433,62.240569021567
"1990","jesus",-3.90020756371318,79,10,69,16.759430978433,62.240569021567
"1990","now just",-3.90020756371318,79,10,69,16.759430978433,62.240569021567
"2000","comes",-3.90219989455029,702,166,536,188.898152423149,513.101847576851
"1990","pants",-3.90456667255431,85,11,74,18.0322991540102,66.9677008459898
"1990","buy",-3.91423116747098,225,36,189,47.7325565841446,177.267443415855
"2010","someone else",-3.91516203982132,85,7,78,13.0868315381688,71.9131684618312
"1990","im falling",-3.91942229968853,91,12,79,19.3051673295874,71.6948326704126
"1960","met",-3.92011256727226,313,11,302,18.6933845719695,294.30661542803
"1970","broke",-3.92038683893515,233,22,211,31.8855587994418,201.114441200558
"1970","youi",-3.92038683893515,233,22,211,31.8855587994418,201.114441200558
"2000","well im",-3.92487744568479,89,16,73,23.9486261619091,65.0513738380909
"1970","need love",-3.92879531917952,180,16,164,24.6326205317576,155.367379468242
"1990","can never",-3.93547736670869,67,8,59,14.2136946272786,52.7863053727214
"2000","baby yeah",-3.93667509263428,80,14,66,21.526854976997,58.473145023003
"2000","hits",-3.93667509263428,80,14,66,21.526854976997,58.473145023003
"2000","disappear",-3.93840826762905,52,8,44,13.992455735048,38.007544264952
"2000","give heart",-3.93840826762905,52,8,44,13.992455735048,38.007544264952
"2000","knocked",-3.93840826762905,52,8,44,13.992455735048,38.007544264952
"2000","shook",-3.93840826762905,52,8,44,13.992455735048,38.007544264952
"1970","know now",-3.9419787817202,106,8,98,14.5058765353684,91.4941234646316
"1970","different",-3.94313979164263,198,18,180,27.0958825849334,170.904117415067
"1970","single",-3.94313979164263,198,18,180,27.0958825849334,170.904117415067
"1990","now im",-3.94697195661602,555,99,456,117.74030624089,437.25969375911
"2000","bang",-3.95740760950171,239,51,188,64.3114792437785,174.688520756222
"1990","tomorrow",-3.9609577265005,279,46,233,59.1883701643393,219.811629835661
"1980","grow",-3.96603651337749,210,25,185,35.3295028051514,174.670497194849
"1990","slowly",-3.97142865741409,126,18,108,26.730231687121,99.269768312879
"1990","brought",-3.97280310915095,103,14,89,21.8509036807418,81.1490963192582
"1960","line",-3.97322627120496,461,18,443,27.5324290341149,433.467570965885
"1990","love get",-3.98483128299093,61,7,54,12.9408264517014,48.0591735482986
"1990","mall",-3.98483128299093,61,7,54,12.9408264517014,48.0591735482986
"2010","hips",-3.99851343775954,152,15,137,23.4023340447254,128.597665955275
"2000","died",-4.00258124130051,116,22,94,31.2139397166456,84.7860602833544
"2000","cant go",-4.00602373616429,231,49,182,62.1587937460788,168.841206253921
"1980","love forever",-4.00743673724127,78,7,71,13.1223867561991,64.8776132438009
"1970","wouldnt",-4.00853366271415,421,44,377,57.6129624659442,363.387037534056
"1990","get way",-4.00856413770849,109,15,94,23.1237718563189,85.8762281436811
"1970","ends",-4.01156794414313,135,11,124,18.4744653988182,116.525534601182
"1980","come let",-4.01587833618795,70,6,64,11.7765009350505,58.2234990649496
"1980","baby now",-4.02430090087963,86,8,78,14.4682725773477,71.5317274226523
"1980","chain",-4.02430090087963,86,8,78,14.4682725773477,71.5317274226523
"1980","like baby",-4.02430090087963,86,8,78,14.4682725773477,71.5317274226523
"1990","ha ha ha",-4.02474326153194,132,19,113,28.0030998626982,103.996900137302
"1990","beat",-4.02673113708829,765,140,625,162.290692386092,602.709307613908
"2010","holding",-4.02679529332529,299,34,265,46.0348544695584,252.965145530442
"2000","doubt",-4.0361638644133,185,38,147,49.7808521343055,135.219147865694
"1980","feels like",-4.03701973938533,168,19,149,28.2636022441211,139.736397755879
"1990","beautiful",-4.04489766727316,515,91,424,109.254518403709,405.745481596291
"2010","yall",-4.04743560852379,621,78,543,95.6108515906214,525.389148409379
"1960","pain",-4.04831852314793,524,21,503,31.2949952578659,492.705004742134
"1970","rock",-4.05399221664414,1320,156,1164,180.639217232889,1139.36078276711
"1990","good lovin",-4.06589434549815,55,6,49,11.6679582761242,43.3320417238758
"1990","somebody love",-4.06589434549815,55,6,49,11.6679582761242,43.3320417238758
"2000","got much",-4.07063376064268,62,10,52,16.6833126071727,45.3166873928273
"2010","hearts",-4.07223459451442,322,37,285,49.5759971210629,272.424002878937
"1990","new",-4.07311009237876,1223,231,992,259.452963121817,963.547036878183
"2010","chain",-4.0787081314957,86,7,79,13.2407942621472,72.7592057378528
"2010","dont come",-4.0787081314957,86,7,79,13.2407942621472,72.7592057378528
"2010","time dont",-4.0787081314957,86,7,79,13.2407942621472,72.7592057378528
"2010","will make",-4.0787081314957,86,7,79,13.2407942621472,72.7592057378528
"2000","love life",-4.07889146735884,76,13,63,20.4505122281471,55.5494877718529
"1960","break",-4.08307450293597,977,44,933,58.3496381048378,918.650361895162
"2000","youd",-4.08598663482591,412,93,319,110.863303131534,301.136696868466
"2000","perfect",-4.08804992346338,219,46,173,58.9297654995292,160.070234500471
"1960","fly",-4.09211145062907,764,33,731,45.6285808721557,718.371419127844
"1990","driving",-4.09348949059429,121,17,104,25.6695082074733,95.3304917925267
"1980","hip",-4.09502935826793,132,14,118,22.2071160489523,109.792883951048
"1980","breath",-4.10519095202525,260,32,228,43.7412891873303,216.25871081267
"1990","baby now",-4.10601021705684,86,11,75,18.2444438499397,67.7555561500603
"1990","dont come",-4.10601021705684,86,11,75,18.2444438499397,67.7555561500603
"1990","steady",-4.10601021705684,86,11,75,18.2444438499397,67.7555561500603
"1980","lifes",-4.10807065664797,102,10,92,17.1600442196449,84.8399557803551
"1980","locked",-4.10807065664797,102,10,92,17.1600442196449,84.8399557803551
"1990","paper",-4.11513682728607,92,12,80,19.5173120255169,72.4826879744831
"2000","york",-4.11832763120391,177,36,141,47.6281666366058,129.371833363394
"1960","roll",-4.12266096680814,804,35,769,48.0175118078706,755.982488192129
"1990","ha ha ha ha",-4.12482238306313,74,9,65,15.6987074987853,58.3012925012147
"1990","im talking",-4.12482238306313,74,9,65,15.6987074987853,58.3012925012147
"1990","record",-4.12482238306313,74,9,65,15.6987074987853,58.3012925012147
"1990","will will",-4.12482238306313,74,9,65,15.6987074987853,58.3012925012147
"2010","youre youre",-4.13056747680549,95,8,87,14.6264587779533,80.3735412220467
"2010","wait",-4.13081393002037,758,97,661,116.70374477567,641.29625522433
"2010","voice",-4.13253666158768,177,18,159,27.2514021441868,149.748597855813
"1980","speak",-4.13583548947738,147,16,131,24.730651963606,122.269348036394
"1960","minute",-4.13848033270476,251,8,243,14.9905416216114,236.009458378389
"1970","play",-4.14471714575122,1125,131,994,153.953878323485,971.046121676515
"2000","drank",-4.15788407565391,90,16,74,24.2177118491216,65.7822881508784
"2000","let show",-4.15788407565391,90,16,74,24.2177118491216,65.7822881508784
"1980","baby come",-4.15830371421902,125,13,112,21.0294659554472,103.970534044553
"2000","got time",-4.15889611868733,99,18,81,26.6394830340338,72.3605169659662
"2000","wash",-4.15889611868733,99,18,81,26.6394830340338,72.3605169659662
"1990","big",-4.16988478868164,964,179,785,204.507486876068,759.492513123931
"2000","someday",-4.17248122725877,143,28,115,38.4792532713821,104.520746728618
"2000","much love",-4.17803361055923,108,20,88,29.0612542189459,78.9387457810541
"2000","know feel",-4.18147672496545,81,14,67,21.7959406642094,59.2040593357906
"2000","will see",-4.18147672496545,81,14,67,21.7959406642094,59.2040593357906
"1960","cant",-4.18642909135974,5338,284,5054,318.802833371161,5019.19716662884
"1990","boy",-4.18786707641728,1613,309,1304,342.189394534334,1270.81060546567
"1980","foot",-4.18904401907365,79,7,72,13.2906224838427,65.7093775161573
"1970","problem",-4.19104511947826,127,10,117,17.3796822640734,109.620317735927
"1970","way love",-4.19250793481211,227,21,206,31.0644714483832,195.935528551617
"1970","confused",-4.19385132707673,98,7,91,13.4110934006236,84.5889065993764
"2000","never can",-4.19450349024842,43,6,37,11.5706845501359,31.4293154498641
"2000","night just",-4.19450349024842,43,6,37,11.5706845501359,31.4293154498641
"2000","stayin",-4.19450349024842,43,6,37,11.5706845501359,31.4293154498641
"1970","hope",-4.19535377774416,523,56,467,71.5714474339402,451.42855256606
"2010","quite",-4.19860360048057,104,9,95,16.0121232937595,87.9878767062406
"1980","like never",-4.19861934639876,87,8,79,14.6365083049913,72.3634916950087
"1990","waiting",-4.20199939527735,686,124,562,145.531261407659,540.468738592341
"2000","said dont",-4.20215196559138,48,7,41,12.9161129861982,35.0838870138018
"1990","boogie",-4.20253322550462,313,52,261,66.4012898259434,246.598710174057
"2000","gets",-4.20515245589976,352,78,274,94.7181618987867,257.281838101213
"1990","can say",-4.20770213621742,189,29,160,40.0953475306815,148.904652469319
"1980","different",-4.21615287795437,198,23,175,33.3106740734284,164.689325926572
"1970","grab",-4.21898375726905,146,12,134,19.9797922090923,126.020207790908
"1990","bullet",-4.22003397369633,62,7,55,13.152971147631,48.847028852369
"1990","got right",-4.22003397369633,62,7,55,13.152971147631,48.847028852369
"2010","suddenly",-4.22262257612033,78,6,72,12.0090924703196,65.9909075296804
"2010","cause love",-4.22325806470114,121,11,110,18.6294896013932,102.370510398607
"2010","glad",-4.22474831461666,217,23,194,33.409911103325,183.590088896675
"1960","thinkin",-4.23092432202239,362,13,349,21.6198249682204,340.38017503178
"1980","trying",-4.23293983035065,504,68,436,84.7908067323633,419.209193267637
"1980","know need",-4.234331006214,118,12,106,19.8518158619422,98.1481841380578
"2000","hoo hoo",-4.23466654863829,53,8,45,14.2615414222605,38.7384585777395
"2000","limit",-4.23466654863829,53,8,45,14.2615414222605,38.7384585777395
"2000","say know",-4.23466654863829,53,8,45,14.2615414222605,38.7384585777395
"2000","will know",-4.23466654863829,53,8,45,14.2615414222605,38.7384585777395
"2000","yeah come",-4.23466654863829,53,8,45,14.2615414222605,38.7384585777395
"2010","make right",-4.24431501694395,87,7,80,13.3947569861257,73.6052430138743
"1980","anything",-4.26691078478409,636,88,548,106.997922781316,529.002077218684
"1980","brought",-4.27117295041677,103,10,93,17.3282799472885,85.6717200527115
"2010","mmm",-4.27612655215742,194,20,174,29.8687684518205,164.131231548179
"2010","time time",-4.27612655215742,194,20,174,29.8687684518205,164.131231548179
"2000","burning",-4.27656869189358,216,45,171,58.1225084378919,157.877491562108
"2000","bringing",-4.28508620520154,58,9,49,15.6069698583228,42.3930301416772
"2000","human",-4.28508620520154,58,9,49,15.6069698583228,42.3930301416772
"2000","highway",-4.28726035434939,86,15,71,23.1413691002718,62.8586308997282
"2010","number one",-4.28997453906129,96,8,88,14.7804215019318,81.2195784980682
"2000","ill give",-4.29190242101557,178,36,142,47.8972523238183,130.102747676182
"2010","slow",-4.29534321577278,567,70,497,87.2968644957847,479.703135504215
"2010","sun",-4.29717676902506,675,85,590,103.924838685458,571.075161314542
"1980","baby let",-4.30800975650997,126,13,113,21.1977016830908,104.802298316909
"1990","long way",-4.31394834722908,56,6,50,11.8801029720538,44.1198970279462
"1990","stop dont",-4.31394834722908,56,6,50,11.8801029720538,44.1198970279462
"1990","lets make",-4.31411244744055,93,12,81,19.7294567214464,73.2705432785536
"1980","know got",-4.31649679638084,213,25,188,35.8342099880821,177.165790011918
"1960","chance",-4.318409705026,510,20,490,30.4588694303657,479.541130569634
"1990","two three",-4.32716516598059,99,13,86,21.0023248970236,77.9976751029764
"2000","bad boy",-4.33330146066264,77,13,64,20.7195979153596,56.2804020846404
"2010","turn around",-4.33559821613403,218,23,195,33.5638738273035,184.436126172697
"1970","deeper",-4.34074350746338,99,7,92,13.5479412924667,85.4520587075333
"1970","im man",-4.34074350746338,99,7,92,13.5479412924667,85.4520587075333
"2000","son",-4.34524540492038,208,43,165,55.9698229401922,152.030177059808
"1970","else can",-4.3472855161709,89,6,83,12.1794623740357,76.8205376259643
"1970","like rock",-4.3472855161709,89,6,83,12.1794623740357,76.8205376259643
"1970","nothings",-4.3472855161709,89,6,83,12.1794623740357,76.8205376259643
"1980","summer",-4.3483834949911,331,42,289,55.6860258500243,275.313974149976
"2000","bigger",-4.34883617550132,63,10,53,16.9523982943851,46.0476017056149
"2000","listening",-4.34883617550132,63,10,53,16.9523982943851,46.0476017056149
"1970","im never",-4.36093307996733,109,8,101,14.9164202108977,94.0835797891023
"1990","twice",-4.36189025309339,134,19,115,28.4273892545572,105.572610745443
"1960","ever",-4.37103363623045,2130,105,2025,127.210572326822,2002.78942767318
"1980","gotta keep",-4.37311283999542,80,7,73,13.4588582114862,66.5411417885138
"1980","dry",-4.37526591176393,88,8,80,14.8047440326349,73.1952559673651
"1980","oh yeah oh",-4.37526591176393,88,8,80,14.8047440326349,73.1952559673651
"1990","good times",-4.37589478843275,111,15,96,23.548061248178,87.451938751822
"2010","even though",-4.38466133689255,155,15,140,23.8642222166607,131.135777783339
"2000","beauty",-4.3867008326642,100,18,82,26.9085687212462,73.0914312787538
"2000","gimme gimme",-4.3867008326642,100,18,82,26.9085687212462,73.0914312787538
"1980","rich",-4.38694224722033,134,14,120,22.5435875042394,111.456412495761
"1990","drama",-4.38854709999068,69,8,61,14.6379840191377,54.3620159808623
"2010","four",-4.39349489315206,195,20,175,30.022731175799,164.977268824201
"2000","doctor",-4.39569587580826,91,16,75,24.4867975363341,66.5132024636659
"2000","dont feel",-4.39745289813787,109,20,89,29.3303399061584,79.6696600938416
"2010","climb",-4.39797983697119,79,6,73,12.163055194298,66.8369448057019
"2010","ghetto",-4.39797983697119,79,6,73,12.163055194298,66.8369448057019
"1980","deal",-4.39808647320764,96,9,87,16.1506298537835,79.8493701462165
"1980","back home",-4.39950718143699,72,6,66,12.1129723903376,59.8870276096624
"1980","everybody everybody",-4.39950718143699,72,6,66,12.1129723903376,59.8870276096624
"1970","wide",-4.40008668005894,166,14,152,22.7167500459543,143.283249954046
"1960","daddy",-4.40854444501858,344,12,332,20.5448060471486,323.455193952851
"1980","say im",-4.41817477132984,242,29,213,40.7130460897459,201.286953910254
"2000","leaving",-4.42095919601926,200,41,159,53.8171374424925,146.182862557508
"2000","look around",-4.42278281791671,68,11,57,18.2978267304474,49.7021732695526
"2000","ill tell",-4.42320408023186,118,22,96,31.7521110910705,86.2478889089295
"2010","like way",-4.42659931080893,211,22,189,32.4861347594543,178.513865240546
"2000","flame",-4.43143822666799,82,14,68,22.0650263514219,59.9349736485781
"2000","ive ever",-4.43143822666799,82,14,68,22.0650263514219,59.9349736485781
"1960","love like",-4.44630907857582,301,10,291,17.9767052912551,283.023294708745
"1980","dig",-4.44708517327132,207,24,183,34.8247956222206,172.175204377779
"1990","ghost",-4.45934284124214,63,7,56,13.3651158435605,49.6348841564395
"2010","simple",-4.46418887527995,131,12,119,20.1691168411778,110.830883158822
"2000","lonely",-4.4670095517993,748,176,572,201.276094034922,546.723905965078
"1970","bill",-4.48917288262276,100,7,93,13.6847891843098,86.3152108156902
"1980","na na",-4.49734458126557,1366,201,1165,229.810003961127,1136.18999603887
"2000","take home",-4.49862031097399,162,32,130,43.5918813284189,118.408118671581
"1990","keep",-4.50098111112506,2547,497,2050,540.332540532517,2006.66745946748
"1970","asking",-4.50282867713215,90,6,84,12.3163102658788,77.6836897341212
"1970","go oh",-4.50282867713215,90,6,84,12.3163102658788,77.6836897341212
"1970","tell im",-4.50352913629266,110,8,102,15.0532681027408,94.9467318972592
"2010","ocean",-4.50891053110299,106,9,97,16.3200487417164,89.6799512582836
"2000","young",-4.50955687883437,589,136,453,158.49146976814,430.50853023186
"1970","afraid",-4.51201966682885,239,22,217,32.7066461505004,206.2933538495
"1960","room",-4.51412602122607,389,14,375,23.232353349828,365.767646650172
"2010","cars",-4.51616779375252,156,15,141,24.0181849406392,131.981815059361
"2000","get ready",-4.5173163545011,49,7,42,13.1851986734107,35.8148013265894
"1990","like just",-4.51904708056185,88,11,77,18.6687332417988,69.3312667582012
"1990","breaking",-4.52117779979566,152,22,130,32.2459937812888,119.754006218711
"1990","pieces",-4.52401764582796,100,13,87,21.2144695929532,78.7855304070468
"2010","feels",-4.52433796753015,446,53,393,68.6673748943915,377.332625105608
"2000","cries",-4.52456634916443,44,6,38,11.8397702373483,32.1602297626517
"2000","id love",-4.52456634916443,44,6,38,11.8397702373483,32.1602297626517
"2000","still one",-4.52456634916443,44,6,38,11.8397702373483,32.1602297626517
"2000","went away",-4.52456634916443,44,6,38,11.8397702373483,32.1602297626517
"1990","shoulder",-4.53418293521336,135,19,116,28.6395339504868,106.360466049513
"1980","leave",-4.53496682424613,1265,185,1080,212.818195469126,1052.18180453087
"2000","breaks",-4.53763484443345,54,8,46,14.530627109473,39.469372890527
"2000","play game",-4.53763484443345,54,8,46,14.530627109473,39.469372890527
"2000","put em",-4.53763484443345,54,8,46,14.530627109473,39.469372890527
"1990","ball",-4.53955045040405,169,25,144,35.8524536120908,133.147546387909
"1960","try",-4.54734063597218,1260,58,1202,75.2513244750212,1184.74867552498
"2000","baby just",-4.54930517424291,205,42,163,55.1625658785548,149.837434121445
"1970","one day",-4.55011563387983,158,13,145,21.6219669112095,136.378033088791
"2010","minute",-4.55361624797077,251,27,224,38.6446437185925,212.355356281407
"1980","like rock",-4.55418536632171,89,8,81,14.9729797602784,74.0270202397216
"1960","felt",-4.55576335587437,325,11,314,19.410063852684,305.589936147316
"1960","ladies",-4.55793993705305,303,10,293,18.0961518380408,284.903848161959
"2010","bag",-4.56622078000068,140,13,127,21.5547813569839,118.445218643016
"1990","blowin",-4.56628883201632,57,6,51,12.0922476679833,44.9077523320167
"1990","cant sleep",-4.56628883201632,57,6,51,12.0922476679833,44.9077523320167
"1990","hollywood",-4.56628883201632,57,6,51,12.0922476679833,44.9077523320167
"1990","valley",-4.56628883201632,57,6,51,12.0922476679833,44.9077523320167
"1980","loud",-4.56966369913275,208,24,184,34.9930313498642,173.006968650136
"1960","still",-4.57367875959084,1843,89,1754,110.069992863067,1732.93000713693
"2010","gotta keep",-4.57541808320235,80,6,74,12.3170179182765,67.6829820817235
"2000","innocent",-4.5778864662284,59,9,50,15.8760555455353,43.1239444544647
"2000","torn",-4.5778864662284,59,9,50,15.8760555455353,43.1239444544647
"1990","low",-4.57805807174987,660,118,542,140.015499313491,519.984500686509
"1970","miss",-4.57923253944661,717,79,638,98.1199384515012,618.880061548499
"1960","playin",-4.58131215511823,212,6,206,12.6613339592893,199.338666040711
"2010","love feel",-4.5815162894587,89,7,82,13.7026824340826,75.2973175659174
"1980","used",-4.58595697902518,732,102,630,123.148552635099,608.851447364901
"1990","sexy",-4.58666693043435,401,68,333,85.0700230677422,315.929976932258
"2000","come go",-4.59298796949238,78,13,65,20.9886836025721,57.0113163974279
"2000","fools",-4.59298796949238,78,13,65,20.9886836025721,57.0113163974279
"1980","get little",-4.59514737258546,73,6,67,12.2812081179812,60.7187918820188
"1980","missed",-4.59514737258546,73,6,67,12.2812081179812,60.7187918820188
"2000","men",-4.59738691919401,184,37,147,49.5117664470931,134.488233552907
"1980","seven",-4.60359948943961,105,10,95,17.6647514025757,87.3352485974243
"1990","getting",-4.60784937494363,609,108,501,129.196119821085,479.803880178915
"1980","get right",-4.61287005861955,128,13,115,21.534173138378,106.465826861622
"1970","streets",-4.61351962860039,177,15,162,24.2220768562283,152.777923143772
"2010","mans",-4.61443022815875,98,8,90,15.0883469498887,82.9116530501113
"1980","roll",-4.61617983547262,804,113,691,135.261525025437,668.738474974563
"1990","just might",-4.62084482447224,70,8,62,14.8501287150672,55.1498712849328
"1990","bottle",-4.62768178996677,124,17,107,26.3059422952619,97.6940577047381
"2010","knees",-4.63173550357308,197,20,177,30.3306566237559,166.669343376244
"1990","cant take",-4.6370683736698,164,24,140,34.7917301324432,129.208269867557
"1960","road",-4.63755291748462,370,13,357,22.0976111553634,347.902388844637
"1970","rule",-4.6391077152084,101,7,94,13.8216370761529,87.1783629238471
"2010","baby just",-4.64269363067574,205,21,184,31.5623584155835,173.437641584416
"1990","goes",-4.64463694552504,712,128,584,151.047023501827,560.952976498173
"1970","week",-4.64755128124636,111,8,103,15.1901159945839,95.8098840054161
"2010","hand",-4.64892112984788,859,110,749,132.253979897494,726.746020102506
"1970","cruel",-4.64929533040938,140,11,129,19.1587048580337,120.841295141966
"1970","somethin",-4.65378998516054,293,28,265,40.0964323100277,252.903567689972
"2000","feel like",-4.66040988027205,506,115,391,136.157357729506,369.842642270494
"1980","singing",-4.66615912084992,223,26,197,37.5165672645179,185.483432735482
"1960","like im",-4.69232280022124,283,9,274,16.9016863701833,266.098313629817
"2000","dont want",-4.69700736374166,818,193,625,220.112092139794,597.887907860206
"2000","stay",-4.69792581781864,1204,291,913,323.979167403805,880.020832596195
"1970","five",-4.69936091885846,196,17,179,26.8221868012472,169.177813198753
"2000","age",-4.69959586823528,69,11,58,18.5669124176599,50.4330875823401
"2000","know will",-4.69959586823528,69,11,58,18.5669124176599,50.4330875823401
"1990","never love",-4.70262052786189,64,7,57,13.57726053949,50.42273946051
"2000","soon",-4.70853520218833,294,63,231,79.1111920404639,214.888807959536
"1960","open",-4.71317851563454,519,20,499,30.9963788909016,488.003621109098
"1980","please",-4.71347216826608,1038,149,889,174.628685294034,863.371314705966
"2000","pray",-4.71895603355933,206,42,164,55.4316515657672,150.568348434233
"1980","lady",-4.71956265325043,530,71,459,89.1649356510963,440.835064348904
"1990","job",-4.72385880430121,101,13,88,21.4266142888827,79.5733857111173
"1990","say im",-4.72449481035175,242,38,204,51.3390164149466,190.660983585053
"2010","died",-4.73343471142449,116,10,106,17.8596759815009,98.1403240184991
"1980","funky",-4.73540092730432,195,22,173,32.8059668904977,162.194033109502
"1980","tonight im",-4.74539940122403,98,9,89,16.4871013090706,81.5128986909294
"1980","treat like",-4.74838127846101,82,7,75,13.7953296667734,68.2046703332266
"1990","mirror",-4.75457244835382,142,20,122,30.1245468219935,111.875453178007
"2010","bodys",-4.75488352802854,81,6,75,12.470980642255,68.529019357745
"2000","dont say",-4.76134608244411,124,23,101,33.3666252143453,90.6333747856547
"1980","wasnt",-4.76255782039483,245,29,216,41.2177532726766,203.782246727323
"1980","girl know",-4.76291408843471,188,21,167,31.6283167969926,156.371683203007
"1980","outta",-4.76291408843471,188,21,167,31.6283167969926,156.371683203007
"2000","crush",-4.77512100673031,74,12,62,19.9123408537222,54.0876591462778
"2000","im talking",-4.77512100673031,74,12,62,19.9123408537222,54.0876591462778
"1960","moving",-4.77976264334863,215,6,209,12.8405037794679,202.159496220532
"1970","coming",-4.7833472405141,614,66,548,84.0246055916621,529.975394408338
"1960","wild",-4.7841470306286,479,18,461,28.6074479551866,450.392552044813
"1970","fix",-4.79051724114017,102,7,95,13.958484967996,88.041515032004
"1980","fell love",-4.79324130119479,74,6,68,12.4494438456248,61.5505561543752
"1980","know one",-4.79324130119479,74,6,68,12.4494438456248,61.5505561543752
"1990","roses",-4.79376901089852,77,9,68,16.3351415865739,60.6648584134261
"1980","good good",-4.79553478759085,181,20,161,30.4506667034876,150.549333296512
"1960","wanna see",-4.79606524271992,262,8,254,15.647497628933,246.352502371067
"1990","queen",-4.8030419816525,148,21,127,31.3974149975707,116.602585002429
"1980","started",-4.80650196489222,315,39,276,52.994254207727,262.005745792273
"1960","close",-4.80699958132847,764,32,732,45.6285808721557,718.371419127844
"2010","happened",-4.81123640399383,125,11,114,19.245340497307,105.754659502693
"2010","love want",-4.81123640399383,125,11,114,19.245340497307,105.754659502693
"2010","uh uh uh",-4.81123640399383,125,11,114,19.245340497307,105.754659502693
"2000","dont mind",-4.81677691513089,155,30,125,41.7082815179316,113.291718482068
"1970","double",-4.81763169996968,122,9,113,16.6954428048579,105.304557195142
"1970","coast",-4.81864130277637,92,6,86,12.590006049565,79.409993950435
"1970","paper",-4.81864130277637,92,6,86,12.590006049565,79.409993950435
"1970","youll",-4.83368522503417,1377,161,1216,188.439547067946,1188.56045293205
"2000","lyrics",-4.83928513091526,50,7,43,13.4542843606231,36.5457156393769
"2000","shore",-4.83928513091526,50,7,43,13.4542843606231,36.5457156393769
"1990","maybe",-4.84117745283532,740,133,607,156.987074987853,583.012925012147
"1990","just wanna",-4.84306609779374,377,63,314,79.9785503654334,297.021449634567
"1960","beat",-4.84464431371202,765,32,733,45.6883041455486,719.311695854452
"2000","colors",-4.84704567209596,55,8,47,14.7997127966854,40.2002872033146
"2000","love gonna",-4.84704567209596,55,8,47,14.7997127966854,40.2002872033146
"1960","house",-4.84725102272595,417,15,402,24.9046050048284,392.095394995172
"2010","brand new",-4.84806255209862,142,13,129,21.8627068049408,120.137293195059
"2010","love got",-4.84806255209862,142,13,129,21.8627068049408,120.137293195059
"2000","just another",-4.84857908758667,111,20,91,29.8685112805833,81.1314887194167
"1990","carry",-4.84919104706997,221,34,187,46.8839778004265,174.116022199574
"1990","hungry",-4.85682961178009,71,8,63,15.0622734109967,55.9377265890033
"2010","ride",-4.85749407179228,898,115,783,138.258526132654,759.741473867346
"2000","laid",-4.85780319487856,79,13,66,21.2577692897845,57.7422307102155
"2000","want make",-4.85780319487856,79,13,66,21.2577692897845,57.7422307102155
"1970","passion",-4.85893517263149,132,10,122,18.0639217232889,113.936078276711
"2000","can change",-4.86180840409367,45,6,39,12.1088559245608,32.8911440754392
"2000","company",-4.86180840409367,45,6,39,12.1088559245608,32.8911440754392
"2000","mind mind",-4.86180840409367,45,6,39,12.1088559245608,32.8911440754392
"2000","recall",-4.86180840409367,45,6,39,12.1088559245608,32.8911440754392
"2000","stop now",-4.86180840409367,45,6,39,12.1088559245608,32.8911440754392
"1980","id like",-4.86500962617078,122,12,110,20.5247587725165,101.475241227483
"2000","babys",-4.87678946606174,60,9,51,16.1451412327477,43.8548587672523
"2000","pleasure",-4.87678946606174,60,9,51,16.1451412327477,43.8548587672523
"2000","quiet",-4.87678946606174,60,9,51,16.1451412327477,43.8548587672523
"2000","push",-4.8782312253676,164,32,132,44.1300527028438,119.869947297156
"1980","whoa whoa",-4.87890726297058,167,18,149,28.0953665164775,138.904633483522
"1980","whats",-4.88159085679623,847,119,728,142.495661314111,704.504338685889
"1980","done",-4.88924330824705,605,82,523,101.782615224365,503.217384775635
"1960","star",-4.89812935353985,375,13,362,22.3962275223277,352.603772477672
"1990","yeah im",-4.90706284764108,160,23,137,33.9431513487251,126.056848651275
"2000","know can",-4.91252443602488,241,50,191,64.8496506182034,176.150349381797
"1980","great",-4.91296536735123,145,15,130,24.3941805083188,120.605819491681
"1970","mirror",-4.91304504894014,142,11,131,19.4324006417199,122.56759935828
"1960","big",-4.91990695695071,964,42,922,57.5732355507305,906.42676444927
"1980","deeper",-4.92217415073442,99,9,90,16.6553370367142,82.3446629632858
"2000","baby get",-4.92301033453631,65,10,55,17.49056966881,47.50943033119
"1980","sent",-4.92479654191806,130,13,117,21.8706445936651,108.129355406335
"1990","please dont",-4.93454088401683,249,39,210,52.8240292864534,196.175970713547
"2010","grind",-4.93632444441268,82,6,76,12.6249433662334,69.3750566337666
"1970","want go",-4.94337163019496,103,7,96,14.0953328598391,88.9046671401609
"2000","road",-4.94400924616142,370,81,289,99.5617042686111,270.438295731389
"1990","jack",-4.94507481464583,90,11,79,19.0930226336578,70.9069773663421
"2010","gimme gimme",-4.94614380296992,100,8,92,15.3962723978456,84.6037276021544
"2010","youre still",-4.94614380296992,100,8,92,15.3962723978456,84.6037276021544
"2000","precious",-4.94629473637641,84,14,70,22.6031977258468,61.3968022741532
"1990","build",-4.94787579221807,114,15,99,24.1844953359666,89.8155046640334
"1990","know know know know",-4.94973646223558,65,7,58,13.7894052354196,51.2105947645804
"1990","time know",-4.94973646223558,65,7,58,13.7894052354196,51.2105947645804
"1990","walks",-4.94973646223558,65,7,58,13.7894052354196,51.2105947645804
"1990","cause youre",-4.94990192717105,194,29,165,41.1560710103291,152.843928989671
"2000","tomorrow",-4.95294285229985,279,59,220,75.074906732277,203.925093267723
"1980","head",-4.97140360391474,1158,167,991,194.816972611263,963.183027388737
"1990","cause aint",-4.97509051023435,84,10,74,17.8201544580807,66.1798455419193
"1990","now youre",-4.97815442213318,183,27,156,38.8224793551043,144.177520644896
"1970","death",-4.97884014023505,93,6,87,12.7268539414081,80.2731460585919
"1980","really need",-4.98006522901142,115,11,104,19.3471086790115,95.6528913209885
"1960","calling",-4.98061684405149,218,6,212,13.0196735996465,204.980326400354
"1960","ones",-4.98061684405149,218,6,212,13.0196735996465,204.980326400354
"2000","make cry",-4.98190686378098,70,11,59,18.8359981048724,51.1640018951276
"2000","get together",-4.98942021899329,98,17,81,26.3703973468213,71.6296026531787
"1970","maybe",-4.99412730297085,740,81,659,101.267439963892,638.732560036108
"1970","stick",-4.99631983179364,133,10,123,18.200769615132,114.799230384868
"2000","im gonna",-5.00025513928919,1035,247,788,278.503686264898,756.496313735101
"2010","blame",-5.01430339962713,263,28,235,40.492196406334,222.507803593666
"1990","gets",-5.01961125332484,352,58,294,74.6749329671951,277.325067032805
"1990","harder",-5.02362586220024,155,22,133,32.8824278690774,122.117572130923
"1990","sky",-5.02689648214476,562,98,464,119.225319112397,442.774680887603
"2000","rainy",-5.03956702361391,89,15,74,23.9486261619091,65.0513738380909
"2000","high",-5.03988225050131,790,185,605,212.577692897845,577.422307102155
"1980","lips",-5.04878074614604,338,42,296,56.8636759435293,281.136324056471
"1960","pass",-5.06222045239678,243,7,236,14.5127554344684,228.487244565532
"1970","hide",-5.06628325417486,358,35,323,48.9915452798291,309.008454720171
"1990","playing",-5.06875476085554,217,33,184,46.0353990167084,170.964600983292
"2010","change",-5.07123579869219,823,104,719,126.71132183427,696.28867816573
"2000","cause love",-5.0830952561734,121,22,99,32.5593681527079,88.4406318472921
"1990","miracle",-5.08320660396909,59,6,53,12.5165370598424,46.4834629401576
"1990","mistakes",-5.08320660396909,59,6,53,12.5165370598424,46.4834629401576
"2000","less",-5.08983015670694,152,29,123,40.9010244562943,111.098975543706
"1970","dont even",-5.0906475471735,181,15,166,24.7694684236007,156.230531576399
"1980","know mean",-5.10096921598425,100,9,91,16.8235727643578,83.1764272356422
"1960","love im",-5.1047405130928,267,8,259,15.9461139958973,251.053886004103
"1980","brain",-5.11718160781827,108,10,98,18.1694585855064,89.8305414144936
"1980","look like",-5.11718160781827,108,10,98,18.1694585855064,89.8305414144936
"1980","now got",-5.11718160781827,108,10,98,18.1694585855064,89.8305414144936
"1990","whoa whoa",-5.12765425810693,167,24,143,35.4281642202318,131.571835779768
"1980","now im",-5.13130345931664,555,74,481,93.3708288421857,461.629171157814
"1980","wont come",-5.13275837834319,84,7,77,14.1318011220605,69.8681988779394
"2010","seem",-5.13444073130719,295,32,263,45.4190035736446,249.580996426355
"1990","hundred",-5.16134965823911,121,16,105,25.6695082074733,95.3304917925267
"2000","kicks",-5.16264726228699,56,8,48,15.0687984838979,40.9312015161021
"2000","natural",-5.16264726228699,56,8,48,15.0687984838979,40.9312015161021
"2000","release",-5.16264726228699,56,8,48,15.0687984838979,40.9312015161021
"2000","fading",-5.16776706155317,51,7,44,13.7233700478356,37.2766299521644
"2010","pop",-5.16925494694563,394,45,349,60.6613132475118,333.338686752488
"2010","bring",-5.17111245951143,896,114,782,137.950600684697,758.049399315303
"1970","comes",-5.17595495948402,702,76,626,96.0672200738548,605.932779926145
"2000","oh lord",-5.181575788701,61,9,52,16.4142269199602,44.5857730800398
"1990","girl like",-5.18494498058529,127,17,110,26.9423763830505,100.057623616949
"2010","flip",-5.19411413183468,136,12,124,20.9389304610701,115.06106953893
"1980","ill show",-5.19651817404991,76,6,70,12.7859153009119,63.2140846990881
"1980","way can",-5.19651817404991,76,6,70,12.7859153009119,63.2140846990881
"1980","sun",-5.19726176862589,675,92,583,113.559116159415,561.440883840585
"1990","make mine",-5.20056641919315,66,7,59,14.0015499313491,51.9984500686509
"2000","strange",-5.2048856108647,108,19,89,29.0612542189459,78.9387457810541
"2000","cause girl",-5.20589002797209,46,6,40,12.3779416117733,33.6220583882267
"2000","knew love",-5.20589002797209,46,6,40,12.3779416117733,33.6220583882267
"2000","la da da",-5.20589002797209,46,6,40,12.3779416117733,33.6220583882267
"2000","needing",-5.20589002797209,46,6,40,12.3779416117733,33.6220583882267
"2000","tell",-5.20923397544335,3445,868,2577,927.000192446933,2517.99980755307
"1990","calling",-5.21653696076827,218,33,185,46.2475437126379,171.752456287362
"2000","lose control",-5.21858655078982,66,10,56,17.7596553560225,48.2403446439775
"2010","used",-5.22763051959014,732,91,641,112.70071395223,619.29928604777
"1960","feels",-5.23039428618035,446,16,430,26.6365799332218,419.363420066778
"1990","dig",-5.23334073935755,207,31,176,43.913952057413,163.086047942587
"1970","round round",-5.23916329779243,154,12,142,21.0745753438371,132.925424656163
"1970","give give",-5.24659568693655,125,9,116,17.1059864803872,107.894013519613
"1990","fun",-5.25148389202432,423,71,352,89.7372063781919,333.262793621808
"1980","shine",-5.26938956720723,395,50,345,66.4531124192133,328.546887580787
"2000","last time",-5.26954538714554,71,11,60,19.1050837920848,51.8949162079152
"2000","worst",-5.26954538714554,71,11,60,19.1050837920848,51.8949162079152
"2000","across",-5.27224394898209,192,38,154,51.6644519447928,140.335548055207
"2010","count",-5.27781564086381,178,17,161,27.4053648681652,150.594635131835
"2010","seems like",-5.28481541575583,102,8,94,15.7041978458025,86.2958021541975
"1980","bird",-5.29155363695686,93,8,85,15.6459226708527,77.3540773291473
"1980","stare",-5.29155363695686,93,8,85,15.6459226708527,77.3540773291473
"1980","get way",-5.29220525751337,109,10,99,18.33769431315,90.66230568685
"2000","jack",-5.29960150326047,90,15,75,24.2177118491216,65.7822881508784
"1980","walk away",-5.30628840739982,170,18,152,28.6000736994082,141.399926300592
"2010","good times",-5.31473646041216,111,9,102,17.0898623616086,93.9101376383913
"2010","now can",-5.31473646041216,111,9,102,17.0898623616086,93.9101376383913
"1980","dont tell",-5.31835975943732,117,11,106,19.6835801342986,97.3164198657014
"1980","luck",-5.31835975943732,117,11,106,19.6835801342986,97.3164198657014
"1990","love just",-5.32606950133613,290,46,244,61.5219618195642,228.478038180436
"1980","killing",-5.32822138837539,85,7,78,14.3000368497041,70.6999631502959
"2000","bridge",-5.33149418295958,76,12,64,20.4505122281471,55.5494877718529
"1990","jet",-5.33942662612677,73,8,65,15.4865628028558,57.5134371971442
"1990","baby lets",-5.34069200430037,104,13,91,22.0630483766713,81.9369516233287
"1990","darkness",-5.34069200430037,104,13,91,22.0630483766713,81.9369516233287
"1990","quite",-5.34069200430037,104,13,91,22.0630483766713,81.9369516233287
"2000","within",-5.34088177531841,104,18,86,27.9849114700961,76.0150885299039
"1980","story",-5.3432553274353,185,20,165,31.1236096140619,153.876390385938
"1990","let em",-5.34749337113124,60,6,54,12.7286817557719,47.2713182442281
"1990","one knows",-5.34749337113124,60,6,54,12.7286817557719,47.2713182442281
"1990","sold",-5.34749337113124,60,6,54,12.7286817557719,47.2713182442281
"1990","youre ready",-5.34749337113124,60,6,54,12.7286817557719,47.2713182442281
"1990","fall",-5.35239967816186,925,168,757,196.233843734817,728.766156265183
"1990","half",-5.35370348234754,230,35,195,48.7932800637923,181.206719936208
"1990","face",-5.35434598615624,869,157,712,184.353740762763,684.646259237237
"1980","happened",-5.35691399896839,125,12,113,21.0294659554472,103.970534044553
"2000","called",-5.36236832618925,231,47,184,62.1587937460788,168.841206253921
"1960","dont stop",-5.36393316904534,317,10,307,18.932277665541,298.067722334459
"1990","perfect",-5.36595568003711,219,33,186,46.4596884085674,172.540311591433
"1990","shame",-5.36931462023264,157,22,135,33.3067172609365,123.693282739064
"2010","just like",-5.3712774713342,618,75,543,95.148963418686,522.851036581314
"1980","right",-5.37165522763426,3946,610,3336,663.858181281558,3282.14181871844
"1970","mean",-5.37492515017975,746,81,665,102.088527314951,643.911472685049
"1960","love way",-5.38874435882736,248,7,241,14.8113718014327,233.188628198567
"2000","fear",-5.39194474357471,184,36,148,49.5117664470931,134.488233552907
"2000","now now",-5.39273267929071,95,16,79,25.5631402851839,69.4368597148161
"2000","shoot",-5.39273267929071,95,16,79,25.5631402851839,69.4368597148161
"1980","count",-5.39363414518778,178,19,159,29.9459595205569,148.054040479443
"1980","kid",-5.39363414518778,178,19,159,29.9459595205569,148.054040479443
"1980","lot",-5.40220748146615,410,52,358,68.9766483338669,341.023351666133
"2000","dying",-5.40225896528303,81,13,68,21.7959406642094,59.2040593357906
"1970","ask",-5.40714415261777,498,51,447,68.1502501378628,429.849749862137
"1960","worth",-5.41920110504524,272,8,264,16.2447303628617,255.755269637138
"2010","slip",-5.4239304150529,129,11,118,19.8611913932209,109.138808606779
"2010","faith",-5.42861602454081,146,13,133,22.4785577008546,123.521442299145
"1990","working",-5.43129078333206,140,19,121,29.7002574301344,110.299742569866
"1990","first",-5.43202049991635,706,125,581,149.774155326249,556.225844673751
"1960","promise",-5.43352078781167,385,13,372,22.9934602562565,362.006539743744
"1980","nah",-5.4418330788764,156,16,140,26.2447735123982,129.755226487602
"1980","still love",-5.4418330788764,156,16,140,26.2447735123982,129.755226487602
"1980","ten",-5.4418330788764,156,16,140,26.2447735123982,129.755226487602
"2010","treat",-5.44335536594213,321,35,286,49.4220343970845,271.577965602916
"2010","weve",-5.44428538035885,427,49,378,65.7420831388008,361.257916861199
"2000","others",-5.44677728141355,109,19,90,29.3303399061584,79.6696600938416
"1990","ive",-5.44817239031119,2652,514,2138,562.607733605118,2089.39226639488
"1960","fast",-5.4512329815211,341,11,330,20.36563622697,320.63436377303
"1970","cant wait",-5.45460215512487,146,11,135,19.9797922090923,126.020207790908
"1970","skin",-5.45460215512487,146,11,135,19.9797922090923,126.020207790908
"1970","type",-5.45460215512487,146,11,135,19.9797922090923,126.020207790908
"2000","live",-5.45482408110976,1210,290,920,325.593681527079,884.406318472921
"1990","baby ooh",-5.45499211459167,67,7,60,14.2136946272786,52.7863053727214
"2010","sunday",-5.45667180549498,103,8,95,15.858160569781,87.141839430219
"1980","go back",-5.46210810741435,141,14,127,23.7212375977445,117.278762402256
"1980","river",-5.46213034089407,215,24,191,36.1706814433693,178.829318556631
"1990","diamond",-5.46575554722601,146,20,126,30.9731256057116,115.026874394288
"1970","aint never",-5.46820720840623,96,6,90,13.1373976169374,82.8626023830626
"1980","lights",-5.46880759387364,465,60,405,78.2296133542637,386.770386645736
"1980","make lose",-5.46908238970491,110,10,100,18.5059300407936,91.4940699592064
"1990","fight",-5.4722999941303,483,82,401,102.465888133964,380.534111866036
"1990","dark",-5.47715018365625,329,53,276,69.7956049608159,259.204395039184
"1980","keeping",-5.48107405855158,94,8,86,15.8141583984963,78.1858416015037
"1980","talkin bout",-5.48107405855158,94,8,86,15.8141583984963,78.1858416015037
"1980","wherever",-5.48107405855158,94,8,86,15.8141583984963,78.1858416015037
"1980","wrote",-5.48107405855158,94,8,86,15.8141583984963,78.1858416015037
"2000","know shes",-5.48420234971277,57,8,49,15.3378841711103,41.6621158288897
"2000","drinking",-5.492037666854,62,9,53,16.6833126071727,45.3166873928273
"2000","much time",-5.492037666854,62,9,53,16.6833126071727,45.3166873928273
"2000","need baby",-5.492037666854,62,9,53,16.6833126071727,45.3166873928273
"2010","need",-5.49284169352136,3735,524,3211,575.050774059534,3159.94922594047
"2000","beginning",-5.50248925203165,52,7,45,13.992455735048,38.007544264952
"2000","heart just",-5.50248925203165,52,7,45,13.992455735048,38.007544264952
"2000","lay back",-5.50248925203165,52,7,45,13.992455735048,38.007544264952
"2000","want take",-5.50248925203165,52,7,45,13.992455735048,38.007544264952
"2000","whistle",-5.50248925203165,52,7,45,13.992455735048,38.007544264952
"2000","yeah youre",-5.50248925203165,52,7,45,13.992455735048,38.007544264952
"2000","wrong",-5.50271711478828,946,223,723,254.555060102989,691.444939897011
"1970","stuck",-5.50642699875024,175,14,161,23.9483810725421,151.051618927458
"1980","let go",-5.50784817800699,804,111,693,135.261525025437,668.738474974563
"1970","say",-5.51398718481843,4757,596,4161,650.985421497617,4106.01457850238
"1990","moves",-5.51587313529729,175,25,150,37.125321787668,137.874678212332
"2010","long time",-5.51946549089097,155,14,141,23.8642222166607,131.135777783339
"2010","thank",-5.52138703641233,244,25,219,37.5669046507433,206.433095349257
"1980","want come",-5.52579617193923,86,7,79,14.4682725773477,71.5317274226523
"1980","women",-5.53235697977773,201,22,179,33.8153812563592,167.184618743641
"1980","saw",-5.53544523075576,425,54,371,71.5001842485206,353.499815751479
"1970","point",-5.54019416043783,117,8,109,16.0112033456425,100.988796654358
"2010","telling",-5.55248515400773,260,27,233,40.0303082343986,219.969691765601
"2000","candle",-5.55649517540557,47,6,41,12.6470272989857,34.3529727010143
"2000","ill find",-5.55649517540557,47,6,41,12.6470272989857,34.3529727010143
"2000","make happy",-5.55649517540557,47,6,41,12.6470272989857,34.3529727010143
"2000","put yo",-5.55649517540557,47,6,41,12.6470272989857,34.3529727010143
"2000","things want",-5.55649517540557,47,6,41,12.6470272989857,34.3529727010143
"1990","baby love",-5.56789904824636,270,42,228,57.2790679009735,212.720932099026
"2010","im ready",-5.57715104799514,147,13,134,22.6325204248331,124.367479575167
"1960","bout",-5.58160481486365,884,37,847,52.7953736793006,831.204626320699
"1970","doubt",-5.58375523572547,185,15,170,25.3168599909731,159.683140009027
"1990","byamandah",-5.5858337611527,74,8,66,15.6987074987853,58.3012925012147
"1990","byamandah editor",-5.5858337611527,74,8,66,15.6987074987853,58.3012925012147
"1990","church",-5.5858337611527,74,8,66,15.6987074987853,58.3012925012147
"1990","thrill",-5.5858337611527,74,8,66,15.6987074987853,58.3012925012147
"2010","forever",-5.59177275623316,874,110,764,134.563420757171,739.436579242829
"1970","speak",-5.59282261948744,147,11,136,20.1166401009354,126.883359899065
"2000","now dont",-5.59664410738,172,33,139,46.2827382005435,125.717261799456
"1970","kids",-5.60671332354862,213,18,195,29.1486009625799,183.85139903742
"1980","bye bye",-5.60882100459824,78,6,72,13.1223867561991,64.8776132438009
"1990","girl give",-5.61548441579216,61,6,55,12.9408264517014,48.0591735482986
"2010","bop",-5.61643304547464,284,30,254,43.7254136098816,240.274586390118
"1990","top",-5.61801892479478,421,70,351,89.3129169863328,331.687083013667
"1980","side",-5.61912212283497,799,110,689,134.420346387219,664.579653612781
"1970","one thing",-5.63248363457915,204,17,187,27.916969935992,176.083030064008
"1990","fall love",-5.63387317419599,254,39,215,53.884752766101,200.115247233899
"1970","can call",-5.63414836384016,97,6,91,13.2742455087805,83.7257544912195
"1980","ever",-5.63416553508736,2130,318,1812,358.342099880821,1771.65790011918
"1980","wonderful",-5.64777778661472,111,10,101,18.6741657684371,92.3258342315629
"2000","guitar",-5.65290827014447,96,16,80,25.8322259723964,70.1677740276036
"2010","can say",-5.65917493058415,189,18,171,29.0989548319282,159.901045168072
"1980","lets go",-5.66954050852516,202,22,180,33.9836169840027,168.016383015997
"1980","school",-5.66954050852516,202,22,180,33.9836169840027,168.016383015997
"1980","got feeling",-5.67257382110408,95,8,87,15.9823941261399,79.0176058738601
"1980","shoot",-5.67257382110408,95,8,87,15.9823941261399,79.0176058738601
"2000","far",-5.67354246293969,616,140,476,165.756783322877,450.243216677123
"2000","want baby",-5.68163329189579,82,13,69,22.0650263514219,59.9349736485781
"2010","sayin",-5.68396818108959,181,17,164,27.8672530401006,153.132746959899
"2010","double",-5.68618565779429,122,10,112,18.7834523253717,103.216547674628
"1970","six",-5.68673556289718,128,9,119,17.5165301559165,110.483469844083
"1970","weak",-5.68673556289718,128,9,119,17.5165301559165,110.483469844083
"2000","go home",-5.69254275019827,110,19,91,29.5994255933708,80.4005744066291
"2000","know really",-5.69254275019827,110,19,91,29.5994255933708,80.4005744066291
"2000","snow",-5.69254275019827,110,19,91,29.5994255933708,80.4005744066291
"1990","darling",-5.70493064361164,260,40,220,55.1576209416782,204.842379058322
"2000","help",-5.7105027842825,765,177,588,205.850550717534,559.149449282466
"1990","drag",-5.71290083204512,68,7,61,14.4258393232082,53.5741606767919
"1990","shinin",-5.71290083204512,68,7,61,14.4258393232082,53.5741606767919
"1960","can feel",-5.71947720490047,300,9,291,17.9169820178622,282.083017982138
"1960","will never",-5.72112546710744,253,7,246,15.1099881683971,237.890011831603
"1960","something",-5.72316223034985,1202,53,1149,71.7873746182345,1130.21262538177
"1970","im still",-5.72488876155951,214,18,196,29.285448854423,184.714551145577
"1980","time love",-5.72543174927694,87,7,80,14.6365083049913,72.3634916950087
"2010","motion",-5.7270060360081,148,13,135,22.7864831488115,125.213516851188
"1970","look like",-5.72833327001158,108,7,101,14.7795723190546,93.2204276809454
"1970","now got",-5.72833327001158,108,7,101,14.7795723190546,93.2204276809454
"1970","girl im",-5.73214355160457,148,11,137,20.2534879927785,127.746512007221
"1980","shoulder",-5.73405970223473,135,13,122,22.711823231883,112.288176768117
"1990","act",-5.74173533856823,304,48,256,64.4919875625776,239.508012437422
"1990","ill tell",-5.74751854301283,118,15,103,25.0330741196847,92.9669258803153
"2000","knock",-5.75296793843259,164,31,133,44.1300527028438,119.869947297156
"2000","starting",-5.75400308854212,87,14,73,23.4104547874842,63.5895452125158
"2000","can",-5.76501678109935,8122,2090,6032,2185.51395153962,5936.48604846038
"1990","yes",-5.77284718558865,1017,185,832,215.751155760334,801.248844239666
"2000","theres nothing",-5.780132298157,186,36,150,50.049937821518,135.950062178482
"2000","hurry",-5.78327979269265,142,26,116,38.2101675841696,103.78983241583
"1990","read",-5.78944790378703,188,27,161,39.8832028347519,148.116797165248
"1970","say im",-5.79181939077178,242,21,221,33.1171898260297,208.88281017397
"1990","bill",-5.79226889121555,100,12,88,21.2144695929532,78.7855304070468
"1990","know mean",-5.79226889121555,100,12,88,21.2144695929532,78.7855304070468
"2000","stronger",-5.79774583558906,115,20,95,30.9448540294332,84.0551459705668
"2010","im back",-5.80525770869518,105,8,97,16.1660860177379,88.8339139822621
"1990","answer",-5.80979418209893,171,24,147,36.2767430039499,134.72325699605
"1990","handle",-5.80979418209893,171,24,147,36.2767430039499,134.72325699605
"1980","laid",-5.81820695733857,79,6,73,13.2906224838427,65.7093775161573
"1980","wide",-5.81998700479308,166,17,149,27.9271307888339,138.072869211166
"2000","seemed",-5.82580063646321,68,10,58,18.2978267304474,49.7021732695526
"2000","tie",-5.82580063646321,68,10,58,18.2978267304474,49.7021732695526
"1980","sayin",-5.82756626900084,181,19,162,30.4506667034876,150.549333296512
"1980","south",-5.82825722550892,112,10,102,18.8424014960807,93.1575985039193
"2000","promises",-5.83289810179331,92,15,77,24.7558832235465,67.2441167764535
"1980","knows",-5.83339476679855,496,64,432,83.4449209112147,412.555079088785
"1990","wherever",-5.83370325386919,94,11,83,19.941601417376,74.058398582624
"2000","another day",-5.84248141861454,106,18,88,28.523082844521,77.476917155479
"2000","bleed",-5.84319563618706,53,7,46,14.2615414222605,38.7384585777395
"2000","ooh love",-5.84319563618706,53,7,46,14.2615414222605,38.7384585777395
"1960","truth",-5.84437512253157,302,9,293,18.0364285646479,283.963571435352
"1970","coming back",-5.8480273012469,119,8,111,16.2848991293287,102.715100870671
"1990","boys",-5.85539212020854,581,100,481,123.256068335058,457.743931664942
"1990","hard",-5.85609008393701,1241,229,1012,263.271567648549,977.728432351451
"2000","tell want",-5.86016197937436,73,11,62,19.6432551665097,53.3567448334902
"2010","ive",-5.86172726656069,2652,364,2288,408.309143990866,2243.69085600913
"1990","turn",-5.86752760211253,1733,327,1406,367.646758045878,1365.35324195412
"1990","lookin",-5.88022949371073,471,79,392,99.9201517828094,371.079848217191
"1990","champagne",-5.88705274663232,62,6,56,13.152971147631,48.847028852369
"1990","give away",-5.88705274663232,62,6,56,13.152971147631,48.847028852369
"1970","little bit",-5.90192817180494,419,41,378,57.339266682258,361.660733317742
"2000","short",-5.90501263895143,120,21,99,32.2902824654955,87.7097175345045
"2000","just feel",-5.9076124014436,78,12,66,20.9886836025721,57.0113163974279
"2000","now tell",-5.9076124014436,78,12,66,20.9886836025721,57.0113163974279
"2000","time come",-5.9076124014436,78,12,66,20.9886836025721,57.0113163974279
"2000","backseat",-5.91332924558715,48,6,42,12.9161129861982,35.0838870138018
"2000","ill just",-5.91332924558715,48,6,42,12.9161129861982,35.0838870138018
"2000","pink",-5.91332924558715,48,6,42,12.9161129861982,35.0838870138018
"2000","something like",-5.91332924558715,48,6,42,12.9161129861982,35.0838870138018
"2000","works",-5.91332924558715,48,6,42,12.9161129861982,35.0838870138018
"2000","playing",-5.91713567846898,217,43,174,58.3915941251043,158.608405874896
"1990","meet",-5.92906511795314,381,62,319,80.8271291491515,300.172870850848
"2010","really",-5.94395225791013,1880,252,1628,289.449921079498,1590.5500789205
"1980","come come come",-5.94684130293974,144,14,130,24.2259447806752,119.774055219325
"1980","dont really",-5.94684130293974,144,14,130,24.2259447806752,119.774055219325
"2000","oh oh oh oh",-5.94899403214568,1291,309,982,347.389622191289,943.610377808711
"1990","oh dont",-5.9537156629889,119,15,104,25.2452188156143,93.7547811843857
"1990","space",-5.9537156629889,119,15,104,25.2452188156143,93.7547811843857
"1990","age",-5.97418507854385,69,7,62,14.6379840191377,54.3620159808623
"1990","shakin",-5.97418507854385,69,7,62,14.6379840191377,54.3620159808623
"1990","cant stand",-5.9822623131199,107,13,94,22.6994824644599,84.3005175355401
"2010","escape",-5.98822054081301,115,9,106,17.7057132575225,97.2942867424775
"2010","shed",-5.98822054081301,115,9,106,17.7057132575225,97.2942867424775
"1970","bag",-5.99121618153814,140,10,130,19.1587048580337,120.841295141966
"2010","isnt",-5.99720417951818,240,24,216,36.9510537548295,203.04894624517
"2010","bomb",-6.00371412192001,97,7,90,14.9343842259103,82.0656157740897
"2000","watching",-6.00618578745717,256,52,204,68.8859359263903,187.11406407361
"2000","kept",-6.01408657584128,125,22,103,33.6357109015578,91.3642890984422
"1980","scene",-6.0159906286754,121,11,110,20.3565230448729,100.643476955127
"1960","nice",-6.01870404514372,233,6,227,13.9155227005396,219.08447729946
"1980","can can",-6.02381750428197,105,9,96,17.6647514025757,87.3352485974243
"1980","way im",-6.02967389545922,80,6,74,13.4588582114862,66.5411417885138
"1960","gettin",-6.04044327975581,440,15,425,26.2782402928645,413.721759707135
"1970","whoa oh",-6.05086482166552,160,12,148,21.8956626948957,138.104337305104
"1960","im just",-6.05275968421675,462,16,446,27.5921523075078,434.407847692492
"1980","acting",-6.06133938117451,97,8,89,16.3188655814271,80.6811344185729
"1980","can call",-6.06133938117451,97,8,89,16.3188655814271,80.6811344185729
"2010","breakin",-6.06379278166594,88,6,82,13.5487197101042,74.4512802898958
"2010","whole life",-6.06379278166594,88,6,82,13.5487197101042,74.4512802898958
"1960","pull",-6.06463414107409,282,8,274,16.8419630967905,265.15803690321
"2010","across",-6.06678272033972,192,18,174,29.5608430038636,162.439156996136
"1990","force",-6.08838510935509,76,8,68,16.1229968906444,59.8770031093556
"1990","mami",-6.08838510935509,76,8,68,16.1229968906444,59.8770031093556
"1990","see us",-6.08838510935509,76,8,68,16.1229968906444,59.8770031093556
"1970","gonna take",-6.09901941047428,170,13,157,23.2641416133266,146.735858386673
"2000","dont dont",-6.10595064096403,93,15,78,25.024968910759,67.975031089241
"2010","talkin",-6.10711830202571,335,36,299,51.5775125327829,283.422487467217
"1970","eye",-6.11400483700567,263,23,240,35.9909955547348,227.009004445265
"1990","leave",-6.11941917886796,1265,233,1032,268.363040350857,996.636959649142
"2010","higher",-6.12261705769824,233,23,210,35.8733146869803,197.12668531302
"1980","sunshine",-6.12336017751495,183,19,164,30.7871381587748,152.212861841225
"2000","go go go go",-6.13709815402611,69,10,59,18.5669124176599,50.4330875823401
"2000","tonight tonight",-6.13709815402611,69,10,59,18.5669124176599,50.4330875823401
"1960","dont want",-6.13862353893558,818,33,785,48.8536376353709,769.146362364629
"1970","dont let go",-6.14001596651211,100,6,94,13.6847891843098,86.3152108156902
"2010","clean",-6.14292082138347,176,16,160,27.0974394202083,148.902560579792
"2000","tease",-6.14429000610426,59,8,51,15.8760555455353,43.1239444544647
"2000","wont",-6.1473640820624,2313,570,1743,622.395194522425,1690.60480547757
"1970","cant stop",-6.15135950480052,236,20,216,32.2961024749711,203.703897525029
"1990","shop",-6.16207779821519,63,6,57,13.3651158435605,49.6348841564395
"1990","wheels",-6.16207779821519,63,6,57,13.3651158435605,49.6348841564395
"1990","turns",-6.16233692803888,120,15,105,25.4573635115438,94.5426364884562
"2000","ding",-6.16283646310803,74,11,63,19.9123408537222,54.0876591462778
"2010","women",-6.17607969021772,201,19,182,30.9465075196697,170.05349248033
"1990","know got",-6.17781636466514,213,31,182,45.1868202329902,167.81317976701
"2000","just little",-6.17842412765678,274,56,218,73.7294782962147,200.270521703785
"2010","lies",-6.18222149555196,289,30,259,44.4952272297739,244.504772770226
"2010","baby come",-6.18267975371235,125,10,115,19.245340497307,105.754659502693
"1990","call",-6.18642823731491,1553,290,1263,329.460712778563,1223.53928722144
"2010","come take",-6.18909137647398,98,7,91,15.0883469498887,82.9116530501113
"2000","food",-6.18964561806302,54,7,47,14.530627109473,39.469372890527
"2000","need little",-6.18964561806302,54,7,47,14.530627109473,39.469372890527
"2000","real real",-6.18964561806302,54,7,47,14.530627109473,39.469372890527
"2000","mine",-6.19013501661924,1033,243,790,277.965514890474,755.034485109526
"1980","gone",-6.2004791210377,1359,195,1164,228.632353867622,1130.36764613238
"1990","look like",-6.201359827001,108,13,95,22.9116271603894,85.0883728396106
"1990","much love",-6.201359827001,108,13,95,22.9116271603894,85.0883728396106
"2000","coming home",-6.20273181667568,79,12,67,21.2577692897845,57.7422307102155
"2000","ill love",-6.20273181667568,79,12,67,21.2577692897845,57.7422307102155
"1980","send",-6.20386548692275,191,20,171,32.1330239799234,158.866976020077
"1970","can tell",-6.22566673624146,264,23,241,36.1278434465778,227.872156553422
"1980","full",-6.23078965812532,342,41,301,57.5366188541037,284.463381145896
"1990","im gone",-6.23874226631979,70,7,63,14.8501287150672,55.1498712849328
"1980","king",-6.23876941668378,138,13,125,23.2165304148138,114.783469585186
"2000","control",-6.24574802282103,371,79,292,99.8307899558235,271.169210044177
"1990","story",-6.25039390342846,185,26,159,39.2467687469634,145.753231253037
"2010","im sure",-6.25776637811797,89,6,83,13.7026824340826,75.2973175659174
"1960","can take",-6.26454302003668,261,7,254,15.5877743555401,245.41222564446
"1970","control",-6.2675428122028,371,35,336,50.7705678737893,320.229432126211
"2010","proud",-6.27523523033558,143,12,131,22.0166695289193,120.983330471081
"2000","gods",-6.27611718229062,49,6,43,13.1851986734107,35.8148013265894
"2000","got keep",-6.27611718229062,49,6,43,13.1851986734107,35.8148013265894
"2000","youre always",-6.27611718229062,49,6,43,13.1851986734107,35.8148013265894
"2000","deep inside",-6.29459122310296,117,20,97,31.4830254038581,85.5169745961419
"1980","call",-6.29476086440697,1553,225,1328,261.270085030477,1291.72991496952
"1990","shouldnt",-6.29520558896916,96,11,85,20.365890809235,75.634109190765
"1990","take away",-6.2978041969432,191,27,164,40.5196369225405,150.480363077459
"2000","rhyme",-6.31471672598809,89,14,75,23.9486261619091,65.0513738380909
"2000","water",-6.3258484203407,245,49,196,65.9259933670533,179.074006632947
"2010","heard",-6.33279514626767,586,69,517,90.2221562513754,495.777843748625
"2010","fact",-6.33393386418045,117,9,108,18.0136387054794,98.9863612945206
"1990","listen",-6.33724015562057,491,82,409,104.1630457014,386.8369542986
"1990","never felt",-6.34434925840402,77,8,69,16.3351415865739,60.6648584134261
"2000","can hear",-6.35952180391252,108,18,90,29.0612542189459,78.9387457810541
"2000","mistake",-6.35952180391252,108,18,90,29.0612542189459,78.9387457810541
"2000","yesterday",-6.363902964496,131,23,108,35.2502250248326,95.7497749751674
"2010","alright alright",-6.37603857792482,99,7,92,15.2423096738672,83.7576903261328
"1970","true love",-6.37957507647393,112,7,105,15.326963886427,96.673036113573
"2000","cake",-6.38313911746591,94,15,79,25.2940545979715,68.7059454020285
"2000","lines",-6.38313911746591,94,15,79,25.2940545979715,68.7059454020285
"1990","let love",-6.38944661262842,248,37,211,52.6118845905238,195.388115409476
"1990","saturday",-6.39223567679352,115,14,101,24.3966400318961,90.6033599681039
"2010","wine",-6.41223994343021,161,14,147,24.7879985605315,136.212001439469
"2000","song",-6.41771493357521,816,188,628,219.573920765369,596.426079234631
"2000","let go",-6.42105787303639,804,185,619,216.34489251882,587.65510748118
"1970","right now",-6.42156667367437,502,50,452,68.6976417052352,433.302358294765
"1990","cares",-6.44044500427887,64,6,58,13.57726053949,50.42273946051
"1990","desert",-6.44044500427887,64,6,58,13.57726053949,50.42273946051
"2000","youyou",-6.45330907785874,70,10,60,18.8359981048724,51.1640018951276
"2010","color",-6.45336456014338,90,6,84,13.8566451580611,76.1433548419389
"1980","favorite",-6.45752007712836,99,8,91,16.6553370367142,82.3446629632858
"1980","yeah oh yeah",-6.45863764044857,82,6,76,13.7953296667734,68.2046703332266
"2000","almost",-6.4617895553466,185,35,150,49.7808521343055,135.219147865694
"1980","everywhere",-6.46389923254744,237,26,211,39.871867451528,197.128132548472
"2000","held",-6.47384794095755,136,24,112,36.5956534608949,99.4043465391051
"1960","know youre",-6.47584249571684,448,15,433,26.7560264800075,421.243973519992
"1970","paradise",-6.47806685897216,123,8,115,16.832290696701,106.167709303299
"2000","let let",-6.48241120545818,60,8,52,16.1451412327477,43.8548587672523
"2000","people say",-6.48241120545818,60,8,52,16.1451412327477,43.8548587672523
"2000","winter",-6.48241120545818,60,8,52,16.1451412327477,43.8548587672523
"1970","life oh",-6.4836903424962,102,6,96,13.958484967996,88.041515032004
"1980","harder",-6.48900973250804,155,15,140,26.0765377847546,128.923462215245
"1990","white",-6.49588222295422,315,49,266,66.8255792178025,248.174420782198
"2010","may",-6.49972758021195,476,54,422,73.2862566137452,402.713743386255
"2000","bound",-6.50238595474899,80,12,68,21.526854976997,58.473145023003
"2000","california",-6.50238595474899,80,12,68,21.526854976997,58.473145023003
"2000","shadows",-6.50238595474899,80,12,68,21.526854976997,58.473145023003
"2010","else",-6.50388394634147,625,74,551,96.2267024865352,528.773297513465
"1990","fancy",-6.50647441859078,71,7,64,15.0622734109967,55.9377265890033
"1980","wouldnt",-6.51307401816178,421,52,369,70.8272413379463,350.172758662054
"1990","star",-6.52371861245164,375,60,315,79.5542609735744,295.445739026426
"2000","hurt",-6.52769043025391,542,120,422,145.844442469155,396.155557530845
"2000","im glad",-6.53849714924586,104,17,87,27.9849114700961,76.0150885299039
"2000","cure",-6.54161284838881,55,7,48,14.7997127966854,40.2002872033146
"2000","birds",-6.54685401540145,85,13,72,22.8722834130593,62.1277165869407
"1980","respect",-6.55667817649588,124,11,113,20.8612302278037,103.138769772196
"1980","sex",-6.56143395179572,245,27,218,41.2177532726766,203.782246727323
"1990","wonder",-6.56171603768552,493,82,411,104.587335093259,388.412664906741
"2010","dont let go",-6.56452297414837,100,7,93,15.3962723978456,84.6037276021544
"2010","feet",-6.56761726873166,347,37,310,53.4250652205243,293.574934779476
"2000","red",-6.57033421724429,452,98,354,121.626730620033,330.373269379967
"1990","shut",-6.58153346430963,146,19,127,30.9731256057116,115.026874394288
"1970","didnt know",-6.58428828923458,144,10,134,19.7060964254061,124.293903574594
"2000","theyll",-6.58519551054009,141,25,116,37.9410818969572,103.058918103043
"1970","trying",-6.59143127473129,504,50,454,68.9713374889213,435.028662511079
"1960","rest",-6.59368208801818,241,6,235,14.3933088876826,226.606691112317
"1980","uh oh",-6.59926077215553,108,9,99,18.1694585855064,89.8305414144936
"1990","doesnt matter",-6.60332517330614,78,8,70,16.5472862825035,61.4527137174965
"2010","dont let",-6.60397444630021,324,34,290,49.8839225690198,274.11607743098
"1970","sexy",-6.63253688338957,401,38,363,54.8760046290823,346.123995370918
"2000","lover lover",-6.64460178002195,50,6,44,13.4542843606231,36.5457156393769
"2000","spring",-6.64460178002195,50,6,44,13.4542843606231,36.5457156393769
"2010","every little",-6.65055014891229,91,6,85,14.0106078820395,76.9893921179605
"2010","gangsta",-6.65055014891229,91,6,85,14.0106078820395,76.9893921179605
"2010","love ill",-6.65055014891229,91,6,85,14.0106078820395,76.9893921179605
"1980","pieces",-6.65829360671589,100,8,92,16.8235727643578,83.1764272356422
"1970","moment",-6.65986373809836,410,39,371,56.1076356556702,353.89236434433
"2000","gonna let",-6.66436772869947,95,15,80,25.5631402851839,69.4368597148161
"1980","trees",-6.67603294909613,83,6,77,13.963565394417,69.036434605583
"2000","loud",-6.68668428664375,208,40,168,55.9698229401922,152.030177059808
"1970","realize",-6.69338041378518,184,14,170,25.18001209913,158.81998790087
"2010","ear",-6.70369343633265,110,8,102,16.9358996376302,93.0641003623698
"2000","believe",-6.71529489412814,1245,295,950,335.011680579516,909.988319420485
"2010","memories",-6.71946609964271,163,14,149,25.0959240084884,137.904075991512
"2010","dream",-6.72168724534537,789,96,693,121.476589219002,667.523410780998
"1990","come come come come",-6.7220454058969,65,6,59,13.7894052354196,51.2105947645804
"1990","want say",-6.72256347676489,85,9,76,18.0322991540102,66.9677008459898
"1990","wont take",-6.72256347676489,85,9,76,18.0322991540102,66.9677008459898
"1970","dollar",-6.73518575333458,145,10,135,19.8429443172492,125.157055682751
"1980","bang",-6.73798339185307,239,26,213,40.2083389068151,198.791661093185
"1980","chill",-6.7528603216853,92,7,85,15.4776869432092,76.5223130567908
"1980","solo",-6.7528603216853,92,7,85,15.4776869432092,76.5223130567908
"1970","shoulder",-6.75424301569822,135,9,126,18.4744653988182,116.525534601182
"2010","making love",-6.75451282779814,101,7,94,15.5502351218241,85.4497648781759
"1980","fact",-6.75628236579328,117,10,107,19.6835801342986,97.3164198657014
"1980","shoes",-6.75809424615892,172,17,155,28.9365451546954,143.063454845305
"1960","around",-6.75936387805011,2228,105,2123,133.063453119323,2094.93654688068
"1960","takes",-6.76338699923983,363,11,352,21.6795482416132,341.320451758387
"2010","soon",-6.76805311884136,294,30,264,45.2650408496661,248.734959150334
"2000","love ive",-6.77428247793801,71,10,61,19.1050837920848,51.8949162079152
"1990","tell tell",-6.77728789706303,72,7,65,15.2744181069263,56.7255818930737
"2000","danger",-6.78684952374664,66,9,57,17.7596553560225,48.2403446439775
"2010","need know",-6.79417530787845,172,15,157,26.4815885242945,145.518411475706
"1990","wasnt",-6.79586783174254,245,36,209,51.9754505027352,193.024549497265
"1960","life",-6.79749225563721,2901,141,2760,173.257216112727,2727.74278388727
"1970","love want",-6.79995256743228,125,8,117,17.1059864803872,107.894013519613
"2010","dont mind",-6.81143302957751,155,13,142,23.8642222166607,131.135777783339
"2000","now baby",-6.81152369874419,151,27,124,40.6319387690818,110.368061230918
"1980","baby im",-6.81167541401447,340,40,300,57.2001473988165,282.799852601183
"1960","second",-6.81284544950714,244,6,238,14.5724787078612,229.427521292139
"1980","hoo",-6.82144394545922,157,15,142,26.4130092400417,130.586990759958
"2000","billy",-6.8256614375667,61,8,53,16.4142269199602,44.5857730800398
"2000","knockin",-6.8256614375667,61,8,53,16.4142269199602,44.5857730800398
"2000","one another",-6.8256614375667,61,8,53,16.4142269199602,44.5857730800398
"2000","silence",-6.8256614375667,61,8,53,16.4142269199602,44.5857730800398
"1970","want love",-6.82988035837901,185,14,171,25.3168599909731,159.683140009027
"1970","ever ever",-6.83226768198281,104,6,98,14.2321807516822,89.7678192483178
"2010","best friend",-6.84928722791592,92,6,86,14.164570606018,77.835429393982
"2010","game",-6.85419503736435,644,76,568,99.1519942421259,544.848005757874
"1990","like girl",-6.85859058018901,92,10,82,19.5173120255169,72.4826879744831
"1990","nobody else",-6.85859058018901,92,10,82,19.5173120255169,72.4826879744831
"1970","nobody",-6.86117046367078,718,75,643,98.2567863433443,619.743213656656
"2010","dont see",-6.86312712480348,120,9,111,18.4755268774148,101.524473122585
"2010","sounds",-6.86312712480348,120,9,111,18.4755268774148,101.524473122585
"2010","walkin",-6.86405046181598,129,10,119,19.8611913932209,109.138808606779
"1990","go crazy",-6.8652317605722,79,8,71,16.759430978433,62.240569021567
"1990","seat",-6.8652317605722,79,8,71,16.759430978433,62.240569021567
"1970","cause know",-6.87864007928559,214,17,197,29.285448854423,184.714551145577
"2000","dark",-6.88297795283106,329,68,261,88.5291910929001,240.4708089071
"1970","candy",-6.8871049549438,146,10,136,19.9797922090923,126.020207790908
"1990","york",-6.8898385711457,177,24,153,37.5496111795271,139.450388820473
"2000","love yeah",-6.89138008707595,110,18,92,29.5994255933708,80.4005744066291
"2000","love give",-6.89221446835084,91,14,77,24.4867975363341,66.5132024636659
"1980","cause aint",-6.89530604536399,84,6,78,14.1318011220605,69.8681988779394
"1980","silly",-6.89530604536399,84,6,78,14.1318011220605,69.8681988779394
"1980","tree",-6.89530604536399,84,6,78,14.1318011220605,69.8681988779394
"2010","cmon",-6.89837012053993,239,23,216,36.7970910308511,202.202908969149
"2010","matter",-6.90751089122767,533,61,472,82.0621318805172,450.937868119483
"2000","loving",-6.91863672107867,504,110,394,135.619186355081,368.380813644919
"1980","whatcha",-6.91900300024465,173,17,156,29.104780882339,143.895219117661
"1980","callin",-6.92148151002772,134,12,122,22.5435875042394,111.456412495761
"2000","nah",-6.9262644366821,156,28,128,41.9773672051441,114.022632794856
"1980","waitin",-6.93271779945146,142,13,129,23.8894733253881,118.110526674612
"1980","yeah",-6.93355487372639,6260,976,5284,1053.1556550488,5206.8443449512
"1970","taste",-6.95251404926521,224,18,206,30.6539277728539,193.346072227146
"1980","five",-6.95486055989379,196,20,176,32.9742026181413,163.025797381859
"2000","prove",-6.95729500270686,138,24,114,37.1338248353198,100.86617516468
"1980","come now",-6.96388653405294,93,7,86,15.6459226708527,77.3540773291473
"1980","lets make",-6.96388653405294,93,7,86,15.6459226708527,77.3540773291473
"2000","somebodys",-6.97684672945974,115,19,96,30.9448540294332,84.0551459705668
"1990","highway",-6.97699102698296,86,9,77,18.2444438499397,67.7555561500603
"2010","just",-6.98026798061795,9577,1382,8195,1474.50100754168,8102.49899245832
"1990","learned",-6.98167765484029,148,19,129,31.3974149975707,116.602585002429
"1990","motion",-6.98167765484029,148,19,129,31.3974149975707,116.602585002429
"1990","rolling",-6.98167765484029,148,19,129,31.3974149975707,116.602585002429
"1990","daddys",-7.00677529114139,66,6,60,14.0015499313491,51.9984500686509
"1990","even know",-7.00753875052336,99,11,88,21.0023248970236,77.9976751029764
"1990","golden",-7.00753875052336,99,11,88,21.0023248970236,77.9976751029764
"1990","like dont",-7.00753875052336,99,11,88,21.0023248970236,77.9976751029764
"1970","ice",-7.00782614265813,215,17,198,29.4222967462661,185.577703253734
"1970","know aint",-7.00833437417181,105,6,99,14.3690286435253,90.6309713564747
"1960","car",-7.01139797649297,390,12,378,23.2920766232208,366.707923376779
"2000","best thing",-7.01854217002104,51,6,45,13.7233700478356,37.2766299521644
"2000","just come",-7.01854217002104,51,6,45,13.7233700478356,37.2766299521644
"2000","mystery",-7.01854217002104,51,6,45,13.7233700478356,37.2766299521644
"2000","nation",-7.01854217002104,51,6,45,13.7233700478356,37.2766299521644
"1990","last",-7.01871116320369,827,145,682,175.443663533723,651.556336466277
"1990","love dont",-7.02162960221228,280,42,238,59.4005148602689,220.599485139731
"2010","youll see",-7.04225955455701,121,9,112,18.6294896013932,102.370510398607
"2010","wet",-7.04954108643878,93,6,87,14.3185333299964,78.6814666700036
"1990","now go",-7.0510931492879,73,7,66,15.4865628028558,57.5134371971442
"1990","im feelin",-7.05466142748309,118,14,104,25.0330741196847,92.9669258803153
"1990","lock",-7.05466142748309,118,14,104,25.0330741196847,92.9669258803153
"2010","loved",-7.06711324231564,398,43,355,61.2771641434256,336.722835856574
"1960","groove",-7.0711868407323,297,8,289,17.7378121976836,279.262187802316
"1960","let know",-7.0711868407323,297,8,289,17.7378121976836,279.262187802316
"1990","spot",-7.07617925613399,178,24,154,37.7617558754566,140.238244124543
"1970","will never",-7.07843959991692,253,21,232,34.6225166363038,218.377483363696
"1970","bet",-7.07969185553603,225,18,207,30.790775664697,194.209224335303
"1990","mess",-7.08568633546446,207,29,178,43.913952057413,163.086047942587
"2000","know now",-7.08581356640433,106,17,89,28.523082844521,77.476917155479
"2000","baby please",-7.09863998564462,77,11,66,20.7195979153596,56.2804020846404
"2000","never felt",-7.09863998564462,77,11,66,20.7195979153596,56.2804020846404
"2000","telephone",-7.09863998564462,77,11,66,20.7195979153596,56.2804020846404
"2000","cos",-7.09987428648413,72,10,62,19.3741694792973,52.6258305207027
"1990","mornin",-7.10260528036782,112,13,99,23.7602059441075,88.2397940558925
"1980","please dont",-7.10897449293795,249,27,222,41.8906961832509,207.109303816749
"1990","much",-7.11251729534001,1552,287,1265,329.248568082633,1222.75143191737
"2000","smiling",-7.11481311528011,82,12,70,22.0650263514219,59.9349736485781
"1980","pack",-7.11641078350024,85,6,79,14.3000368497041,70.6999631502959
"1980","pants",-7.11641078350024,85,6,79,14.3000368497041,70.6999631502959
"1970","guys",-7.12621494368773,127,8,119,17.3796822640734,109.620317735927
"1980","coming back",-7.13888431823023,119,10,109,20.0200515895858,98.9799484104142
"1980","park",-7.13888431823023,119,10,109,20.0200515895858,98.9799484104142
"1970","never",-7.14069881626762,4753,588,4165,650.438029930244,4102.56197006976
"2000","gonna find",-7.14510380985063,87,13,74,23.4104547874842,63.5895452125158
"1970","giving",-7.15639959832423,235,19,216,32.159254583128,202.840745416872
"2000","shame",-7.15892667160227,157,28,129,42.2464528923566,114.753547107643
"2000","shes",-7.15936189055579,1432,341,1091,385.330704088246,1046.66929591175
"2000","broken heart",-7.16268151009545,111,18,93,29.8685112805833,81.1314887194167
"2000","call call",-7.17386140407994,62,8,54,16.6833126071727,45.3166873928273
"2000","time will",-7.17386140407994,62,8,54,16.6833126071727,45.3166873928273
"1970","one one",-7.1826399517699,158,11,147,21.6219669112095,136.378033088791
"1980","one two",-7.18986195179217,111,9,102,18.6741657684371,92.3258342315629
"1990","war",-7.19484566274704,137,17,120,29.0638233423458,107.936176657654
"1980","aah",-7.19777956126493,190,19,171,31.9647882522798,158.03521174772
"2010","weve got",-7.21264021771466,131,10,121,20.1691168411778,110.830883158822
"2010","wife",-7.21264021771466,131,10,121,20.1691168411778,110.830883158822
"1980","move",-7.21619972218473,1129,157,972,189.938136509599,939.0618634904
"2010","theres something",-7.22272025065233,122,9,113,18.7834523253717,103.216547674628
"2000","leaves",-7.23857848775023,97,15,82,26.1013116596088,70.8986883403912
"2000","cover",-7.24430707470626,116,19,97,31.2139397166456,84.7860602833544
"2010","just little",-7.24802196197544,274,27,247,42.185786370097,231.814213629903
"2010","dough",-7.25127816616125,94,6,88,14.4724960539749,79.5275039460251
"1990","started",-7.27944561134849,315,48,267,66.8255792178025,248.174420782198
"2010","found",-7.28466746314877,723,86,637,111.315049436424,611.684950563576
"1990","disguise",-7.29453586325462,67,6,61,14.2136946272786,52.7863053727214
"1990","dont ask",-7.29453586325462,67,6,61,14.2136946272786,52.7863053727214
"1990","good good good",-7.29453586325462,67,6,61,14.2136946272786,52.7863053727214
"1990","road",-7.29669058944485,370,58,312,78.4935374939267,291.506462506073
"1990","cant even",-7.32780447415979,74,7,67,15.6987074987853,58.3012925012147
"1990","doors",-7.32780447415979,74,7,67,15.6987074987853,58.3012925012147
"2010","start",-7.33160585357236,753,90,663,115.933931155778,637.066068844222
"1980","train",-7.33412166475644,221,23,198,37.1800958092307,183.819904190769
"1970","gotta get",-7.33635921368973,227,18,209,31.0644714483832,195.935528551617
"1970","secret",-7.35409064139646,179,13,166,24.4957726399145,154.504227360085
"1990","faces",-7.35729866583619,94,10,84,19.941601417376,74.058398582624
"1980","get get",-7.35992944870765,546,69,477,91.8567072933935,454.143292706606
"2000","far away",-7.39435399813341,158,28,130,42.515538579569,115.484461420431
"1990","dirt",-7.39752858227008,81,8,73,17.1837203702921,63.8162796297079
"2000","around im",-7.39771246364569,52,6,46,13.992455735048,38.007544264952
"2000","burned",-7.39771246364569,52,6,46,13.992455735048,38.007544264952
"2000","help help",-7.39771246364569,52,6,46,13.992455735048,38.007544264952
"1990","walls",-7.40443719358277,107,12,95,22.6994824644599,84.3005175355401
"2000","baby let",-7.41944210456461,126,21,105,33.9047965887702,92.0952034112297
"2000","just hold",-7.42994688741668,73,10,63,19.6432551665097,53.3567448334902
"1960","just like",-7.43110345824675,618,22,596,36.9089829567961,581.091017043204
"1960","lay",-7.43349952025604,465,15,450,27.7713221276864,437.228677872314
"1960","lights",-7.43349952025604,465,15,450,27.7713221276864,437.228677872314
"2000","love cant",-7.43747046213149,112,18,94,30.1375969677958,81.8624030322042
"1980","window",-7.45943933589058,184,18,166,30.9553738864183,153.044626113582
"2000","feel love",-7.46363759610831,68,9,59,18.2978267304474,49.7021732695526
"2000","know ive",-7.46363759610831,68,9,59,18.2978267304474,49.7021732695526
"2000","dont let",-7.46439505091066,324,66,258,87.1837626568378,236.816237343162
"2000","shell",-7.46554315646144,203,38,165,54.6243945041298,148.37560549587
"1980","track",-7.46816132253439,145,13,132,24.3941805083188,120.605819491681
"2000","something",-7.47687089798032,1202,282,920,323.44099602938,878.55900397062
"1970","dont want",-7.48049339803796,818,86,732,111.941575527654,706.058424472346
"1990","get back",-7.48145582991616,215,30,185,45.6111096248493,169.388890375151
"1970","green",-7.48350146821107,170,12,158,23.2641416133266,146.735858386673
"2000","hide",-7.48548124280084,358,74,284,96.3326760220615,261.667323977939
"1960","seen",-7.4870842687528,576,20,556,34.4006054742954,541.599394525705
"2010","anymore",-7.49454167170488,227,21,206,34.9495383431096,192.05046165689
"1990","hold hold",-7.49514930756638,101,11,90,21.4266142888827,79.5733857111173
"2000","happen",-7.50382194495011,172,31,141,46.2827382005435,125.717261799456
"2000","sun comes",-7.52684106151226,63,8,55,16.9523982943851,46.0476017056149
"2000","talk talk",-7.52684106151226,63,8,55,16.9523982943851,46.0476017056149
"1970","caught",-7.53066767699836,330,29,301,45.1598043082223,284.840195691778
"2000","glass",-7.53138493141604,98,15,83,26.3703973468213,71.6296026531787
"2000","welcome",-7.53138493141604,98,15,83,26.3703973468213,71.6296026531787
"2000","ill never",-7.54014587850764,286,57,229,76.9585065427642,209.041493457236
"1970","quick",-7.5433725217027,108,6,102,14.7795723190546,93.2204276809454
"1990","romance",-7.56748361285491,114,13,101,24.1844953359666,89.8155046640334
"1990","honey",-7.57550638857484,421,67,354,89.3129169863328,331.687083013667
"1960","goin",-7.57961958754102,556,19,537,33.2061400064379,522.793859993562
"2000","ive never",-7.58576718854796,103,16,87,27.7158257828836,75.2841742171164
"1980","aint never",-7.60731558425244,96,7,89,16.1506298537835,79.8493701462165
"1990","can dance",-7.60733980401403,75,7,68,15.9108521947149,59.0891478052851
"1990","danced",-7.60733980401403,75,7,68,15.9108521947149,59.0891478052851
"1990","switch",-7.60733980401403,75,7,68,15.9108521947149,59.0891478052851
"1990","clouds",-7.61048138669386,95,10,85,20.1537461133055,74.8462538866945
"1990","lucky",-7.61048138669386,95,10,85,20.1537461133055,74.8462538866945
"2010","somebodys",-7.63781964052737,115,8,107,17.7057132575225,97.2942867424775
"2010","shell",-7.64201013518524,203,18,185,31.2544329676266,171.745567032373
"2000","ground",-7.65045055688967,278,55,223,74.8058210450645,203.194178954935
"2010","grass",-7.65907321780241,96,6,90,14.7804215019318,81.2195784980682
"1970","hurt",-7.66168098224205,542,53,489,74.1715573789591,467.828442621041
"1990","chicks",-7.66777213494229,82,8,74,17.3958650662216,64.6041349337784
"1990","legs",-7.66777213494229,82,8,74,17.3958650662216,64.6041349337784
"1990","rock rock",-7.66777213494229,82,8,74,17.3958650662216,64.6041349337784
"2000","look",-7.70018386854416,1903,459,1444,512.070062765316,1390.92993723468
"1990","use",-7.70174005175036,290,43,247,61.5219618195642,228.478038180436
"1980","id rather",-7.72428683680832,122,10,112,20.5247587725165,101.475241227483
"2010","another day",-7.72599912641646,106,7,99,16.3200487417164,89.6799512582836
"1990","magic",-7.73532123630643,279,41,238,59.1883701643393,219.811629835661
"1970","couple",-7.73790704796629,120,7,113,16.4217470211718,103.578252978828
"2010","slide",-7.74147472288716,143,11,132,22.0166695289193,120.983330471081
"2000","tree",-7.7439708934305,84,12,72,22.6031977258468,61.3968022741532
"2010","kept",-7.77184930081172,125,9,116,19.245340497307,105.754659502693
"2000","know know know",-7.77274887144864,132,22,110,35.519310712045,96.480689287955
"2010","somewhere",-7.77679903028241,229,21,208,35.2574637910665,193.742536208934
"1980","doin",-7.78105026072464,348,40,308,58.5460332199651,289.453966780035
"2000","just love",-7.78190053388192,53,6,47,14.2615414222605,38.7384585777395
"2000","kind girl",-7.78190053388192,53,6,47,14.2615414222605,38.7384585777395
"2000","laughter",-7.78190053388192,53,6,47,14.2615414222605,38.7384585777395
"2000","need somebody",-7.78190053388192,53,6,47,14.2615414222605,38.7384585777395
"2000","sunny",-7.78190053388192,53,6,47,14.2615414222605,38.7384585777395
"1970","wont let",-7.79944967999067,221,17,204,30.2433840973246,190.756615902675
"1970","fight",-7.7996168575779,483,46,437,66.0975317602163,416.902468239784
"1970","fly",-7.80401372654831,764,79,685,104.551789368127,659.448210631873
"1990","bottom",-7.80562677551592,152,19,133,32.2459937812888,119.754006218711
"2000","stood",-7.80883504195814,69,9,60,18.5669124176599,50.4330875823401
"2000","youve gone",-7.80883504195814,69,9,60,18.5669124176599,50.4330875823401
"1980","kissed",-7.82511777314785,97,7,90,16.3188655814271,80.6811344185729
"2000","sun",-7.84625189173838,675,150,525,181.632838868412,493.367161131588
"1990","fast",-7.8495405974554,341,52,289,72.3413413119703,268.65865868803
"1980","just wanna",-7.85029169751494,377,44,333,63.4248693216289,313.575130678371
"2010","looks",-7.8626330112712,196,17,179,30.1766938997774,165.823306100223
"2010","leaves",-7.86506939430052,97,6,91,14.9343842259103,82.0656157740897
"2000","rush",-7.86523768466846,137,23,114,36.8647391481073,100.135260851893
"1990","grass",-7.86614104174424,96,10,86,20.365890809235,75.634109190765
"2010","try",-7.86645173620109,1260,159,1101,193.993032212855,1066.00696778714
"1960","weve",-7.87014843121773,427,13,414,25.5018377387572,401.498162261243
"2000","win",-7.87116205249215,196,36,160,52.7407946936426,143.259205306357
"2000","theyve",-7.87681653525809,104,16,88,27.9849114700961,76.0150885299039
"1990","addicted",-7.87877664445671,69,6,63,14.6379840191377,54.3620159808623
"1990","dont forget",-7.87877664445671,69,6,63,14.6379840191377,54.3620159808623
"1990","got money",-7.87877664445671,69,6,63,14.6379840191377,54.3620159808623
"2000","anymore",-7.8795747573614,227,43,184,61.0824509972289,165.917549002771
"1990","disco",-7.88705318907607,109,12,97,23.1237718563189,85.8762281436811
"2010","whatever",-7.89606197198146,343,35,308,52.8092143246105,290.19078567539
"1980","wanna say",-7.89824495258641,106,8,98,17.8329871302193,88.1670128697807
"1980","mad",-7.9035104030918,262,28,234,44.0777606426174,217.922239357383
"1970","instead",-7.90554761091009,110,6,104,15.0532681027408,94.9467318972592
"1970","take take",-7.90554761091009,110,6,104,15.0532681027408,94.9467318972592
"2010","cant stand",-7.92440709200707,107,7,100,16.4740114656948,90.5259885343052
"2000","whisper",-7.93364182854348,109,17,92,29.3303399061584,79.6696600938416
"1970","wear",-7.93511484172984,183,13,170,25.0431642072869,157.956835792713
"1990","baby boy",-7.94065268879662,83,8,75,17.6080097621511,65.3919902378489
"1970","breath",-7.94281101458854,260,21,239,35.5804518792055,224.419548120795
"1970","think youre",-7.94424623283959,163,11,152,22.306206370425,140.693793629575
"1970","givin",-7.95293446032719,193,14,179,26.4116431257179,166.588356874282
"2010","take home",-7.95380749621594,162,13,149,24.9419612845099,137.05803871549
"2010","words",-7.95960676547055,612,70,542,94.2251870748153,517.774812925185
"1990","youre just",-7.96966256598186,122,14,108,25.8816529034029,96.1183470965971
"2000","movin",-7.97424325995809,192,35,157,51.6644519447928,140.335548055207
"2000","says",-7.98339243145148,361,74,287,97.1399330836989,263.860066916301
"1990","money",-7.99632147712542,1142,204,938,242.269242751525,899.730757248475
"2000","yeah yeah yeah yeah",-7.99800863495893,549,119,430,147.728042279642,401.271957720358
"2000","foolish",-8.00056689057227,59,7,52,15.8760555455353,43.1239444544647
"1970","look",-8.0042568149449,1903,219,1684,260.421538177415,1642.57846182258
"2010","searching",-8.02074360792697,117,8,109,18.0136387054794,98.9863612945206
"2010","line",-8.0291109905324,461,50,411,70.9768157540684,390.023184245932
"2000","someone else",-8.06455485565045,85,12,73,22.8722834130593,62.1277165869407
"1980","year",-8.06576316596787,132,11,121,22.2071160489523,109.792883951048
"2000","oh dont",-8.06670169043263,119,19,100,32.021196778283,86.978803221717
"2000","run away",-8.09443570395822,95,14,81,25.5631402851839,69.4368597148161
"1970","mmm",-8.09705818717378,194,14,180,26.548491017561,167.451508982439
"1960","everything",-8.09830106970177,1269,53,1216,75.788833935557,1193.21116606444
"2010","round round",-8.09880451614664,154,12,142,23.7102594926823,130.289740507318
"1970","tell",-8.10876985094943,3445,415,3030,471.440987399472,2973.55901260053
"2010","bump",-8.12412353005047,108,7,101,16.6279741896733,91.3720258103267
"2000","strength",-8.12798244343624,100,15,85,26.9085687212462,73.0914312787538
"1970","deny",-8.12988194209462,133,8,125,18.200769615132,114.799230384868
"1980","white",-8.15849426974987,315,35,280,52.994254207727,262.005745792273
"2000","bear",-8.17090691842112,54,6,48,14.530627109473,39.469372890527
"2000","marry",-8.17090691842112,54,6,48,14.530627109473,39.469372890527
"2000","someones",-8.17090691842112,54,6,48,14.530627109473,39.469372890527
"2010","get back",-8.17418500543178,215,19,196,33.1019856553681,181.898014344632
"1990","melody",-8.17508119719574,70,6,64,14.8501287150672,55.1498712849328
"1990","one wish",-8.17508119719574,70,6,64,14.8501287150672,55.1498712849328
"2000","feelings",-8.17896770693535,246,47,199,66.1950790542657,179.804920945734
"1970","looking",-8.18792421329684,769,79,690,105.236028827342,663.763971172658
"1990","knows",-8.19172301658524,496,80,416,105.223769181048,390.776230818952
"1970","im sorry",-8.20231081260928,144,9,135,19.7060964254061,124.293903574594
"1970","never ever",-8.20231081260928,144,9,135,19.7060964254061,124.293903574594
"1980","fake",-8.20562101931188,116,9,107,19.515344406655,96.484655593345
"2010","go dont",-8.2140988427941,118,8,110,18.1676014294578,99.8323985705422
"2010","thug",-8.2140988427941,118,8,110,18.1676014294578,99.8323985705422
"2000","slide",-8.21848343108039,143,24,119,38.4792532713821,104.520746728618
"2000","begin",-8.22312532019137,110,17,93,29.5994255933708,80.4005744066291
"2000","sleeping",-8.22312532019137,110,17,93,29.5994255933708,80.4005744066291
"1990","somebody",-8.22439285489097,672,113,559,142.561235664645,529.438764335355
"1990","wanna go",-8.23027365457215,184,24,160,39.0346240510338,144.965375948966
"1990","love way",-8.23403213094736,248,35,213,52.6118845905238,195.388115409476
"1960","best",-8.23692352612916,908,35,873,54.2287322407295,853.77126775927
"1960","dont",-8.24334086141326,11587,620,10967,692.01356880323,10894.9864311968
"2010","alright",-8.26041343379094,705,82,623,108.543720404812,596.456279595188
"1980","stick",-8.26083791188683,133,11,122,22.3753517765959,110.624648223404
"2010","nowhere",-8.26088593077946,224,20,204,34.4876501711742,189.512349828826
"1990","called",-8.27603558850811,231,32,199,49.0054247597218,181.994575240278
"1990","city",-8.27887133475591,545,89,456,115.618859281595,429.381140718405
"1990","waitin",-8.27955934139257,142,17,125,30.1245468219935,111.875453178007
"1990","act like",-8.28163670516397,117,13,104,24.8209294237552,92.1790705762448
"2010","get away",-8.28807545184589,137,10,127,21.0928931850485,115.907106814951
"1990","youre gonna",-8.29844560871533,421,66,355,89.3129169863328,331.687083013667
"2010","ring",-8.30896518026837,274,26,248,42.185786370097,231.814213629903
"1970","blame",-8.32350594367297,263,21,242,35.9909955547348,227.009004445265
"1980","quick",-8.32422404289993,108,8,100,18.1694585855064,89.8305414144936
"2000","go go go",-8.34730007814559,120,19,101,32.2902824654955,87.7097175345045
"1990","look",-8.35107247183062,1903,353,1550,403.711356353899,1499.2886436461
"1990","smile",-8.35266619224218,583,96,487,123.680357726917,459.319642273083
"1970","track",-8.36802322700781,145,9,136,19.8429443172492,125.157055682751
"2000","behind",-8.37249899172436,342,69,273,92.0273050266621,249.972694973338
"1970","freak",-8.37969334946149,186,13,173,25.4537078828162,160.546292117184
"2010","face",-8.38183476832987,869,104,765,133.793607137279,735.206392862721
"1990","welcome",-8.38467569774293,98,10,88,20.7901802010941,77.2098197989059
"2000","grass",-8.40430393118276,96,14,82,25.8322259723964,70.1677740276036
"1990","rockin",-8.41603291146306,173,22,151,36.701032395809,136.298967604191
"1970","catch",-8.41948200103266,347,30,317,47.486218469555,299.513781530445
"2010","wed",-8.42006332506772,191,16,175,29.4068802798852,161.593119720115
"2000","mmm",-8.42769000980762,194,35,159,52.2026233192177,141.797376680782
"1970","pretend",-8.44246554588075,124,7,117,16.9691385885441,107.030861411456
"2010","games",-8.45984404297037,165,13,152,25.4038494564453,139.596150543555
"1990","message",-8.46211948836847,78,7,71,16.5472862825035,61.4527137174965
"1990","oooh",-8.46211948836847,78,7,71,16.5472862825035,61.4527137174965
"1990","see eyes",-8.46211948836847,78,7,71,16.5472862825035,61.4527137174965
"1990","shady",-8.46211948836847,78,7,71,16.5472862825035,61.4527137174965
"1990","yea yea",-8.47406462115667,71,6,65,15.0622734109967,55.9377265890033
"2010","thing",-8.47487827396301,1697,219,1478,261.27474259144,1435.72525740856
"1960","low",-8.48450035874249,660,23,637,39.4173604392968,620.582639560703
"1980","whoa",-8.48687877680986,687,88,599,115.577944891138,571.422055108862
"1980","gimme gimme",-8.48801270104463,100,7,93,16.8235727643578,83.1764272356422
"1960","drink",-8.49102576167435,292,7,285,17.4391958307192,274.560804169281
"1990","country",-8.49902522582443,105,11,94,22.2751930726008,82.7248069273992
"1960","feel like",-8.51152082456735,506,16,490,30.2199763367942,475.780023663206
"2000","ever gonna",-8.51214259654023,71,9,62,19.1050837920848,51.8949162079152
"1990","thug",-8.52401424613902,118,13,105,25.0330741196847,92.9669258803153
"1970","truth",-8.52488257226275,302,25,277,41.3280633366156,260.671936663384
"2010","dance floor",-8.52738272334256,110,7,103,16.9358996376302,93.0641003623698
"1960","blow",-8.55000094491578,318,8,310,18.9920009389339,299.007999061066
"1960","like like",-8.55000094491578,318,8,310,18.9920009389339,299.007999061066
"2010","dont think",-8.55596350610314,284,27,257,43.7254136098816,240.274586390118
"1990","cha",-8.5584236974666,92,9,83,19.5173120255169,72.4826879744831
"1960","hard",-8.55912887239757,1241,51,1190,74.1165822805566,1166.88341771944
"2000","go round",-8.56454383001876,55,6,49,14.7997127966854,40.2002872033146
"1970","next",-8.56669897932496,491,46,445,67.1923148949611,423.807685105039
"1990","walk",-8.56913173216158,994,174,820,210.871827753954,783.128172246046
"1960","looking",-8.5834704309905,769,28,741,45.9271972391201,723.07280276088
"2010","wow",-8.60448608019112,120,8,112,18.4755268774148,101.524473122585
"2000","listen",-8.61007231098396,491,104,387,132.121072421319,358.878927578681
"2000","open eyes",-8.61288375880181,66,8,58,17.7596553560225,48.2403446439775
"1990","feelin",-8.62163066328635,494,79,415,104.799479789189,389.200520210811
"1980","come come",-8.62182229532683,369,42,327,62.0789835004803,306.92101649952
"2010","makes",-8.62940466273667,739,86,653,113.778453020079,625.221546979921
"2010","got got",-8.63061402231769,166,13,153,25.5578121804237,140.442187819576
"1980","lie",-8.6311649966944,517,63,454,86.9778711917298,430.02212880827
"1960","first",-8.63401133363106,706,25,681,42.164631015369,663.835368984631
"1970","top",-8.63767359171898,421,38,383,57.6129624659442,363.387037534056
"1970","two",-8.64352398623895,967,102,865,132.331911412276,834.668088587724
"1980","pull",-8.65179075518833,282,30,252,47.442475195489,234.557524804511
"1980","singin",-8.65503401483248,135,11,124,22.711823231883,112.288176768117
"1960","show",-8.66601286119482,1443,61,1382,86.1806835059171,1356.81931649408
"1990","away",-8.68277018927976,2580,487,2093,547.333315498192,2032.66668450181
"1960","hate",-8.68512235299041,369,10,359,22.0378878819705,346.96211211803
"1990","dress",-8.68840333682333,150,18,132,31.8217043894297,118.17829561057
"2010","wall",-8.69310390875944,184,15,169,28.329141212036,155.670858787964
"1970","dont ever",-8.70217359250154,147,9,138,20.1166401009354,126.883359899065
"2010","walking",-8.70678330183541,227,20,207,34.9495383431096,192.05046165689
"1980","woke",-8.71203124658391,101,7,94,16.9918084920014,84.0081915079986
"1980","know im",-8.71401234291631,580,72,508,97.5767220332752,482.423277966725
"1980","boy",-8.71817454947345,1613,228,1385,271.364228689091,1341.63577131091
"1980","good",-8.72471940347766,2885,427,2458,485.360074251722,2399.63992574828
"1980","problem",-8.72891741181601,127,10,117,21.3659374107344,105.634062589266
"2010","oh love",-8.73087767014731,111,7,104,17.0898623616086,93.9101376383913
"2010","wonderful",-8.73087767014731,111,7,104,17.0898623616086,93.9101376383913
"1990","climb",-8.75219602112317,79,7,72,16.759430978433,62.240569021567
"1990","monkey",-8.75219602112317,79,7,72,16.759430978433,62.240569021567
"1990","need girl",-8.75568280501072,106,11,95,22.4873377685304,83.5126622314696
"2000","now oh",-8.75814031986422,61,7,54,16.4142269199602,44.5857730800398
"2000","play play",-8.75814031986422,61,7,54,16.4142269199602,44.5857730800398
"2000","oh yeah",-8.76630355428442,542,116,426,145.844442469155,396.155557530845
"1990","underneath",-8.77564854428946,72,6,66,15.2744181069263,56.7255818930737
"2000","night day",-8.79249816484645,77,10,67,20.7195979153596,56.2804020846404
"2000","can make",-8.79610135108363,370,75,295,99.5617042686111,270.438295731389
"1980","im sorry",-8.79901436287398,144,12,132,24.2259447806752,119.774055219325
"2010","leave alone",-8.80147589006948,121,8,113,18.6294896013932,102.370510398607
"1970","rush",-8.81845715849762,137,8,129,18.7481611825044,118.251838817496
"1960","control",-8.82185041007738,371,10,361,22.1573344287562,348.842665571244
"2010","youll never",-8.823867083004,176,14,162,27.0974394202083,148.902560579792
"2000","fade",-8.83266917210073,150,25,125,40.3628530818693,109.637146918131
"1990","want want",-8.83772983126696,193,25,168,40.9439263143996,152.0560736856
"1990","year",-8.84025476879463,132,15,117,28.0030998626982,103.996900137302
"1980","right right",-8.85411373812871,136,11,125,22.8800589595266,113.119941040473
"2000","louder",-8.86999386838072,72,9,63,19.3741694792973,52.6258305207027
"2000","poor",-8.86999386838072,72,9,63,19.3741694792973,52.6258305207027
"1970","livin",-8.87774160897609,351,30,321,48.0336100369274,302.966389963073
"1990","oh im",-8.87918570040912,113,12,101,23.9723506400371,89.0276493599629
"2010","baby love",-8.88870528814236,270,25,245,41.5699354741832,228.430064525817
"1980","talkin",-8.89188176306588,335,37,298,56.3589687605986,278.641031239401
"2010","dont try",-8.91488647827739,102,6,96,15.7041978458025,86.2958021541975
"2000","tonight",-8.91646788557817,1587,375,1212,427.038985606178,1159.96101439382
"2000","falling",-8.92497656854376,375,76,299,100.907132704673,274.092867295327
"1980","wet",-8.94616989325896,93,6,87,15.6459226708527,77.3540773291473
"1970","one night",-8.94884549569151,159,10,149,21.7588148030526,137.241185196947
"2000","jimmy",-8.96263426177095,56,6,50,15.0687984838979,40.9312015161021
"2000","now ill",-8.96263426177095,56,6,50,15.0687984838979,40.9312015161021
"1980","week",-8.9742360168808,111,8,103,18.6741657684371,92.3258342315629
"2010","sugar",-8.97460620555698,254,23,231,39.1065318905279,214.893468109472
"2000","baby ill",-8.98039365592648,127,20,107,34.1738822759827,92.8261177240173
"1970","baby ill",-8.98107747040376,127,7,120,17.3796822640734,109.620317735927
"2000","dare",-8.98344595593469,67,8,59,18.028741043235,48.971258956765
"1980","finally",-9.00038822014831,201,19,182,33.8153812563592,167.184618743641
"1960","holding",-9.01751196875261,299,7,292,17.8572587444693,281.142741255531
"2010","west",-9.01782106220597,212,18,194,32.6400974834327,179.359902516567
"2000","come take",-9.03463270900221,98,14,84,26.3703973468213,71.6296026531787
"1990","gotta keep",-9.04473409296728,80,7,73,16.9715756743625,63.0284243256375
"1990","oh youre",-9.04473409296728,80,7,73,16.9715756743625,63.0284243256375
"1990","take chance",-9.04473409296728,80,7,73,16.9715756743625,63.0284243256375
"1990","weed",-9.04473409296728,80,7,73,16.9715756743625,63.0284243256375
"2000","passion",-9.04831479505693,132,21,111,35.519310712045,96.480689287955
"2000","dreamin",-9.04913269832885,88,12,76,23.6795404746967,64.3204595253033
"1990","affair",-9.05725123856766,87,8,79,18.4565885458693,68.5434114541307
"1990","bop bop bop",-9.05725123856766,87,8,79,18.4565885458693,68.5434114541307
"2010","fresh",-9.06524748762275,195,16,179,30.022731175799,164.977268824201
"1990","oh cant",-9.07975798636025,73,6,67,15.4865628028558,57.5134371971442
"2010","train",-9.08612866746889,221,19,202,34.0257619992388,186.974238000761
"1990","talkin bout",-9.1050388378931,94,9,85,19.941601417376,74.058398582624
"2000","feel good",-9.12098225927984,137,22,115,36.8647391481073,100.135260851893
"2000","get away",-9.12098225927984,137,22,115,36.8647391481073,100.135260851893
"1990","nowhere",-9.12762207604817,224,30,194,47.5204118882151,176.479588111785
"2010","holdin",-9.12862959850624,103,6,97,15.858160569781,87.141839430219
"1980","buy",-9.13515585791954,225,22,203,37.853038719805,187.146961280195
"1970","take away",-9.13670214794387,191,13,178,26.1379473420317,164.862052657968
"2000","chorus",-9.13690439115638,224,41,183,60.2751939355916,163.724806064408
"2000","oh can",-9.14311116284243,78,10,68,20.9886836025721,57.0113163974279
"2000","gonna stop",-9.14337944059092,62,7,55,16.6833126071727,45.3166873928273
"2000","guide",-9.14337944059092,62,7,55,16.6833126071727,45.3166873928273
"2000","open door",-9.14337944059092,62,7,55,16.6833126071727,45.3166873928273
"2000","higher",-9.15726049644325,233,43,190,62.6969651205037,170.303034879496
"2000","took",-9.15923495004604,553,118,435,148.804385028492,404.195614971508
"2010","ill give",-9.1630325789174,178,14,164,27.4053648681652,150.594635131835
"1980","rose",-9.16446258747776,103,7,96,17.3282799472885,85.6717200527115
"2010","now baby",-9.17176876860333,151,11,140,23.2483713207469,127.751628679253
"1980","woman",-9.18180976028785,796,103,693,133.915639204288,662.084360795712
"1980","shut",-9.19029474517092,146,12,134,24.5624162359624,121.437583764038
"1970","life",-9.19607682834759,2901,342,2559,396.995734236827,2504.00426576317
"1960","miss",-9.20185610821591,717,25,692,42.8215870226906,674.178412977309
"2000","cant cant",-9.23181383427641,73,9,64,19.6432551665097,53.3567448334902
"2000","get little",-9.23181383427641,73,9,64,19.6432551665097,53.3567448334902
"2000","vision",-9.23181383427641,73,9,64,19.6432551665097,53.3567448334902
"1990","now got",-9.27550944453628,108,11,97,22.9116271603894,85.0883728396106
"1990","taken",-9.27550944453628,108,11,97,22.9116271603894,85.0883728396106
"2010","times",-9.28062563725688,626,70,556,96.3806652105136,529.619334789486
"2000","place",-9.28770426983375,943,213,730,253.747803041352,689.252196958648
"2010","knowing",-9.28938919445958,133,9,124,20.4770422891347,112.522957710865
"1970","check",-9.31038609354511,261,20,241,35.7172997710486,225.282700228951
"2010","gonna take",-9.32380496372776,170,13,157,26.1736630763376,143.826336923662
"2010","get get get get",-9.32980137151177,161,12,149,24.7879985605315,136.212001439469
"1980","long time",-9.33846127149358,155,13,142,26.0765377847546,128.923462215245
"2010","darkness",-9.34357385989232,104,6,98,16.0121232937595,87.9878767062406
"2010","within",-9.34357385989232,104,6,98,16.0121232937595,87.9878767062406
"2010","hear say",-9.34855083411534,114,7,107,17.551750533544,96.448249466456
"2010","read",-9.3579456078812,188,15,173,28.9449921079498,159.05500789205
"2000","changes",-9.35805622669472,68,8,60,18.2978267304474,49.7021732695526
"2000","mighty",-9.36125328551285,94,13,81,25.2940545979715,68.7059454020285
"1990","youre youre",-9.38175151332323,95,9,86,20.1537461133055,74.8462538866945
"1970","lock",-9.39472643321363,118,6,112,16.1480512374856,101.851948762514
"2010","respect",-9.39938811525171,124,8,116,19.0913777733286,104.908622226671
"2000","know dont",-9.40057562375835,243,45,198,65.3878219926283,177.612178007372
"1970","know got",-9.42842698654363,213,15,198,29.1486009625799,183.85139903742
"1960","thinking",-9.44751636450339,452,13,439,26.994919573579,425.005080426421
"1980","til",-9.45767069311181,594,73,521,99.9320222202853,494.067977779715
"1980","double",-9.47216135281669,122,9,113,20.5247587725165,101.475241227483
"1990","mountain",-9.47676660895494,141,16,125,29.912402126064,111.087597873936
"2010","oh yes",-9.48418068783875,134,9,125,20.6310050131131,113.368994986887
"1960","every time",-9.49261580917835,356,9,347,21.2614853278631,334.738514672137
"1960","apart",-9.49619863206552,279,6,273,16.6627932766118,262.337206723388
"1980","hello",-9.53226555978021,156,13,143,26.2447735123982,129.755226487602
"2000","ghost",-9.53272473815799,63,7,56,16.9523982943851,46.0476017056149
"2000","last forever",-9.53272473815799,63,7,56,16.9523982943851,46.0476017056149
"2000","rock body",-9.53272473815799,63,7,56,16.9523982943851,46.0476017056149
"2000","step step",-9.53272473815799,63,7,56,16.9523982943851,46.0476017056149
"2000","well never",-9.53272473815799,63,7,56,16.9523982943851,46.0476017056149
"2000","dreaming",-9.53928270586878,162,27,135,43.5918813284189,118.408118671581
"2000","meaning",-9.53928270586878,162,27,135,43.5918813284189,118.408118671581
"1990","gonna",-9.54399811116519,4550,881,3669,965.258366479369,3584.74163352063
"1960","sorry",-9.55185762296634,306,7,299,18.2753216582194,287.724678341781
"1980","dog",-9.55699962373405,131,10,121,22.0388803213087,108.961119678691
"1980","wife",-9.55699962373405,131,10,121,22.0388803213087,108.961119678691
"2010","know aint",-9.55969557314547,105,6,99,16.1660860177379,88.8339139822621
"2000","home",-9.56326073286938,1475,345,1130,396.901388638382,1078.09861136162
"2000","youll never",-9.56817602134902,176,30,146,47.3590809493934,128.640919050607
"1960","put",-9.58307635157341,1646,70,1576,98.3045080046705,1547.69549199533
"2010","give give",-9.60094218343469,125,8,117,19.245340497307,105.754659502693
"2010","thang",-9.60094218343469,125,8,117,19.245340497307,105.754659502693
"1970","know youre",-9.60656250990375,448,40,408,61.3078555457079,386.692144454292
"1970","whos",-9.61175491078865,457,41,416,62.5394865722958,394.460513427704
"1970","turn",-9.61218407062968,1733,194,1539,237.157396564089,1495.84260343591
"1990","rainy",-9.62975576033529,89,8,81,18.8808779377283,70.1191220622717
"1990","cover",-9.6455159937605,116,12,104,24.6087847278257,91.3912152721743
"1990","send",-9.65066703689632,191,24,167,40.5196369225405,150.480363077459
"2010","shoulder",-9.68004684021501,135,9,126,20.7849677370916,114.215032262908
"1980","bring",-9.6930165409964,896,117,779,150.739211968646,745.260788031354
"1990","party like",-9.69526932065637,75,6,69,15.9108521947149,59.0891478052851
"2000","saturday",-9.71912681662151,115,17,98,30.9448540294332,84.0551459705668
"1990","moonlight",-9.72076462282448,103,10,93,21.8509036807418,81.1490963192582
"2000","go oh",-9.72361680818733,90,12,78,24.2177118491216,65.7822881508784
"1970","baby just",-9.73353131344776,205,14,191,28.0538178278351,176.946182172165
"2000","join",-9.73658854925926,69,8,61,18.5669124176599,50.4330875823401
"2000","lived",-9.73658854925926,69,8,61,18.5669124176599,50.4330875823401
"1970","dont need",-9.73950370493164,395,34,361,54.0549172780237,340.945082721976
"2000","beside",-9.75027351796026,144,23,121,38.7483389585946,105.251661041405
"2000","seasons",-9.77151677146469,58,6,52,15.6069698583228,42.3930301416772
"2000","sing song",-9.77151677146469,58,6,52,15.6069698583228,42.3930301416772
"1990","water",-9.77659118595892,245,33,212,51.9754505027352,193.024549497265
"2010","behind",-9.77738682649554,342,33,309,52.6552516006321,289.344748399368
"1970","goes",-9.78072800954271,712,70,642,97.4356989922857,614.564301007714
"1970","inside",-9.79002389797849,991,103,888,135.61626081651,855.38373918349
"2000","love want",-9.79621802280478,125,19,106,33.6357109015578,91.3642890984422
"2000","love know",-9.8246000219619,149,24,125,40.0937673946569,108.906232605343
"1980","can go",-9.84434830146884,198,18,180,33.3106740734284,164.689325926572
"2000","enjoy",-9.84602066907262,130,20,110,34.9811393376201,95.0188606623799
"2000","makin love",-9.85554874264525,80,10,70,21.526854976997,58.473145023003
"1970","wants",-9.87574067082809,557,52,505,76.2242757566056,480.775724243394
"1970","slide",-9.87822861401474,143,8,135,19.569248533563,123.430751466437
"1990","radio",-9.89014962929166,180,22,158,38.1860452673157,141.813954732684
"2000","know ill",-9.89258947275282,168,28,140,45.2063954516937,122.793604548306
"1970","hip",-9.89694940920156,132,7,125,18.0639217232889,113.936078276711
"1970","im feeling",-9.89694940920156,132,7,125,18.0639217232889,113.936078276711
"2000","round round",-9.90269421949145,154,25,129,41.4391958307192,112.560804169281
"1980","bottle",-9.90503531144125,124,9,115,20.8612302278037,103.138769772196
"1960","wish",-9.94508525907833,839,30,809,50.1078263766212,788.892173623379
"1980","know want",-9.94780325564661,253,25,228,42.5636390938252,210.436360906175
"2000","dont talk",-9.96690267003295,75,9,66,20.1814265409347,54.8185734590653
"2010","one love",-9.97655737800149,117,7,110,18.0136387054794,98.9863612945206
"1980","make",-9.97661569724482,5520,842,4678,928.66121659255,4591.33878340745
"1960","youre one",-9.97708690500777,285,6,279,17.0211329169691,267.978867083031
"2010","blue",-9.97886485140009,471,49,422,72.5164429938529,398.483557006147
"1980","pop",-9.99196728119428,394,44,350,66.2848766915697,327.71512330843
"1990","trouble",-9.99360525006477,162,19,143,34.3674407405841,127.632559259416
"1990","gold",-9.99799050101095,304,43,261,64.4919875625776,239.508012437422
"2000","uhh",-10.0001568152727,106,15,91,28.523082844521,77.476917155479
"2010","just want",-10.0019073961686,244,21,223,37.5669046507433,206.433095349257
"2000","last",-10.0116760659638,827,183,644,222.533863324706,604.466136675294
"1980","gave",-10.0364460143132,466,54,412,78.3978490819073,387.602150918093
"1970","thinking",-10.0391485221938,452,40,412,61.8552471130803,390.14475288692
"1970","something",-10.0393975337379,1202,128,1074,164.491165995404,1037.5088340046
"1970","kiss",-10.0471428443789,809,81,728,110.709944501066,698.290055498934
"2010","said",-10.0509312225391,2163,281,1882,333.021371965401,1829.9786280346
"1990","cool",-10.0533122830421,389,58,331,82.5242867165878,306.475713283412
"1990","says",-10.0536658435103,361,53,308,76.5842352305609,284.415764769439
"1980","ice",-10.0607522521991,215,20,195,36.1706814433693,178.829318556631
"1980","peace",-10.0716704820724,167,14,153,28.0953665164775,138.904633483522
"1990","air",-10.080714222628,417,63,354,88.4643382026147,328.535661797385
"1990","somewhere",-10.091138505654,229,30,199,48.5811353678627,180.418864632137
"2000","tough",-10.1015352815731,150,24,126,40.3628530818693,109.637146918131
"1990","say say",-10.1133425368661,150,17,133,31.8217043894297,118.17829561057
"1980","american",-10.1233764786445,125,9,116,21.0294659554472,103.970534044553
"2010","today",-10.125850285218,377,37,340,58.043946939878,318.956053060122
"2000","baby now",-10.1279938933622,86,11,75,23.1413691002718,62.8586308997282
"1990","runnin",-10.1301095932503,241,32,209,51.1268717190171,189.873128280983
"1960","thats",-10.1346327761862,2727,125,2602,162.865366542367,2564.13463345763
"1980","glass",-10.1391973794598,98,6,92,16.4871013090706,81.5128986909294
"1960","dance",-10.1457978273721,1542,64,1478,92.0932875718116,1449.90671242819
"1990","every time",-10.1541513720046,356,52,304,75.5235117509133,280.476488249087
"1990","poppin",-10.1664132079382,118,12,106,25.0330741196847,92.9669258803153
"1990","takin",-10.1664132079382,118,12,106,25.0330741196847,92.9669258803153
"1980","trust",-10.1704092496697,239,23,216,40.2083389068151,198.791661093185
"1970","house",-10.171549748647,417,36,381,57.0655708985718,359.934429101428
"1970","close eyes",-10.1785690218788,218,15,203,29.8328404217953,188.167159578205
"1970","follow",-10.1785690218788,218,15,203,29.8328404217953,188.167159578205
"2000","greatest",-10.1820018085748,59,6,53,15.8760555455353,43.1239444544647
"2000","rain",-10.200212414336,767,168,599,206.388722091959,560.611277908042
"2010","just dont",-10.2032002598098,184,14,170,28.329141212036,155.670858787964
"2010","say love",-10.2032002598098,184,14,170,28.329141212036,155.670858787964
"2010","grown",-10.2120976237366,128,8,120,19.7072286692424,108.292771330758
"2010","mercy",-10.2148987838689,108,6,102,16.6279741896733,91.3720258103267
"2000","yes can",-10.2171739770317,81,10,71,21.7959406642094,59.2040593357906
"1990","cherish",-10.2382566350044,84,7,77,17.8201544580807,66.1798455419193
"1990","lyin",-10.2382566350044,84,7,77,17.8201544580807,66.1798455419193
"1980","goes",-10.265488885737,712,89,623,119.783838082227,592.216161917773
"1970","safe",-10.2693336133594,134,7,127,18.3376175069751,115.662382493025
"1980","slide",-10.2828385084301,143,11,132,24.0577090530316,118.942290946968
"1990","fallin",-10.3004249033238,188,23,165,39.8832028347519,148.116797165248
"1990","girl know",-10.3004249033238,188,23,165,39.8832028347519,148.116797165248
"2000","sight",-10.300465450794,211,37,174,56.7770800018295,154.22291999817
"1990","wheel",-10.3200596121259,77,6,71,16.3351415865739,60.6648584134261
"2000","want can",-10.323191219194,65,7,58,17.49056966881,47.50943033119
"2000","tell love",-10.325294524574,112,16,96,30.1375969677958,81.8624030322042
"2010","another",-10.3278112379147,1121,135,986,172.592213579849,948.407786420151
"1980","game",-10.3603735744383,644,79,565,108.343808602464,535.656191397536
"2000","fantasy",-10.363151577402,122,18,104,32.8284538399204,89.1715461600796
"1970","forget",-10.3747671430559,491,44,447,67.1923148949611,423.807685105039
"1980","even know",-10.3819128313256,99,6,93,16.6553370367142,82.3446629632858
"1980","got time",-10.3819128313256,99,6,93,16.6553370367142,82.3446629632858
"2010","gonna get",-10.3882282636694,272,24,248,41.8778609221401,230.12213907786
"1990","know know know",-10.4011328383863,132,14,118,28.0030998626982,103.996900137302
"2000","crying",-10.4097712217294,216,38,178,58.1225084378919,157.877491562108
"2010","love need",-10.4179223462783,129,8,121,19.8611913932209,109.138808606779
"1990","might",-10.4325065823691,702,115,587,148.925576542531,553.074423457469
"2000","hip",-10.4371731015796,132,20,112,35.519310712045,96.480689287955
"2000","poison",-10.4828849866876,87,11,76,23.4104547874842,63.5895452125158
"2000","cause ive",-10.5049439210912,71,8,63,19.1050837920848,51.8949162079152
"2000","wanna tell",-10.5049439210912,71,8,63,19.1050837920848,51.8949162079152
"1990","pour",-10.5050355259422,92,8,84,19.5173120255169,72.4826879744831
"1990","favorite",-10.5101629367121,99,9,90,21.0023248970236,77.9976751029764
"1980","tell em",-10.5184651244847,161,13,148,27.085952150616,133.914047849384
"1990","birds",-10.5421888959589,85,7,78,18.0322991540102,66.9677008459898
"1970","bottle",-10.5502659207369,124,6,118,16.9691385885441,107.030861411456
"1970","shy",-10.5502659207369,124,6,118,16.9691385885441,107.030861411456
"1990","loved",-10.5820095760958,398,59,339,84.4335889799536,313.566411020046
"2000","know much",-10.5822771716183,82,10,72,22.0650263514219,59.9349736485781
"2010","get",-10.5832018184203,8265,1167,7098,1272.50191368194,6992.49808631806
"2000","oh now",-10.5963250057583,60,6,54,16.1451412327477,43.8548587672523
"2010","late",-10.6190341084012,421,42,379,64.8183067949301,356.18169320507
"2010","enjoy",-10.6247721513523,130,8,122,20.0151541171993,109.984845882801
"1980","youre never",-10.6259317102115,100,6,94,16.8235727643578,83.1764272356422
"2000","time time",-10.6264285212674,194,33,161,52.2026233192177,141.797376680782
"1960","cuz",-10.6266852763935,293,6,287,17.4989191041121,275.501080895888
"1960","somethin",-10.6266852763935,293,6,287,17.4989191041121,275.501080895888
"1990","know never",-10.6357778729847,78,6,72,16.5472862825035,61.4527137174965
"1970","known",-10.6632822221298,211,14,197,28.8749051788937,182.125094821106
"2000","alone",-10.668018058386,975,218,757,262.358545032151,712.641454967849
"2000","moonlight",-10.6687290124931,103,14,89,27.7158257828836,75.2841742171164
"1990","running",-10.6985331681171,365,53,312,77.432814014279,287.567185985721
"1990","loving",-10.6995357802601,504,78,426,106.920926748484,397.079073251516
"2000","gonna give",-10.7046694414358,98,13,85,26.3703973468213,71.6296026531787
"2000","hangin",-10.7046694414358,98,13,85,26.3703973468213,71.6296026531787
"1990","mama",-10.7074069646951,460,70,390,97.5865601275845,362.413439872415
"1990","lot",-10.7090202133304,410,61,349,86.979325331108,323.020674668892
"1980","love love love love",-10.7190365813584,162,13,149,27.2541878782596,134.74581212174
"2000","always love",-10.7240576061729,66,7,59,17.7596553560225,48.2403446439775
"2000","ever wanted",-10.7240576061729,66,7,59,17.7596553560225,48.2403446439775
"2000","huh huh",-10.7240576061729,66,7,59,17.7596553560225,48.2403446439775
"1990","one night",-10.7499717282117,159,18,141,33.7310066527955,125.268993347204
"1980","wanna get",-10.7530095099482,195,17,178,32.8059668904977,162.194033109502
"2010","miss",-10.7596367816152,717,80,637,110.391273092553,606.608726907447
"1980","everything",-10.7696557457701,1269,171,1098,213.4911383797,1055.5088616203
"1970","breathe",-10.7715112355359,191,12,179,26.1379473420317,164.862052657968
"1970","hey hey hey hey",-10.7783332846644,159,9,150,21.7588148030526,137.241185196947
"1980","snow",-10.7911593691336,110,7,103,18.5059300407936,91.4940699592064
"2010","laugh",-10.7964947018184,169,12,157,26.0197003523591,142.980299647641
"1970","wanna see",-10.803535428671,262,19,243,35.8541476628917,226.145852337108
"2000","dancin",-10.8045179305661,162,26,136,43.5918813284189,118.408118671581
"2000","trouble",-10.8045179305661,162,26,136,43.5918813284189,118.408118671581
"2000","blue",-10.810610403906,471,96,375,126.73935867707,344.26064132293
"1970","bit",-10.8379963913383,540,49,491,73.8978615952729,466.102138404727
"2000","dont take",-10.8411036169098,88,11,77,23.6795404746967,64.3204595253033
"1990","lemme",-10.8482329304451,86,7,79,18.2444438499397,67.7555561500603
"1990","make better",-10.8482329304451,86,7,79,18.2444438499397,67.7555561500603
"1970","pull",-10.866977258977,282,21,261,38.5911054997536,243.408894500246
"2010","theyll",-10.8769172492419,141,9,132,21.7087440809623,119.291255919038
"1980","grab",-10.9129890683043,146,11,135,24.5624162359624,121.437583764038
"1990","drop",-10.9277267139279,417,62,355,88.4643382026147,328.535661797385
"2000","cat",-10.9507681886177,83,10,73,22.3341120386344,60.6658879613656
"2000","yeah just",-10.9507681886177,83,10,73,22.3341120386344,60.6658879613656
"1980","fallin",-10.9621481171032,188,16,172,31.6283167969926,156.371683203007
"1980","want know",-10.9643523028753,305,31,274,51.3118969312913,253.688103068709
"1970","cause got",-10.9678647847489,149,8,141,20.3903358846216,128.609664115378
"2000","im never",-10.9791495934033,109,15,94,29.3303399061584,79.6696600938416
"2010","somehow",-10.9840230235918,170,12,158,26.1736630763376,143.826336923662
"1980","couple",-10.9972097217268,120,8,112,20.1882873172294,99.8117126827707
"1980","short",-10.9972097217268,120,8,112,20.1882873172294,99.8117126827707
"1980","trip",-11.008954048324,129,9,120,21.7024088660216,107.297591133978
"1970","bed",-11.0128539975005,350,28,322,47.8967621450843,302.103237854916
"2000","love get",-11.0143524804405,61,6,55,16.4142269199602,44.5857730800398
"2000","turn back",-11.0143524804405,61,6,55,16.4142269199602,44.5857730800398
"1970","probably",-11.0238764016213,138,7,131,18.8850090743475,119.114990925652
"2000","oh yes",-11.0391495224689,134,20,114,36.0574820864699,97.9425179135301
"2010","talk",-11.041500175625,975,114,861,150.113655878995,824.886344121005
"2000","now know",-11.0429370390007,177,29,148,47.6281666366058,129.371833363394
"1980","whatever",-11.0494218262629,343,36,307,57.7048545817472,285.295145418253
"1990","floor",-11.052603957073,648,104,544,137.469762962336,510.530237037664
"2010","youre one",-11.0714111209543,285,25,260,43.8793763338601,241.12062366614
"1980","like im",-11.0838729528332,283,28,255,47.6107109231326,235.389289076867
"1990","dance dance dance",-11.0866697000474,101,9,92,21.4266142888827,79.5733857111173
"1990","car",-11.093364141559,390,57,333,82.7364314125173,307.263568587483
"1990","know know",-11.093364141559,390,57,333,82.7364314125173,307.263568587483
"1990","slow",-11.0937516066307,567,89,478,120.286042592044,446.713957407956
"1990","night night",-11.0989907071769,94,8,86,19.941601417376,74.058398582624
"1990","wrote",-11.0989907071769,94,8,86,19.941601417376,74.058398582624
"2010","tell love",-11.1036655852093,112,6,106,17.2438250855871,94.7561749144129
"2010","true love",-11.1036655852093,112,6,106,17.2438250855871,94.7561749144129
"1980","man im",-11.1177735121029,102,6,96,17.1600442196449,84.8399557803551
"1990","watch",-11.1240183868674,697,113,584,147.864853062884,549.135146937116
"2000","yeah baby",-11.1246976834723,144,22,122,38.7483389585946,105.251661041405
"2000","youre good",-11.1285197315927,67,7,60,18.028741043235,48.971258956765
"1990","can go",-11.1448547987913,198,24,174,42.0046497940473,155.995350205953
"2010","pride",-11.1502909554222,152,10,142,23.4023340447254,128.597665955275
"2010","daddy",-11.1542111343455,344,32,312,52.963177048589,291.036822951411
"1990","girl let",-11.1563377587051,87,7,80,18.4565885458693,68.5434114541307
"1960","make feel",-11.1595398469099,404,10,394,24.1282024507211,379.871797549279
"2010","darling",-11.1615546525415,260,22,238,40.0303082343986,219.969691765601
"2010","one",-11.1616688019058,5413,746,4667,833.400224895384,4579.59977510462
"1990","girlfriend",-11.1670358648946,135,14,121,28.6395339504868,106.360466049513
"1990","girls",-11.1885146268829,942,159,783,199.840303565619,742.159696434381
"1980","uh huh",-11.1891590038359,276,27,249,46.4330608296275,229.566939170372
"1990","next",-11.2009972245504,491,75,416,104.1630457014,386.8369542986
"2000","skies",-11.2025692414062,89,11,78,23.9486261619091,65.0513738380909
"1990","shake shake",-11.2128671267953,402,59,343,85.2821677636717,316.717832236328
"1980","young",-11.220040779641,589,70,519,99.0908435820674,489.909156417933
"1980","since",-11.224940725144,497,57,440,83.6131566388582,413.386843361142
"1990","tell em",-11.2263409979835,161,18,143,34.1552960446546,126.844703955345
"2010","can see",-11.2447578365966,450,45,405,69.2832257903053,380.716774209695
"2010","cant help",-11.2604913902883,199,15,184,30.6385820717128,168.361417928287
"1970","nothing",-11.2708258027597,1236,130,1106,169.143994318069,1066.85600568193
"2000","survive",-11.3442196095519,105,14,91,28.2539971573085,76.7460028426915
"1960","got",-11.367914930337,8289,424,7865,495.046213153532,7793.95378684647
"1990","gonna love",-11.3926124354551,109,10,99,23.1237718563189,85.8762281436811
"2010","understand",-11.3932482455013,585,62,523,90.0681935273969,494.931806472603
"2000","joy",-11.4338504913519,169,27,142,45.4754811389061,123.524518861094
"2010","yes",-11.4604513663111,1017,119,898,156.58009028609,860.41990971391
"2010","anyone",-11.4621033906606,134,8,126,20.6310050131131,113.368994986887
"2010","know cant",-11.4621033906606,134,8,126,20.6310050131131,113.368994986887
"2010","see",-11.5036370037844,5264,723,4541,810.459779022594,4453.54022097741
"1990","shake",-11.5243627387091,1207,209,998,256.058647986945,950.941352013055
"2000","drag",-11.5364648790674,68,7,61,18.2978267304474,49.7021732695526
"2000","nobody can",-11.5364648790674,68,7,61,18.2978267304474,49.7021732695526
"2000","sure",-11.539865386265,560,116,444,150.687984838979,409.312015161021
"1960","now im",-11.5430696316651,555,16,539,33.146416733045,521.853583266955
"2010","pain",-11.5689060656547,524,54,470,80.6764673647111,443.323532635289
"1980","rollin",-11.5864302552125,183,15,168,30.7871381587748,152.212861841225
"1990","met",-11.587775859238,313,43,270,66.4012898259434,246.598710174057
"2010","brother",-11.6174098475136,201,15,186,30.9465075196697,170.05349248033
"1980","fell",-11.6565144510178,224,20,204,37.6848029921615,186.315197007839
"1990","bop bop",-11.6710344726943,150,16,134,31.8217043894297,118.17829561057
"2000","thank",-11.678610529724,244,43,201,65.6569076798408,178.343092320159
"2000","mountain",-11.6823096624635,141,21,120,37.9410818969572,103.058918103043
"2000","love hear",-11.6840573605277,74,8,66,19.9123408537222,54.0876591462778
"2000","will will",-11.6840573605277,74,8,66,19.9123408537222,54.0876591462778
"1990","line",-11.6877611757605,461,69,392,97.7987048235141,363.201295176486
"1990","cold",-11.6968029711409,522,80,442,110.739531275216,411.260468724785
"1990","sail",-11.7008647257193,96,8,88,20.365890809235,75.634109190765
"2010","sea",-11.742964543639,174,12,162,26.7895139722514,147.210486027749
"1970","without",-11.7457825661058,1367,145,1222,187.071068149515,1179.92893185049
"2010","changed",-11.7492351440647,155,10,145,23.8642222166607,131.135777783339
"2010","tears",-11.7688565978679,502,51,451,77.2892874371851,424.710712562815
"1990","million",-11.7734426004654,207,25,182,43.913952057413,163.086047942587
"1990","fucking",-11.7785349168435,89,7,82,18.8808779377283,70.1191220622717
"2000","words",-11.7836843249833,612,128,484,164.680440574027,447.319559425973
"2010","school",-11.7970769371906,202,15,187,31.1004702436482,170.899529756352
"2000","end",-11.8188718879571,629,132,497,169.254897256639,459.745102743361
"1960","burn",-11.8418552154117,335,7,328,20.0072965866128,314.992703413387
"2000","hill",-11.8610187229061,63,6,57,16.9523982943851,46.0476017056149
"1980","im back",-11.8646686826395,105,6,99,17.6647514025757,87.3352485974243
"1980","nana",-11.8646686826395,105,6,99,17.6647514025757,87.3352485974243
"2000","deep love",-11.8665651977566,80,9,71,21.526854976997,58.473145023003
"2000","voices",-11.8665651977566,80,9,71,21.526854976997,58.473145023003
"2000","wine",-11.8708454665943,161,25,136,43.3227956412064,117.677204358794
"1980","friends",-11.8745164154407,762,94,668,128.195624464406,633.804375535594
"1960","ride",-11.8789793624486,898,31,867,53.6314995068008,844.368500493199
"2000","use",-11.9089953544695,290,53,237,78.0348492916141,211.965150708386
"2010","father",-11.9173819145137,126,7,119,19.3993032212855,106.600696778715
"1990","angels",-11.9194715125243,82,6,76,17.3958650662216,64.6041349337784
"1990","truck",-11.9194715125243,82,6,76,17.3958650662216,64.6041349337784
"1980","diamonds",-11.9268805791874,193,16,177,32.4694954352105,160.530504564789
"2000","every little",-11.9349336329929,91,11,80,24.4867975363341,66.5132024636659
"2000","therell",-11.9477855555874,69,7,62,18.5669124176599,50.4330875823401
"2000","street",-11.9643929981307,339,64,275,91.2200479650247,247.779952034975
"1990","put",-11.9703899349734,1646,293,1353,349.190169500009,1296.80983049999
"2000","dont ever",-12.0218011307045,147,22,125,39.555596020232,107.444403979768
"1980","came",-12.0231135632528,701,85,616,117.933245078148,583.066754921852
"1990","wait",-12.0246722659698,758,123,635,160.805679514585,597.194320485415
"1970","going",-12.0265977498065,1104,113,991,151.08007259478,952.91992740522
"2000","float",-12.0757177147385,86,10,76,23.1413691002718,62.8586308997282
"2000","time dont",-12.0757177147385,86,10,76,23.1413691002718,62.8586308997282
"2000","take look",-12.0837772657434,75,8,67,20.1814265409347,54.8185734590653
"1970","take time",-12.0849413177142,155,8,147,21.2114232356802,133.78857676432
"1990","drank",-12.0925340731371,90,7,83,19.0930226336578,70.9069773663421
"1990","way move",-12.0925340731371,90,7,83,19.0930226336578,70.9069773663421
"1980","laugh",-12.1524455099628,169,13,156,28.4318379717647,140.568162028235
"1980","miles",-12.1524455099628,169,13,156,28.4318379717647,140.568162028235
"1980","seen",-12.1869282833072,576,67,509,96.9037791227009,479.096220877299
"1990","wall",-12.1883014970608,184,21,163,39.0346240510338,144.965375948966
"2000","dont go",-12.2185478178192,167,26,141,44.9373097644812,122.062690235519
"1980","met",-12.2200237404966,313,31,282,52.6577827524399,260.34221724756
"1990","pocket",-12.2453360720942,83,6,77,17.6080097621511,65.3919902378489
"1990","uh uh uh uh",-12.2453360720942,83,6,77,17.6080097621511,65.3919902378489
"1960","drive",-12.2480733605901,340,7,333,20.3059129535771,319.694087046423
"1960","reason",-12.2480733605901,340,7,333,20.3059129535771,319.694087046423
"2010","lady",-12.2779308078879,530,54,476,81.6002437085818,448.399756291418
"2000","mother",-12.2801713263631,172,27,145,46.2827382005435,125.717261799456
"2000","can work",-12.289422358991,64,6,58,17.2214839815976,46.7785160184024
"2000","la da",-12.289422358991,64,6,58,17.2214839815976,46.7785160184024
"2000","love tonight",-12.289422358991,64,6,58,17.2214839815976,46.7785160184024
"2000","got get",-12.3056852416942,92,11,81,24.7558832235465,67.2441167764535
"2000","surprise",-12.3056852416942,92,11,81,24.7558832235465,67.2441167764535
"1990","little girl",-12.3103163004403,98,8,90,20.7901802010941,77.2098197989059
"2010","prove",-12.3146041116386,138,8,130,21.246855909027,116.753144090973
"2010","learned",-12.3171051732134,148,9,139,22.7864831488115,125.213516851188
"2010","blind",-12.3202571986827,214,16,198,32.9480229313897,181.05197706861
"2000","rolling",-12.3256729262161,148,22,126,39.8246817074444,108.175318292556
"1990","lean",-12.3329579566936,270,35,235,57.2790679009735,212.720932099026
"1990","bar",-12.3459741385074,172,19,153,36.4888876998794,135.511112300121
"1970","clothes",-12.346393518843,211,13,198,28.8749051788937,182.125094821106
"2010","one one",-12.3561898378535,158,10,148,24.3261103885961,133.673889611404
"2000","believing",-12.3623791733847,70,7,63,18.8359981048724,51.1640018951276
"2000","blowing",-12.3623791733847,70,7,63,18.8359981048724,51.1640018951276
"2000","oh oh oh",-12.3638206386786,1867,436,1431,502.382978025667,1364.61702197433
"2010","listen",-12.3681809851538,491,49,442,75.595697473422,415.404302526578
"2010","got love",-12.4242101570628,168,11,157,25.8657376283807,142.134262371619
"1990","said",-12.4570612889779,2163,393,1770,458.868977295577,1704.13102270442
"1990","late",-12.4614444179818,421,61,360,89.3129169863328,331.687083013667
"2000","got love",-12.5080974481789,168,26,142,45.2063954516937,122.793604548306
"2010","say goodbye",-12.5155327562359,178,12,166,27.4053648681652,150.594635131835
"1990","stupid",-12.5447716231662,113,10,103,23.9723506400371,89.0276493599629
"2000","little girl",-12.5522343645812,98,12,86,26.3703973468213,71.6296026531787
"1990","can dig",-12.5611661054696,106,9,97,22.4873377685304,83.5126622314696
"1970","faith",-12.5694442709793,146,7,139,19.9797922090923,126.020207790908
"1970","kill",-12.5694442709793,146,7,139,19.9797922090923,126.020207790908
"1990","thousand",-12.5894617239389,173,19,154,36.701032395809,136.298967604191
"1970","bay",-12.5924235591135,169,9,160,23.1272937214836,145.872706278516
"2010","years",-12.5986874150737,412,39,373,63.432642279124,348.567357720876
"2000","never ever",-12.6064558967741,144,21,123,38.7483389585946,105.251661041405
"1990","im man",-12.6177829803653,99,8,91,21.0023248970236,77.9976751029764
"2000","coming back",-12.625395781419,119,16,103,32.021196778283,86.978803221717
"2010","yeah yeah yeah yeah",-12.6575319134435,549,56,493,84.5255354641725,464.474464535827
"2010","secret",-12.7107294997626,179,12,167,27.5593275921437,151.440672407856
"1960","makin",-12.7134049110341,318,6,312,18.9920009389339,299.007999061066
"2000","flash",-12.7210591906304,65,6,59,17.49056966881,47.50943033119
"2000","let take",-12.7210591906304,65,6,59,17.49056966881,47.50943033119
"2000","time know",-12.7210591906304,65,6,59,17.49056966881,47.50943033119
"1990","solo",-12.7261125857251,92,7,85,19.5173120255169,72.4826879744831
"2000","gotta gotta",-12.7299063968901,109,14,95,29.3303399061584,79.6696600938416
"1990","cut",-12.762859438276,236,29,207,50.0661482393695,185.933851760631
"1970","memory",-12.7658509137846,147,7,140,20.1166401009354,126.883359899065
"2010","oh yeah",-12.7673545977403,542,55,487,83.4477963963233,458.552203603677
"2000","baby aint",-12.7801477556769,71,7,64,19.1050837920848,51.8949162079152
"2000","day day",-12.7801477556769,71,7,64,19.1050837920848,51.8949162079152
"2000","happiness",-12.7801477556769,71,7,64,19.1050837920848,51.8949162079152
"2000","hungry",-12.7801477556769,71,7,64,19.1050837920848,51.8949162079152
"2000","love someone",-12.7801477556769,71,7,64,19.1050837920848,51.8949162079152
"1980","mother",-12.7818104031128,172,13,159,28.9365451546954,143.063454845305
"2000","miles",-12.7998268697945,169,26,143,45.4754811389061,123.524518861094
"2010","room",-12.8277573533299,389,36,353,59.8914996276195,329.10850037238
"1960","bad",-12.8324180119503,1258,47,1211,75.1318779282354,1182.86812207176
"2000","sister",-12.8411187433193,88,10,78,23.6795404746967,64.3204595253033
"2010","world",-12.8437770139229,2103,266,1837,323.783608526694,1779.21639147331
"2010","everyone",-12.8605202293206,217,16,201,33.409911103325,183.590088896675
"2010","place",-12.8617688145464,943,107,836,145.186848711684,797.813151288316
"1990","shine",-12.8651022371423,395,56,339,83.797154892165,311.202845107835
"1980","disco",-12.8765947768233,109,6,103,18.33769431315,90.66230568685
"1980","baby",-12.8806782273661,9098,1404,7694,1530.60865010127,7567.39134989873
"1990","get right",-12.8808900085577,128,12,116,27.15452107898,100.84547892102
"2000","evil",-12.8926821478429,77,8,69,20.7195979153596,56.2804020846404
"2000","know dont know",-12.8926821478429,77,8,69,20.7195979153596,56.2804020846404
"1970","bad",-12.9017741183054,1258,130,1128,172.154647938617,1085.84535206138
"1970","gotta",-12.9062136024082,1926,211,1715,263.569039689807,1662.43096031019
"2000","beach",-12.9111142469121,130,18,112,34.9811393376201,95.0188606623799
"1980","ridin",-12.9150401542567,198,16,182,33.3106740734284,164.689325926572
"1980","push",-12.9172752808971,164,12,152,27.5906593335468,136.409340666453
"2010","long",-12.9343663239795,1918,240,1678,295.300504590679,1622.69949540932
"2000","ooh baby",-12.9404609242548,150,22,128,40.3628530818693,109.637146918131
"1990","new york",-12.9418450416873,168,18,150,35.6403089161613,132.359691083839
"2010","tellin",-12.9477095908425,151,9,142,23.2483713207469,127.751628679253
"2010","mountain",-12.9633942700511,141,8,133,21.7087440809623,119.291255919038
"1970","head",-12.9649899352029,1158,118,1040,158.469858754307,999.530141245693
"1990","lips",-12.9744257701971,338,46,292,71.7049072241817,266.295092775818
"2000","say love",-12.9789634146253,184,29,155,49.5117664470931,134.488233552907
"2010","reason",-12.9852853295867,340,30,310,52.3473261526751,287.652673847325
"2000","forever",-12.9887805743603,874,189,685,235.180890623692,638.819109376308
"2000","find way",-13.004771909498,160,24,136,43.053709953994,116.946290046006
"2000","wiggle",-13.0147250699302,115,15,100,30.9448540294332,84.0551459705668
"2010","answer",-13.0247600612364,171,11,160,26.327625800316,144.672374199684
"2000","know theres",-13.0451313773245,83,9,74,22.3341120386344,60.6658879613656
"1990","love love love love",-13.0652152717021,162,17,145,34.3674407405841,127.632559259416
"2000","pump",-13.0769942984917,208,34,174,55.9698229401922,152.030177059808
"2000","blues",-13.0832256967776,110,14,96,29.5994255933708,80.4005744066291
"1980","cars",-13.0837675648765,156,11,145,26.2447735123982,129.755226487602
"2010","fine",-13.1096008922324,608,63,545,93.6093361789014,514.390663821099
"1990","aint got",-13.13718089245,268,34,234,56.8547785091145,211.145221490886
"1990","turnin",-13.1634728164342,108,9,99,22.9116271603894,85.0883728396106
"2000","walking",-13.1642621892775,227,38,189,61.0824509972289,165.917549002771
"1980","breathe",-13.1956811320968,191,15,176,32.1330239799234,158.866976020077
"1990","go get",-13.2130044777719,136,13,123,28.8516786464163,107.148321353584
"1970","tell em",-13.2273176507002,161,8,153,22.0325105867388,138.967489413261
"1970","wanna make",-13.2273176507002,161,8,153,22.0325105867388,138.967489413261
"2010","grow",-13.2623386638728,210,15,195,32.3321720354758,177.667827964524
"2000","raise",-13.2667872909009,126,17,109,33.9047965887702,92.0952034112297
"2000","hello",-13.2760026930951,156,23,133,41.9773672051441,114.022632794856
"2000","love right",-13.2892035600439,100,12,88,26.9085687212462,73.0914312787538
"2000","filled",-13.3016944927662,78,8,70,20.9886836025721,57.0113163974279
"2000","little time",-13.3016944927662,78,8,70,20.9886836025721,57.0113163974279
"2000","oooh",-13.3016944927662,78,8,70,20.9886836025721,57.0113163974279
"1970","swear",-13.3185828129838,299,21,278,40.9175196610863,258.082480338914
"2010","special",-13.3186633277782,201,14,187,30.9465075196697,170.05349248033
"1970","apart",-13.3300556507245,279,19,260,38.1805618242243,240.819438175776
"1990","dont give",-13.3426119582161,275,35,240,58.3397913806212,216.660208619379
"1970","prove",-13.3568150293557,138,6,132,18.8850090743475,119.114990925652
"1980","beach",-13.3577827117828,130,8,122,21.8706445936651,108.129355406335
"1980","enjoy",-13.3577827117828,130,8,122,21.8706445936651,108.129355406335
"1990","ooh wee",-13.3668540595769,94,7,87,19.941601417376,74.058398582624
"1980","high",-13.3908077058624,790,96,694,132.906224838427,657.093775161573
"2010","ive got",-13.4059280382439,579,59,520,89.1444171835262,489.855582816474
"2000","people",-13.4222379481314,972,212,760,261.551287970513,710.448712029487
"2000","clouds",-13.4353874349881,95,11,84,25.5631402851839,69.4368597148161
"2000","good times",-13.4391966381466,111,14,97,29.8685112805833,81.1314887194167
"2000","theres",-13.4403330733318,1942,452,1490,522.564404566602,1419.4355954334
"2000","cherish",-13.4439513926564,84,9,75,22.6031977258468,61.3968022741532
"2000","get get get",-13.4574179388088,265,46,219,71.3077071113025,193.692292888697
"1990","got one",-13.4671680808044,109,9,100,23.1237718563189,85.8762281436811
"2010","stick",-13.4798895745038,133,7,126,20.4770422891347,112.522957710865
"2000","dont care",-13.4845034730875,355,66,289,95.5254189604241,259.474581039576
"1960","comin",-13.4849221150867,355,7,348,21.2017620544702,333.79823794553
"1970","style",-13.489348832703,207,12,195,28.3275136115213,178.672486388479
"2000","cant see",-13.5061792821989,306,55,251,82.3402202870135,223.659779712987
"1970","wake",-13.510587408878,330,24,306,45.1598043082223,284.840195691778
"2000","child",-13.519064185102,288,51,237,77.4966779171891,210.503322082811
"1980","yellow",-13.530031420393,158,11,147,26.5812449676853,131.418755032315
"1990","uh huh",-13.5477581978261,276,35,241,58.5519360765507,217.448063923449
"1980","show",-13.561244488407,1443,192,1251,242.764154989683,1200.23584501032
"1960","can get",-13.5683101643157,356,7,349,21.2614853278631,334.738514672137
"2010","gonna make",-13.5743199527283,266,21,245,40.9540845782694,225.045915421731
"1990","dance dance",-13.5775036242492,177,19,158,37.5496111795271,139.450388820473
"1980","want back",-13.5996700678329,131,8,123,22.0388803213087,108.961119678691
"2000","verse",-13.6181781973686,90,10,80,24.2177118491216,65.7822881508784
"2000","can love",-13.6248393464166,73,7,66,19.6432551665097,53.3567448334902
"1990","take",-13.6279085094679,4302,815,3487,912.646481888845,3389.35351811116
"1990","isnt",-13.6308667633359,240,29,211,50.9147270230876,189.085272976912
"2000","kick",-13.6380852787466,329,60,269,88.5291910929001,240.4708089071
"1980","mornin",-13.6468395379297,112,6,106,18.8424014960807,93.1575985039193
"1990","shes",-13.6526635707607,1432,248,1184,303.791204571089,1128.20879542891
"1980","pay",-13.6862908591487,322,31,291,54.1719043012321,267.828095698768
"1990","need need",-13.6898120850242,95,7,88,20.1537461133055,74.8462538866945
"1970","moves",-13.7133953693101,175,9,166,23.9483810725421,151.051618927458
"2000","n roll",-13.7136375100536,79,8,71,21.2577692897845,57.7422307102155
"2000","rock n",-13.7136375100536,79,8,71,21.2577692897845,57.7422307102155
"2000","rock n roll",-13.7136375100536,79,8,71,21.2577692897845,57.7422307102155
"1990","full",-13.7190100431536,342,46,296,72.5534860078998,269.4465139921
"1990","like hot",-13.7244435511137,117,10,107,24.8209294237552,92.1790705762448
"1990","luck",-13.7244435511137,117,10,107,24.8209294237552,92.1790705762448
"1980","gotta get",-13.7377830327423,227,19,208,38.1895101750922,188.810489824908
"1960","anything",-13.743936465355,636,18,618,37.9840018778678,598.015998122132
"1970","cant take",-13.8073912550704,164,8,156,22.4430542622681,141.556945737732
"1980","mmm",-13.8141543956998,194,15,179,32.6377311628541,161.362268837146
"2000","get love",-13.8175535654874,96,11,85,25.8322259723964,70.1677740276036
"2010","ah ah",-13.8241064413018,213,15,198,32.7940602074112,180.205939792589
"1980","bought",-13.8425504417675,132,8,124,22.2071160489523,109.792883951048
"2000","old",-13.8446734380103,730,153,577,196.432551665097,533.567448334903
"2010","given",-13.8626725199298,124,6,118,19.0913777733286,104.908622226671
"2010","wrong",-13.8651371560781,946,106,840,145.64873688362,800.35126311638
"1990","whole life",-13.9019275066485,88,6,82,18.6687332417988,69.3312667582012
"1960","living",-13.9118056415803,517,13,504,30.8769323441158,486.123067655884
"1990","name",-13.9216700698161,977,161,816,207.265367923152,769.734632076848
"1990","dead",-13.9336709383438,204,23,181,43.2775179696245,160.722482030376
"2000","blood",-13.945782825724,128,17,111,34.4429679631952,93.5570320368048
"1980","song",-13.9530063089203,816,99,717,137.28035375716,678.71964624284
"1990","im love",-13.9756750277895,223,26,197,47.3082671922856,175.691732807714
"1990","singing",-13.9756750277895,223,26,197,47.3082671922856,175.691732807714
"1990","breath",-13.9944244395355,260,32,228,55.1576209416782,204.842379058322
"2000","paradise",-13.9983070820669,123,16,107,33.0975395271329,89.9024604728671
"2010","please",-14.0026991298577,1038,118,920,159.813307489638,878.186692510362
"1990","bought",-14.0135505822828,132,12,120,28.0030998626982,103.996900137302
"1990","aint never",-14.0144448519816,96,7,89,20.365890809235,75.634109190765
"2000","just wont",-14.0343560094609,68,6,62,18.2978267304474,49.7021732695526
"1990","aint gonna",-14.0477140993714,139,13,126,29.4881127342049,109.511887265795
"1970","never let",-14.0920896498204,177,9,168,24.2220768562283,152.777923143772
"1980","drive",-14.1112892411523,340,33,307,57.2001473988165,282.799852601183
"1960","air",-14.1248931845378,417,9,408,24.9046050048284,392.095394995172
"1960","alive",-14.1248931845378,417,9,408,24.9046050048284,392.095394995172
"1960","drop",-14.1248931845378,417,9,408,24.9046050048284,392.095394995172
"1960","head",-14.1679483989781,1158,41,1117,69.159550588948,1088.84044941105
"1990","editor",-14.1810371639796,104,8,96,22.0630483766713,81.9369516233287
"1980","goin",-14.1873955115054,556,62,494,93.5390645698293,462.460935430171
"1960","bring",-14.1990194613623,896,29,867,53.512052960015,842.487947039985
"1990","lonely",-14.2039982401975,748,118,630,158.68423255529,589.31576744471
"2000","will make",-14.2500927588384,86,9,77,23.1413691002718,62.8586308997282
"2010","knew",-14.2639542538854,712,75,637,109.621459472661,602.378540527339
"2000","slip",-14.2888906331415,129,17,112,34.7120536504076,94.2879463495924
"2000","sea",-14.2902076197013,174,26,148,46.8209095749684,127.179090425032
"1970","game",-14.2948870480556,644,57,587,88.1300423469551,555.869957653045
"1980","makin",-14.31852251425,318,30,288,53.4989613906578,264.501038609342
"2010","tried",-14.3495130360334,408,37,371,62.8167913832102,345.18320861679
"2010","eyes",-14.3562147096607,1714,209,1505,263.892108899074,1450.10789110093
"1970","wanna know",-14.3711110462192,212,12,200,29.0117530707368,182.988246929263
"1970","west",-14.3711110462192,212,12,200,29.0117530707368,182.988246929263
"2000","solo",-14.4063518643972,92,10,82,24.7558832235465,67.2441167764535
"2000","rose",-14.4149742918913,103,12,91,27.7158257828836,75.2841742171164
"2010","star",-14.4337092119815,375,33,342,57.7360214919211,317.263978508079
"1990","make feel",-14.4384231802117,404,56,348,85.7064571555308,318.293542844469
"1990","run",-14.4603585789446,1088,181,907,230.81342917133,857.18657082867
"1990","get get",-14.464447766184,546,81,465,115.831003977524,430.168996022476
"2000","counting",-14.4779361492753,69,6,63,18.5669124176599,50.4330875823401
"2000","jerk",-14.4779361492753,69,6,63,18.5669124176599,50.4330875823401
"2000","just little bit",-14.4811588611853,75,7,68,20.1814265409347,54.8185734590653
"1960","three",-14.4928782604891,367,7,360,21.9184413351847,345.081558664815
"2000","youll",-14.5231015730864,1377,309,1068,370.530991291561,1006.46900870844
"2000","shining",-14.5250340122214,160,23,137,43.053709953994,116.946290046006
"2000","belongs",-14.546007191794,81,8,73,21.7959406642094,59.2040593357906
"1980","love love love",-14.5535423581248,381,38,343,64.0978122322032,316.902187767797
"2000","groove",-14.5873543029661,297,52,245,79.9184491021013,217.081550897899
"2010","brown",-14.6213172935851,138,7,131,21.246855909027,116.753144090973
"1990","couple",-14.6260809071491,120,10,110,25.4573635115438,94.5426364884562
"2000","soul",-14.6292396902927,642,131,511,172.753011190401,469.246988809599
"1990","best",-14.6293957883413,908,147,761,192.627383904015,715.372616095985
"2000","love now",-14.6343517894331,130,17,113,34.9811393376201,95.0188606623799
"2000","disco",-14.6446950893684,109,13,96,29.3303399061584,79.6696600938416
"2000","running",-14.6982568000058,365,67,298,98.2162758325487,266.783724167451
"2000","ago",-14.6995281102995,125,16,109,33.6357109015578,91.3642890984422
"1980","raise",-14.7256176305365,126,7,119,21.1977016830908,104.802298316909
"1980","dollar",-14.7264782777887,145,9,136,24.3941805083188,120.605819491681
"2010","key",-14.7301749062912,149,8,141,22.94044587279,126.05955412721
"1990","easy",-14.7788203203116,503,73,430,106.708782052554,396.291217947446
"1980","nobody",-14.7798388760817,718,84,634,120.793252448089,597.206747551911
"1990","dancin",-14.7950571645402,162,16,146,34.3674407405841,127.632559259416
"2010","weak",-14.8098516384179,128,6,122,19.7072286692424,108.292771330758
"2010","well",-14.8237484817283,2420,306,2114,372.589792027864,2047.41020797214
"1990","doin",-14.8630397686547,348,46,302,73.826354183477,274.173645816523
"1970","hate",-14.8780292846165,369,27,342,50.4968720901031,318.503127909897
"1990","singin",-14.8790461022003,135,12,123,28.6395339504868,106.360466049513
"1990","grown",-14.888511063417,128,11,117,27.15452107898,100.84547892102
"2000","many",-14.9140555580972,541,107,434,145.575356781942,395.424643218058
"2000","think love",-14.9242771320356,70,6,64,18.8359981048724,51.1640018951276
"1990","leave alone",-14.929693017958,121,10,111,25.6695082074733,95.3304917925267
"1980","son",-14.9568560122619,208,16,192,34.9930313498642,173.006968650136
"2000","oh whoa oh",-14.9662871744875,82,8,74,22.0650263514219,59.9349736485781
"2000","steal",-14.9799960171054,99,11,88,26.6394830340338,72.3605169659662
"1980","everybody",-14.9806797118106,1033,129,904,173.787506655816,859.212493344184
"2000","da da",-14.9863297918218,550,109,441,147.997127966854,402.002872033146
"1980","sky",-14.9871413357701,562,62,500,94.5484789356908,467.451521064309
"2000","get enough",-15.0536821230245,126,16,110,33.9047965887702,92.0952034112297
"2010","heat",-15.0578506403345,210,14,196,32.3321720354758,177.667827964524
"1980","woo",-15.0644616396889,217,17,200,36.5071528986564,180.492847101344
"1980","got",-15.06830951648,8289,1264,7025,1394.50594643762,6894.49405356238
"2010","working",-15.0833929300748,140,7,133,21.5547813569839,118.445218643016
"2010","want",-15.0854476336449,6214,848,5366,956.724366802128,5257.27563319787
"1990","dont worry",-15.100024868376,183,19,164,38.8224793551043,144.177520644896
"1960","shake shake",-15.1025108149247,402,8,394,24.0087559039353,377.991244096065
"2000","understand",-15.1045768404053,585,117,468,157.41512701929,427.58487298071
"2000","never gonna",-15.1113773046922,239,39,200,64.3114792437785,174.688520756222
"2000","world",-15.1305549401987,2103,488,1615,565.887200207808,1537.11279979219
"1970","money",-15.1501771297606,1142,113,1029,156.280292484818,985.719707515182
"2000","night night",-15.2051328100868,94,10,84,25.2940545979715,68.7059454020285
"2000","come baby",-15.2088783707828,177,26,151,47.6281666366058,129.371833363394
"1990","part",-15.2206042328932,338,44,294,71.7049072241817,266.295092775818
"1970","really",-15.2489751695421,1880,201,1679,257.274036665024,1622.72596333498
"2010","sight",-15.2545876368868,211,14,197,32.4861347594543,178.513865240546
"1970","full",-15.2637366150983,342,24,318,46.8019790103395,295.198020989661
"1970","every",-15.2645904204984,2061,223,1838,282.043505088625,1778.95649491138
"1960","jump",-15.2686316869241,404,8,396,24.1282024507211,379.871797549279
"1990","feel like",-15.2716600821152,506,73,433,107.345216140343,398.654783859657
"2010","thought",-15.2883757877775,799,85,714,123.016216458787,675.983783541213
"2010","love im",-15.3109142434494,267,20,247,41.1080473022478,225.891952697752
"1980","comin",-15.3169313556452,355,34,321,59.7236833134702,295.27631668653
"2000","built",-15.3892041583632,83,8,75,22.3341120386344,60.6658879613656
"2000","like like like",-15.3892041583632,83,8,75,22.3341120386344,60.6658879613656
"2010","old",-15.4166181737317,730,76,654,112.392788504273,617.607211495727
"1990","shot",-15.4458295685597,223,25,198,47.3082671922856,175.691732807714
"2000","mind",-15.4521357122254,1930,444,1486,519.335376320052,1410.66462367995
"1970","million",-15.4729620175286,207,11,196,28.3275136115213,178.672486388479
"1990","im like",-15.4857554473018,130,11,119,27.5788104708391,102.421189529161
"1990","cup",-15.4962835360204,151,14,137,32.0338490853593,118.966150914641
"1970","lie",-15.5094713070907,517,42,475,70.7503600828816,446.249639917118
"1970","see",-15.5378421238327,5264,624,4640,720.367302662068,4543.63269733793
"1990","can take",-15.5569940482368,261,31,230,55.3697656376078,205.630234362392
"2010","music",-15.5813210296269,700,72,628,107.773906784919,592.226093215081
"1960","shake",-15.5866214967031,1207,42,1165,72.0859909851988,1134.9140090148
"1990","right im",-15.6001655254805,93,6,87,19.7294567214464,73.2705432785536
"1990","girl dont",-15.6077740071214,165,16,149,35.0038748283727,129.996125171627
"2000","know youll",-15.6083519609658,95,10,85,25.5631402851839,69.4368597148161
"2010","end",-15.6191748489312,629,63,566,96.842553382449,532.157446617551
"2000","oh baby",-15.6220339933891,387,71,316,104.136160951223,282.863839048777
"2010","boys",-15.6269207270958,581,57,524,89.4523426314831,491.547657368517
"1970","talk",-15.627790737672,975,93,882,133.42669454702,841.57330545298
"1980","couldnt",-15.6306434404241,508,54,454,85.4637496429376,422.536250357062
"2010","lover",-15.6580731970248,500,47,453,76.9813619892281,423.018638010772
"2000","hand",-15.6657037066092,859,181,678,231.144605315505,627.855394684495
"2000","knowing",-15.6844723802175,133,17,116,35.7883963992575,97.2116036007425
"1970","might",-15.7135668923959,702,62,640,96.0672200738548,605.932779926145
"2010","come true",-15.7693321467391,132,6,126,20.3230795651562,111.676920434844
"2010","passion",-15.7693321467391,132,6,126,20.3230795651562,111.676920434844
"2000","bye bye",-15.7860478356036,78,7,71,20.9886836025721,57.0113163974279
"1970","want know",-15.7970284485575,305,20,285,41.7386070121449,263.261392987855
"2000","taught",-15.8146916305414,84,8,76,22.6031977258468,61.3968022741532
"2000","belong",-15.8148524742749,302,52,250,81.2638775381636,220.736122461836
"2000","baby oh",-15.8359822220755,154,21,133,41.4391958307192,112.560804169281
"2000","warm",-15.8551926810243,237,38,199,63.7733078693536,173.226692130646
"1970","tough",-15.8667109787135,150,6,144,20.5271837764647,129.472816223535
"2000","close eyes",-15.867283657087,218,34,184,58.6606798123168,159.339320187683
"2000","call name",-15.8734157574275,123,15,108,33.0975395271329,89.9024604728671
"2010","smile",-15.8833989713827,583,57,526,89.76026807944,493.23973192056
"1970","slow",-15.9345237860337,567,47,520,77.5927546750365,489.407245324963
"2000","bad",-15.9488400666284,1258,277,981,338.509794513278,919.490205486723
"1980","whole",-15.9838392175052,613,68,545,103.128501045513,509.871498954487
"2010","love dont",-16.0139632912081,280,21,259,43.1095627139678,236.890437286032
"2010","seen",-16.0218743798327,576,56,520,88.6825290115908,487.317470988409
"1980","gold",-16.0272978818892,304,27,277,51.1436612036477,252.856338796352
"2010","inside",-16.0626143351959,991,109,882,152.57705946265,838.42294053735
"1990","girl youre",-16.088688997864,132,11,121,28.0030998626982,103.996900137302
"2000","blind",-16.0997414125965,214,33,181,57.5843370634669,156.415662936533
"2010","know",-16.1020137965245,11166,1568,9598,1719.14777594344,9446.85222405656
"2000","gonna take",-16.1291097113009,170,24,146,45.7445668261186,124.255433173881
"2000","love need",-16.1298431757747,129,16,113,34.7120536504076,94.2879463495924
"1990","songs",-16.1405694999691,187,19,168,39.6710581388224,147.328941861178
"2000","ooo",-16.1450624783649,180,26,154,48.4354236982432,131.564576301757
"1970","uh huh",-16.1581426624565,276,17,259,37.770018148695,238.229981851305
"1990","uh uh uh",-16.1587822010939,125,10,115,26.5180869911915,98.4819130088085
"1970","second",-16.1763805771892,244,14,230,33.3908856097159,210.609114390284
"2010","pray",-16.1853358950157,206,13,193,31.716321139562,174.283678860438
"1970","straight",-16.2092258562406,255,15,240,34.89621241999,220.10378758001
"1980","yeah oh",-16.2209584926275,214,16,198,36.0024457157257,177.997554284274
"2000","monkey",-16.2261607983796,79,7,72,21.2577692897845,57.7422307102155
"2000","given",-16.2413502666589,124,15,109,33.3666252143453,90.6333747856547
"2000","shy",-16.2413502666589,124,15,109,33.3666252143453,90.6333747856547
"2010","children",-16.2534477697679,134,6,128,20.6310050131131,113.368994986887
"1970","waste",-16.2931815245616,152,6,146,20.8008795601509,131.199120439849
"1970","wee",-16.2931815245616,152,6,146,20.8008795601509,131.199120439849
"1970","put",-16.3093307111963,1646,171,1475,225.251629973739,1420.74837002626
"2000","beg",-16.3119095669648,91,9,82,24.4867975363341,66.5132024636659
"1970","cool",-16.3388425557312,389,28,361,53.2338299269651,335.766170073035
"1990","clap",-16.3491423459966,154,14,140,32.6702831731479,121.329716826852
"1980","hair",-16.3656090800616,369,35,334,62.0789835004803,306.92101649952
"2010","dance dance",-16.3676058927631,177,10,167,27.2514021441868,149.748597855813
"1980","real",-16.3694701863837,1354,174,1180,227.791175229405,1126.2088247706
"1970","watching",-16.3825497484885,256,15,241,35.0330603118331,220.966939688167
"2010","upon",-16.3896735414566,207,13,194,31.8702838635405,175.12971613646
"2000","lord",-16.3967092022495,359,64,295,96.601761709274,262.398238290726
"2000","learn",-16.4132107363027,239,38,201,64.3114792437785,174.688520756222
"2000","doesnt",-16.4238548013055,341,60,281,91.7582193394496,249.24178066055
"2010","sign",-16.4315725228899,167,9,158,25.7117749044022,141.288225095598
"1990","lady",-16.4323502752545,530,76,454,112.436688842652,417.563311157348
"1970","crazy",-16.4837483167819,861,79,782,117.826034876907,743.173965123093
"2010","candy",-16.4873253314565,146,7,139,22.4785577008546,123.521442299145
"1970","huh",-16.5122179854519,618,52,566,84.5719971590345,533.428002840966
"2010","dont want",-16.5322044455797,818,86,732,125.941508214377,692.058491785623
"1990","guitar",-16.6371914852795,96,6,90,20.365890809235,75.634109190765
"2000","sound",-16.6487226290201,405,74,331,108.979703321047,296.020296678953
"1970","touch",-16.6523317071831,942,88,854,128.910714116198,813.089285883802
"1990","let get",-16.6676998939171,104,7,97,22.0630483766713,81.9369516233287
"2000","may",-16.6753494583464,476,90,386,128.084787113132,347.915212886868
"1980","dont even",-16.7266365589412,181,12,169,30.4506667034876,150.549333296512
"2000","tender",-16.7317440094497,92,9,83,24.7558832235465,67.2441167764535
"1960","always",-16.761768870166,1781,68,1713,106.367149912708,1674.63285008729
"2000","whenever",-16.7786036024327,182,26,156,48.9735950726681,133.026404927332
"2010","alone",-16.7793105945311,975,106,869,150.113655878995,824.886344121005
"1970","mouth",-16.7882536021711,179,8,171,24.4957726399145,154.504227360085
"1990","think im",-16.8051215760428,235,26,209,49.8540035434399,185.14599645656
"1990","alive",-16.8241571727208,417,56,361,88.4643382026147,328.535661797385
"1990","burning",-16.8714238325532,216,23,193,45.8232543207788,170.176745679221
"2000","yeah yeah yeah",-16.8946416868562,913,192,721,245.675232424978,667.324767575022
"1960","night",-16.9065270875982,3598,159,3439,214.88433766756,3383.11566233244
"1970","okay",-16.9132613992701,226,12,214,30.9276235565401,195.07237644346
"1980","stone",-16.9242301045206,154,9,145,25.908302057111,128.091697942889
"1970","jeans",-16.9369253397157,155,6,149,21.2114232356802,133.78857676432
"2010","street",-16.9452440087917,339,27,312,52.1933634286967,286.806636571303
"1990","yes im",-16.9856856045894,97,6,91,20.5780355051646,76.4219644948354
"1990","dust",-17.0059110325412,105,7,98,22.2751930726008,82.7248069273992
"2010","feel way",-17.0248313064481,180,10,170,27.7132903161221,152.286709683878
"1970","hard",-17.0538994176779,1241,122,1119,169.828233777285,1071.17176622272
"1990","talking",-17.0663462538091,323,40,283,68.5227367852387,254.477263214761
"1960","feeling",-17.0927920663853,922,28,894,55.0648580682298,866.93514193177
"2010","walk away",-17.1053635146051,170,9,161,26.1736630763376,143.826336923662
"2000","time love",-17.1059484282193,87,8,79,23.4104547874842,63.5895452125158
"1980","lets get",-17.1119714497872,269,22,247,45.2554107361225,223.744589263878
"1980","blow",-17.1230992046277,318,28,290,53.4989613906578,264.501038609342
"2000","love let",-17.1290876600375,110,12,98,29.5994255933708,80.4005744066291
"1990","fine",-17.1690641088307,608,89,519,128.983975125155,479.016024874845
"2000","comfort",-17.1946474056027,75,6,69,20.1814265409347,54.8185734590653
"2000","heartache",-17.1946474056027,75,6,69,20.1814265409347,54.8185734590653
"2000","know youve",-17.1946474056027,75,6,69,20.1814265409347,54.8185734590653
"2000","nobodys",-17.1946474056027,75,6,69,20.1814265409347,54.8185734590653
"1980","brother",-17.1996714734603,201,14,187,33.8153812563592,167.184618743641
"1970","yeah",-17.2065930835613,6260,746,5514,856.667802937793,5403.33219706221
"1990","stuff",-17.2312855710555,164,15,149,34.7917301324432,129.208269867557
"1960","take",-17.2394958401324,4302,195,4107,256.929522136144,4045.07047786386
"1970","trust",-17.2502270446243,239,13,226,32.7066461505004,206.2933538495
"2010","strong",-17.2889611804772,470,42,428,72.3624802698745,397.637519730126
"2010","promise",-17.3204954335835,385,32,353,59.2756487317057,325.724351268294
"2010","cant go",-17.3230216557661,231,15,216,35.5653892390234,195.434610760977
"1970","like im",-17.3398776602807,283,17,266,38.7279533915967,244.272046608403
"2000","proud",-17.3811294435751,143,18,125,38.4792532713821,104.520746728618
"2010","fade",-17.4372163562584,150,7,143,23.0944085967684,126.905591403232
"2010","say say",-17.4372163562584,150,7,143,23.0944085967684,126.905591403232
"2010","tough",-17.4372163562584,150,7,143,23.0944085967684,126.905591403232
"2000","future",-17.4783015342698,138,17,121,37.1338248353198,100.86617516468
"2010","livin",-17.4793717647264,351,28,323,54.0409161164382,296.959083883562
"1970","work",-17.4860837550726,844,76,768,115.499620715575,728.500379284425
"2000","tears",-17.509512988463,502,95,407,135.081014980656,366.918985019344
"2010","keep",-17.5185089743251,2547,318,2229,392.143057973128,2154.85694202687
"2000","dry",-17.5411006745282,88,8,80,23.6795404746967,64.3204595253033
"1990","music",-17.5540740055304,700,105,595,148.501287150672,551.498712849328
"2000","can give",-17.5610151005978,82,7,75,22.0650263514219,59.9349736485781
"2000","woah",-17.5610151005978,82,7,75,22.0650263514219,59.9349736485781
"2000","will love",-17.5784320099188,94,9,85,25.2940545979715,68.7059454020285
"1970","ill make",-17.5853464036218,158,6,152,21.6219669112095,136.378033088791
"1970","scared",-17.6030492225502,195,9,186,26.6853389094041,168.314661090596
"1990","hands",-17.6267429599562,1018,163,855,215.963300456263,802.036699543737
"2000","upside",-17.6559510555593,76,6,70,20.4505122281471,55.5494877718529
"2000","really love",-17.6605416762638,100,10,90,26.9085687212462,73.0914312787538
"1990","pick",-17.6611582398969,186,18,168,39.4589134428929,146.541086557107
"1970","whats",-17.8039459022375,847,76,771,115.910164391104,731.089835608896
"2010","love will",-17.8061956643764,262,18,244,40.3382336823556,221.661766317644
"1970","dont give",-17.8111317384961,275,16,259,37.6331702568519,237.366829743148
"2010","chorus",-17.871170841539,224,14,210,34.4876501711742,189.512349828826
"1990","old",-17.8865189334567,730,110,620,154.865628028558,575.134371971442
"1980","six",-17.89748466137,128,6,122,21.534173138378,106.465826861622
"1990","looking",-17.917630998824,769,117,652,163.13927116981,605.86072883019
"1960","just wanna",-17.919719015126,377,6,371,22.5156740691135,354.484325930886
"2010","cried",-17.9364778213079,163,8,155,25.0959240084884,137.904075991512
"2000","flowers",-17.9785258100296,89,8,81,23.9486261619091,65.0513738380909
"2010","tight",-17.9859291414417,354,28,326,54.5028042883735,299.497195711626
"1980","hell",-18.0007764402966,402,38,364,67.6307625127183,334.369237487282
"2000","cant hear",-18.0105995413198,83,7,76,22.3341120386344,60.6658879613656
"2000","needs",-18.0164217198362,235,36,199,63.2351364949286,171.764863505071
"2010","dreams",-18.0361290214688,640,62,578,98.536143346212,541.463856653788
"1980","come back",-18.0890216863777,240,18,222,40.3765746344587,199.623425365541
"2000","kisses",-18.0960456275755,118,13,105,31.7521110910705,86.2478889089295
"2000","ooh ooh ooh ooh",-18.1135765721078,129,15,114,34.7120536504076,94.2879463495924
"1990","good good",-18.1546571430661,181,17,164,38.3981899632452,142.601810036755
"2000","loves",-18.1758952730902,514,97,417,138.310043227206,375.689956772794
"1980","rather",-18.1861189791859,178,11,167,29.9459595205569,148.054040479443
"1990","blue",-18.1877776616409,471,64,407,99.9201517828094,371.079848217191
"2000","love baby",-18.2412731148145,421,76,345,113.285074316447,307.714925683553
"1990","side",-18.2648883117368,799,122,677,169.503612047696,629.496387952304
"1990","number",-18.2781160180417,241,26,215,51.1268717190171,189.873128280983
"1990","band",-18.2788868218387,195,19,176,41.3682157062587,153.631784293741
"2000","apart",-18.3178519228922,279,45,234,75.074906732277,203.925093267723
"1960","touch",-18.3358478922092,942,28,914,56.2593235360873,885.740676463913
"1970","im just",-18.3568907942949,462,34,428,63.2237260315112,398.776273968489
"2000","land",-18.3666315954584,151,19,132,40.6319387690818,110.368061230918
"2010","give",-18.4026294424784,3148,400,2748,484.67465508418,2663.32534491582
"1960","throw",-18.4100882925939,441,8,433,26.3379635662574,414.662036433743
"2000","diamond",-18.4636276685528,146,18,128,39.2865103330195,106.71348966698
"2010","way love",-18.4897449800507,227,14,213,34.9495383431096,192.05046165689
"2010","dont know",-18.5015907643182,1641,192,1449,252.652830048647,1388.34716995135
"2000","town",-18.5338952048005,467,86,381,125.66301592822,341.33698407178
"2000","now ive",-18.5852652479949,78,6,72,20.9886836025721,57.0113163974279
"1970","beat",-18.7047495920908,765,66,699,104.68863725997,660.31136274003
"1990","told",-18.7251753550355,780,118,662,165.472862825035,614.527137174965
"2000","freedom",-18.730022353159,114,12,102,30.6757683422207,83.3242316577793
"2000","love come",-18.730022353159,114,12,102,30.6757683422207,83.3242316577793
"2000","count",-18.7692471333224,178,24,154,47.8972523238183,130.102747676182
"1980","handle",-18.7771518531236,171,10,161,28.7683094270518,142.231690572948
"1980","burn",-18.7825518038409,335,29,306,56.3589687605986,278.641031239401
"2010","door",-18.8286198560607,597,56,541,91.9157462151384,505.084253784862
"2000","beating",-18.8652412634655,97,9,88,26.1013116596088,70.8986883403912
"1980","ladies",-18.917157301878,303,25,278,50.9754254760041,252.024574523996
"2000","light",-19.0749033095756,1015,213,802,273.121972520649,741.878027479351
"1990","hate",-19.1080395681699,369,46,323,78.2813927979972,290.718607202003
"1970","games",-19.1155292982438,165,6,159,22.5799021541112,142.420097845889
"1980","wish",-19.1487454199368,839,96,743,141.149775492962,697.850224507038
"1990","like im",-19.1899753344884,283,32,251,60.0369489480575,222.963051051943
"1960","top",-19.2045066149789,421,7,414,25.1434980983999,395.8565019016
"2000","jam",-19.2710724919223,164,21,143,44.1300527028438,119.869947297156
"1990","momma",-19.2738820665551,164,14,150,34.7917301324432,129.208269867557
"2000","take hand",-19.2857307644443,121,13,108,32.5593681527079,88.4406318472921
"2010","days",-19.2925098823269,682,66,616,105.002577753307,576.997422246693
"1990","burnin",-19.317344245858,157,13,144,33.3067172609365,123.693282739064
"2000","go way",-19.3724527178505,86,7,79,23.1413691002718,62.8586308997282
"2000","yes",-19.3876434458334,1017,213,804,273.660143895074,743.339856104926
"1980","ride",-19.392795637422,898,104,794,151.075683423933,746.924316576067
"1990","lose",-19.4281854099382,684,100,584,145.1069720158,538.8930279842
"1980","momma",-19.4425683605841,164,9,155,27.5906593335468,136.409340666453
"2010","wonder",-19.4665109855464,493,43,450,75.903622921379,417.096377078621
"1970","lips",-19.4700189495148,338,21,317,46.2545874429671,291.745412557033
"2000","giving",-19.4705161041058,235,35,200,63.2351364949286,171.764863505071
"2010","chance",-19.4779279943802,510,45,465,78.5209892290127,431.479010770987
"1980","name",-19.5245578664506,977,115,862,164.366305907776,812.633694092224
"2000","make feel",-19.5509518851247,404,71,333,108.710617633835,295.289382366165
"1960","gotta",-19.6041888426392,1926,72,1854,115.027024554675,1810.97297544532
"2010","shorty",-19.6122705230826,202,11,191,31.1004702436482,170.899529756352
"1970","standing",-19.6243542711341,307,18,289,42.0123027958311,264.987697204169
"1980","playin",-19.7073220092992,212,14,198,35.6659742604385,176.334025739561
"2000","golden",-19.7337382588442,99,9,90,26.6394830340338,72.3605169659662
"2000","baby love",-19.8042559874428,270,42,228,72.6531355473648,197.346864452635
"1990","can can",-19.820295325929,105,6,99,22.2751930726008,82.7248069273992
"1980","love love",-19.858802717271,1001,118,883,168.403963371221,832.596036628779
"1970","anything",-19.8680861145158,636,51,585,87.0352592122103,548.96474078779
"1960","floor",-19.8773410652631,648,15,633,38.7006811585823,609.299318841418
"2010","boy",-19.9591280011615,1613,186,1427,248.34187377725,1364.65812622275
"2010","go head",-19.968087441439,149,6,143,22.94044587279,126.05955412721
"2010","hold tight",-19.968087441439,149,6,143,22.94044587279,126.05955412721
"1980","diamond",-19.9761348852689,146,7,139,24.5624162359624,121.437583764038
"2000","money money",-19.9951293184024,81,6,75,21.7959406642094,59.2040593357906
"1990","chance",-20.0173156999358,510,69,441,108.193794924061,401.806205075939
"2010","lookin",-20.0221684049034,471,40,431,72.5164429938529,398.483557006147
"2000","knees",-20.0276377861438,197,27,170,53.0098803808551,143.990119619145
"2000","ooh ooh ooh",-20.0331434808053,227,33,194,61.0824509972289,165.917549002771
"1970","yeah yeah",-20.0346994484891,1719,174,1545,235.241526078285,1483.75847392171
"2000","children",-20.0368460898936,134,15,119,36.0574820864699,97.9425179135301
"2010","since",-20.0770368560481,497,43,454,76.5194738172928,420.480526182707
"1980","go get",-20.100224784925,136,6,130,22.8800589595266,113.119941040473
"1990","hey baby",-20.1154726319982,122,8,114,25.8816529034029,96.1183470965971
"1990","dollar",-20.1348271979265,145,11,134,30.7609809097821,114.239019090218
"1960","one",-20.1843396480982,5413,248,5165,323.282078875627,5089.71792112437
"1980","im ready",-20.2466252410279,147,7,140,24.730651963606,122.269348036394
"2000","theres one",-20.2482863278551,129,14,115,34.7120536504076,94.2879463495924
"2000","true love",-20.262979404494,112,11,101,30.1375969677958,81.8624030322042
"2000","dont know dont",-20.290746873523,88,7,81,23.6795404746967,64.3204595253033
"2010","men",-20.3247307077716,184,9,175,28.329141212036,155.670858787964
"2010","love baby",-20.3539244134632,421,34,387,64.8183067949301,356.18169320507
"1970","move",-20.364699099332,1129,105,1024,154.501269890858,974.498730109142
"1990","love love love",-20.3671592979441,381,47,334,80.8271291491515,300.172870850848
"1980","aint got",-20.3827707600604,268,20,248,45.0871750084789,222.912824991521
"1990","lights",-20.3946149937986,465,61,404,98.6472836072322,366.352716392768
"2010","gimme",-20.4193630219222,386,30,356,59.4296114556841,326.570388544316
"2010","watching",-20.4241952474732,256,16,240,39.4144573384848,216.585542661515
"1990","wiggle",-20.4587308866992,115,7,108,24.3966400318961,90.6033599681039
"1990","done",-20.4674474529717,605,85,520,128.347541037367,476.652458962633
"2000","break break",-20.4691046076196,82,6,76,22.0650263514219,59.9349736485781
"2000","jungle",-20.4691046076196,82,6,76,22.0650263514219,59.9349736485781
"1980","big",-20.5097137384618,964,112,852,162.179241448409,801.820758551591
"1960","just",-20.5176441018131,9577,470,9107,571.969789283554,9005.03021071645
"1990","wine",-20.54245099861,161,13,148,34.1552960446546,126.844703955345
"2010","lives",-20.5590933268084,185,9,176,28.4831039360144,156.516896063986
"2010","things",-20.5862228141368,1560,178,1382,240.181849406392,1319.81815059361
"1960","done",-20.6149471908156,605,13,592,36.1325804026887,568.867419597311
"2000","dear",-20.6229587975559,141,16,125,37.9410818969572,103.058918103043
"2000","will come",-20.6258241030501,107,10,97,28.7921685317335,78.2078314682665
"2010","ill never",-20.6323024362092,286,19,267,44.0333390578385,241.966660942162
"1980","probably",-20.6579118652937,138,6,132,23.2165304148138,114.783469585186
"2010","baby baby baby",-20.6803802415013,267,17,250,41.1080473022478,225.891952697752
"1990","well",-20.6826729460603,2420,424,1996,513.390164149467,1906.60983585053
"1960","step",-20.7037532355737,552,11,541,32.9672469128664,519.032753087134
"2000","love feel",-20.7528639943128,89,7,82,23.9486261619091,65.0513738380909
"2000","sweet sweet",-20.7528639943128,89,7,82,23.9486261619091,65.0513738380909
"2000","together",-20.7829473909368,954,196,758,256.707745600689,697.292254399311
"2000","right right",-20.8195404114869,136,15,121,36.5956534608949,99.4043465391051
"1990","meaning",-20.851491706406,162,13,149,34.3674407405841,127.632559259416
"1980","thank",-20.8693155097159,244,17,227,41.049517545033,202.950482454967
"2010","lovers",-20.8710137995429,218,12,206,33.5638738273035,184.436126172697
"2010","sing",-20.8856885280475,620,57,563,95.4568888666429,524.543111133357
"1990","catch",-20.981292852282,347,41,306,73.6142094875475,273.385790512453
"1980","know like",-20.9920346657719,160,8,152,26.9177164229725,133.082283577028
"1990","better",-21.0055233828048,1655,277,1378,351.099471763375,1303.90052823663
"1970","cuz",-21.0207655781736,293,16,277,40.0964323100277,252.903567689972
"2010","saw",-21.0211111626221,425,34,391,65.4341576908439,359.565842309156
"2000","desire",-21.0515340141913,102,9,93,27.4467400956712,74.5532599043289
"2000","along",-21.0521649743291,401,69,332,107.903360572197,293.096639427803
"1990","green",-21.0843777919178,170,14,156,36.0645983080204,133.93540169198
"2010","hang",-21.0851698176544,198,10,188,30.4846193477343,167.515380652266
"2010","give love",-21.0924261042247,219,12,207,33.7178365512819,185.282163448718
"1970","now",-21.1081770522337,6525,768,5757,892.932494276214,5632.06750572379
"1970","bass",-21.1156106020605,174,6,168,23.811533180699,150.188466819301
"1990","shake shake shake",-21.1851681757998,272,29,243,57.7033572928326,214.296642707167
"2000","night oh",-21.2168995806276,90,7,83,24.2177118491216,65.7822881508784
"2000","another",-21.2268586457106,1121,235,886,301.64505536517,819.35494463483
"1970","need",-21.2302187669304,3735,417,3318,511.126876033971,3223.87312396603
"1980","yea",-21.2407198951843,272,20,252,45.7601179190532,226.239882080947
"1970","missing",-21.3143769528085,188,7,181,25.7274036665024,162.272596333498
"2010","comin",-21.3299599937451,355,26,329,54.656767012352,300.343232987648
"1960","cause im",-21.3987706947592,475,8,467,28.3685548616151,446.631445138385
"1990","niggas",-21.4214902231817,392,48,344,83.1607208043764,308.839279195624
"1970","waiting",-21.4413285803105,686,55,631,93.8776538043652,592.122346195635
"1970","meant",-21.5566665693288,318,18,300,43.5176296061051,274.482370393895
"1970","think",-21.5571656825842,2640,282,2358,361.278434465779,2278.72156553422
"1980","less",-21.6090964360712,152,7,145,25.5718306018238,126.428169398176
"1980","sit",-21.6152292843869,265,19,246,44.5824678255482,220.417532174452
"1990","go home",-21.6302733820471,110,6,104,23.3359165522485,86.6640834477515
"1970","im one",-21.6481432836843,239,11,228,32.7066461505004,206.2933538495
"2000","word",-21.6498323899942,343,56,287,92.2963907138746,250.703609286125
"1990","ass",-21.6524572852637,629,88,541,133.439013739675,495.560986260325
"1960","wanted",-21.6525472283511,448,7,441,26.7560264800075,421.243973519992
"1980","bed",-21.6541047868314,350,29,321,58.8825046752523,291.117495324748
"2000","im falling",-21.682809455994,91,7,84,24.4867975363341,66.5132024636659
"2010","hurt",-21.7558614578687,542,47,495,83.4477963963233,458.552203603677
"2010","lay",-21.8365573073663,465,38,427,71.5926666499822,393.407333350018
"1980","dont give",-21.8903253974337,275,20,255,46.2648251019839,228.735174898016
"1960","yall",-21.8995722400614,621,13,608,37.0881527769747,583.911847223025
"2000","glory",-21.9023947935022,85,6,79,22.8722834130593,62.1277165869407
"1960","til",-21.9098836313109,594,12,582,35.4756243953671,558.524375604633
"2000","edge",-21.9263758431602,110,10,100,29.5994255933708,80.4005744066291
"2000","hour",-21.9263758431602,110,10,100,29.5994255933708,80.4005744066291
"2000","take take",-21.9263758431602,110,10,100,29.5994255933708,80.4005744066291
"1990","gon",-21.9479117472584,705,101,604,149.56201063032,555.43798936968
"2000","baby baby",-22.0358993932924,786,155,631,211.501350148995,574.498649851005
"2000","burn",-22.0364726247984,335,54,281,90.1437052161749,244.856294783825
"1970","promise",-22.0382537882799,385,24,361,52.6864383595927,332.313561640407
"1970","dont know",-22.0469612064509,1641,162,1479,224.567390514524,1416.43260948548
"2010","far away",-22.2596237189962,158,6,152,24.3261103885961,133.673889611404
"2000","sign",-22.2725138290696,167,20,147,44.9373097644812,122.062690235519
"2010","get get get",-22.2925517429772,265,16,249,40.8001218542909,224.199878145709
"2000","line",-22.3283103536098,461,81,380,124.048501804945,336.951498195055
"2010","come",-22.332722026947,4867,633,4234,749.336577603147,4117.66342239685
"1980","gotta",-22.3512136089164,1926,249,1677,324.022011441531,1601.97798855847
"2010","needs",-22.3525982361883,235,13,222,36.1812401349372,198.818759865063
"2000","love thats",-22.3635769210137,111,10,101,29.8685112805833,81.1314887194167
"1980","four",-22.3806714594225,195,11,184,32.8059668904977,162.194033109502
"2000","prayer",-22.3837923898282,86,6,80,23.1413691002718,62.8586308997282
"2000","dreams",-22.4283153079105,640,121,519,172.214839815976,467.785160184024
"1970","ill",-22.4579277854614,4216,474,3742,576.950712010501,3639.0492879895
"2010","feelings",-22.5229057353432,246,14,232,37.8748300987003,208.1251699013
"1960","even",-22.6264393473017,1219,37,1182,72.8026702659133,1146.19732973409
"2000","youre",-22.7176698861892,6592,1604,4988,1773.81285010455,4818.18714989545
"1960","turn",-22.7241891094587,1733,60,1673,103.500432789851,1629.49956721015
"2000","everybodys",-22.7603717119696,152,17,135,40.9010244562943,111.098975543706
"2010","takes",-22.8020976405721,363,26,337,55.8884688041796,307.11153119582
"1980","die",-22.8104651318448,516,49,467,86.8096354640862,429.190364535914
"1970","fresh",-22.8532807193666,195,7,188,26.6853389094041,168.314661090596
"2000","band",-22.8577779071061,195,25,170,52.4717090064301,142.52829099357
"2010","many",-22.923591706892,541,46,495,83.2938336723449,457.706166327655
"1990","drink",-22.958928139984,292,31,261,61.9462512114232,230.053748788577
"2000","lives",-23.0283908100499,185,23,162,49.7808521343055,135.219147865694
"1970","act",-23.0462258008246,304,16,288,41.6017591203018,262.398240879698
"1980","right now",-23.0822313823352,502,47,455,84.4543352770761,417.545664722924
"2000","fire",-23.1004620357402,674,128,546,181.3637531812,492.6362468188
"2010","little",-23.2108018300782,2553,308,2245,393.066834316999,2159.933165683
"2000","break heart",-23.2432979378212,113,10,103,30.4066826550082,82.5933173449918
"1990","gone",-23.2559479472286,1359,218,1141,288.304641768233,1070.69535823177
"2000","needed",-23.2657663438558,227,31,196,61.0824509972289,165.917549002771
"1960","hands",-23.2877873229573,1018,28,990,60.7982923139457,957.201707686054
"2000","hear",-23.3429792813164,1398,298,1100,376.181790723022,1021.81820927698
"2000","anybody",-23.3757513406585,131,13,118,35.2502250248326,95.7497749751674
"2000","want back",-23.3757513406585,131,13,118,35.2502250248326,95.7497749751674
"2010","pump",-23.4184761250252,208,10,198,32.0242465875189,175.975753412481
"2010","youll",-23.4618650686416,1377,150,1227,212.006670918334,1164.99332908167
"1980","block",-23.4843968264632,148,6,142,24.8988876912495,123.10111230875
"1980","rolling",-23.4843968264632,148,6,142,24.8988876912495,123.10111230875
"1970","dont think",-23.5816308650251,284,14,270,38.8648012834398,245.13519871656
"2010","jump",-23.5941538743813,404,30,374,62.2009404872963,341.799059512704
"1980","body",-23.6221882380568,1089,126,963,183.208707403856,905.791292596144
"1980","smoke",-23.6496276205087,200,11,189,33.6471455287156,166.352854471284
"2000","lovers",-23.6692753647606,218,29,189,58.6606798123168,159.339320187683
"2010","around",-23.670957157997,2228,263,1965,343.028949024001,1884.971050976
"1980","sick",-23.7703229940702,149,6,143,25.0671234188931,123.932876581107
"2010","easy",-23.7721054437124,503,41,462,77.4432501611635,425.556749838836
"2010","tired",-23.7776804253752,282,17,265,43.4174881619247,238.582511838075
"2000","theyre",-23.8932732731089,472,82,390,127.008444364282,344.991555635718
"2000","whoa oh oh",-24.0390289395999,96,7,89,25.8322259723964,70.1677740276036
"2010","say",-24.1267851375485,4757,613,4144,732.400677965517,4024.59932203448
"1980","da da da",-24.1881213346533,303,22,281,50.9754254760041,252.024574523996
"2010","believe",-24.2032332565951,1245,132,1113,191.683591353178,1053.31640864682
"1990","dont tell",-24.2078224072948,117,6,111,24.8209294237552,92.1790705762448
"2000","made",-24.2824076488711,1068,218,850,287.38351394291,780.61648605709
"1990","midnight",-24.2879154041677,134,8,126,28.4273892545572,105.572610745443
"1970","girl know",-24.2918154741673,188,6,182,25.7274036665024,162.272596333498
"1970","really wanna",-24.2918154741673,188,6,182,25.7274036665024,162.272596333498
"1980","cup",-24.3438573145435,151,6,145,25.4035948741803,125.59640512582
"2000","care",-24.3476555444948,702,133,569,188.898152423149,513.101847576851
"1970","phone",-24.3584014390392,311,16,295,42.5596943632035,268.440305636796
"1980","bye",-24.4161184110563,183,9,174,30.7871381587748,152.212861841225
"1970","chick",-24.5214483463366,189,6,183,25.8642515583455,163.135748441654
"1990","worry",-24.6323399522117,292,30,262,61.9462512114232,230.053748788577
"1980","roof",-24.6610347758269,163,7,156,27.4224236059032,135.577576394097
"2000","love ill",-24.8161396676172,91,6,85,24.4867975363341,66.5132024636659
"2000","thunder",-24.8161396676172,91,6,85,24.4867975363341,66.5132024636659
"1990","lost",-24.8278207412635,635,86,549,134.711881915253,500.288118084747
"1980","jam",-24.9419329396078,164,7,157,27.5906593335468,136.409340666453
"1990","stuck",-24.9622884788084,175,13,162,37.125321787668,137.874678212332
"1990","hips",-24.9738378587227,152,10,142,32.2459937812888,119.754006218711
"2010","cant",-24.9911935633281,5338,693,4645,821.853020597,4516.146979403
"2000","searching",-25.0231155858539,117,10,107,31.4830254038581,85.5169745961419
"1990","ima",-25.0832673658271,371,42,329,78.7056821898562,292.294317810144
"2000","moon",-25.1623006964406,268,38,230,72.1149641729399,195.88503582706
"1960","lie",-25.2048652625529,517,8,509,30.8769323441158,486.123067655884
"1970","ever",-25.2385541304748,2130,215,1915,291.486009625799,1838.5139903742
"1970","yeah yeah yeah",-25.3009206198114,913,76,837,124.942125252748,788.057874747252
"1990","drunk",-25.3040526061937,145,9,136,30.7609809097821,114.239019090218
"2000","im coming",-25.3074111194539,92,6,86,24.7558832235465,67.2441167764535
"2010","needed",-25.3365278851295,227,11,216,34.9495383431096,192.05046165689
"2010","soul",-25.34467227827,642,56,586,98.8440687941689,543.155931205831
"1990","good",-25.359663224444,2885,504,2381,612.037447756699,2272.9625522433
"1960","talk",-25.3741766670563,975,25,950,58.2301915580521,916.769808441948
"1990","throw",-25.4351816934808,441,53,388,93.5558109049234,347.444189095077
"1980","jeans",-25.4974452958657,155,6,149,26.0765377847546,128.923462215245
"2000","near",-25.5364277896207,213,27,186,57.3152513762545,155.684748623746
"1960","boys",-25.6160368682887,581,10,571,34.6992218412598,546.30077815874
"2010","gone",-25.6438598392724,1359,145,1214,209.235341886722,1149.76465811328
"1980","ring",-25.669618538525,274,18,256,46.0965893743403,227.90341062566
"1970","let go",-25.6842327285182,804,64,740,110.025705041851,693.974294958149
"2010","band",-25.7023308698462,195,8,187,30.022731175799,164.977268824201
"1990","take home",-25.7108324447481,162,11,151,34.3674407405841,127.632559259416
"1990","town",-25.7621544812055,467,57,410,99.0715729990913,367.928427000909
"2000","runs",-25.8001993508098,93,6,87,25.024968910759,67.975031089241
"2000","surely",-25.8001993508098,93,6,87,25.024968910759,67.975031089241
"1960","watch",-25.8913825854994,697,14,683,41.6271215548331,655.372878445167
"1980","cant help",-25.9744815730413,199,10,189,33.478909801072,165.521090198928
"1990","jeans",-26.0002758758008,155,10,145,32.8824278690774,122.117572130923
"1990","pussy",-26.0033088994394,147,9,138,31.1852703016411,115.814729698359
"1990","im just",-26.0046611971797,462,56,406,98.0108495194436,363.989150480556
"1960","lets",-26.0724900434877,1662,54,1608,99.2600803789565,1562.73991962104
"2000","city",-26.1343911994214,545,96,449,146.651699530792,398.348300469208
"2010","rhythm",-26.1708732512394,252,13,239,38.798606442571,213.201393557429
"1980","im one",-26.1888965431314,239,14,225,40.2083389068151,198.791661093185
"1970","forever",-26.2213651849507,874,71,803,119.605057470868,754.394942529132
"2000","river",-26.2507898707787,215,27,188,57.8534227506794,157.146577249321
"1970","side",-26.2603810010696,799,63,736,109.341465582635,689.658534417365
"1960","call",-26.2655581974566,1553,49,1504,92.7502435791332,1460.24975642087
"2000","coming",-26.4404846727463,614,111,503,165.218611948452,448.781388051548
"2000","gonna get",-26.4564704301473,272,38,234,73.1913069217897,198.80869307821
"2000","build",-26.4839265833389,114,9,105,30.6757683422207,83.3242316577793
"1980","clothes",-26.4915533450964,211,11,200,35.4977385327949,175.502261467205
"2000","imma",-26.5026185749152,302,44,258,81.2638775381636,220.736122461836
"2010","just cant",-26.5691469415375,493,38,455,75.903622921379,417.096377078621
"2010","whos",-26.5841160024143,457,34,423,70.3609648581545,386.639035141846
"2000","mercy",-26.6601724245365,108,8,100,29.0612542189459,78.9387457810541
"2000","deep",-26.6662115913709,606,109,497,163.065926450752,442.934073549248
"1980","air",-26.6978229611129,417,34,383,70.154298427372,346.845701572628
"2000","happy",-26.7044088765921,520,90,430,139.92455735048,380.07544264952
"1990","born",-26.7374668556562,300,30,270,63.6434087788595,236.356591221141
"2000","shout",-26.7705105112548,139,13,126,37.4029105225323,101.597089477468
"2000","da da da",-26.8151651620086,303,44,259,81.5329632253761,221.467036774624
"2000","never never",-26.8285107727834,121,10,111,32.5593681527079,88.4406318472921
"2000","fall",-27.0882286379359,925,181,744,248.904260671528,676.095739328472
"1960","boy",-27.1378353893368,1613,51,1562,96.3336399827057,1516.66636001729
"1970","wait",-27.1486221275008,758,58,700,103.730702017068,654.269297982932
"1990","higher",-27.1510962303552,233,20,213,49.4297141515809,183.570285848419
"1990","stand",-27.1584823267319,804,113,691,170.564335527343,633.435664472657
"1970","saying",-27.1588055222817,314,15,299,42.9702380387327,271.029761961267
"1980","everyday",-27.183759177141,243,14,229,40.8812818173894,202.118718182611
"1980","wanna make",-27.2432875466564,161,6,155,27.085952150616,133.914047849384
"2000","da da da da",-27.2522594321961,191,22,169,51.3953662575803,139.60463374242
"2000","takes",-27.2765484529422,363,56,307,97.6781044581238,265.321895541876
"1990","like",-27.2847097368817,10949,2102,8847,2322.77227573244,8626.22772426756
"2000","hmm",-27.2873346006728,96,6,90,25.8322259723964,70.1677740276036
"1990","already",-27.4283479364964,241,21,220,51.1268717190171,189.873128280983
"2010","theres",-27.4499421969055,1942,219,1723,298.995609966162,1643.00439003384
"2000","good time",-27.4514523124432,175,19,156,47.0899952621809,127.910004737819
"1990","uh uh",-27.4870947641861,227,19,208,48.1568459760037,178.843154023996
"1980","thinkin",-27.5594086268399,362,27,335,60.9013334069752,301.098666593025
"1960","move",-27.5680839197845,1129,30,1099,67.4275756605547,1061.57242433945
"2000","reach",-27.5955364794067,224,28,196,60.2751939355916,163.724806064408
"2000","good good",-27.6284001377003,181,20,161,48.7045093854557,132.295490614544
"2010","can feel",-27.62882685292,300,17,283,46.1888171935369,253.811182806463
"2000","go let",-27.634518027681,141,13,128,37.9410818969572,103.058918103043
"2000","isnt",-27.7110971562558,240,31,209,64.5805649309909,175.419435069009
"1990","wee",-27.766766528678,152,9,143,32.2459937812888,119.754006218711
"2010","morning",-27.7962990161718,509,39,470,78.3670265050343,430.632973494966
"2000","sad",-27.840412166152,326,48,278,87.7219340312627,238.278065968737
"2000","luck",-27.8778978719923,117,9,108,31.4830254038581,85.5169745961419
"2000","long long",-27.8925754217056,104,7,97,27.9849114700961,76.0150885299039
"1970","hands",-27.922163281755,1018,85,933,139.311153896274,878.688846103726
"2010","free",-27.9409478310512,710,62,648,109.313534024704,600.686465975296
"2010","someone",-28.1642176592624,862,80,782,132.715868069429,729.284131930571
"2000","whoa oh",-28.256866682022,160,16,144,43.053709953994,116.946290046006
"1980","doo",-28.2574566038571,285,18,267,47.9471823784197,237.05281762158
"1970","perfect",-28.2639820559925,219,7,212,29.9696883136384,189.030311686362
"1970","baby dont",-28.3021756205507,366,19,347,50.0863284145738,315.913671585426
"2000","heat",-28.3064008856804,210,25,185,56.5079943146171,153.492005685383
"1990","second",-28.3155105936513,244,21,223,51.7633058068057,192.236694193194
"2010","huh",-28.3160648009674,618,51,567,95.148963418686,522.851036581314
"1980","clean",-28.3532866923491,176,7,169,29.6094880652697,146.39051193473
"1990","just like",-28.3605456904771,618,80,538,131.105422084451,486.89457791555
"1970","low",-28.4514081937238,660,47,613,90.3196086164446,569.680391383555
"1970","worth",-28.4522898504842,272,11,261,37.2226265813226,234.777373418677
"2010","bit",-28.5181050176425,540,42,498,83.1398709483664,456.860129051634
"1990","young",-28.5328694589569,589,75,514,124.953225902494,464.046774097506
"1980","sing",-28.5722304404742,620,58,562,104.306151139018,515.693848860982
"1970","open",-28.5982237323106,519,33,486,71.0240558665678,447.975944133432
"2010","youve",-28.6075913812917,1117,111,1006,171.976362683936,945.023637316064
"1970","one",-28.6447407790395,5413,609,4804,740.757638546689,4672.24236145331
"2000","get get get get",-28.6737551464719,161,16,145,43.3227956412064,117.677204358794
"1970","bout",-28.6882168542915,884,70,814,120.973536389299,763.026463610701
"2000","devil",-28.7869763745382,99,6,93,26.6394830340338,72.3605169659662
"2010","sunshine",-28.8246421521954,183,6,177,28.1751784880575,154.824821511943
"2000","ooh ooh",-28.8996753581574,426,68,358,114.630502752509,311.369497247491
"1980","gimme",-29.0018575852064,386,29,357,64.9389908704211,321.061009129579
"2010","move",-29.1079075769284,1129,112,1017,173.823915371677,955.176084628323
"1990","dancing",-29.1745849160345,362,38,324,76.7963799264904,285.20362007351
"1990","bring",-29.2098320768471,896,127,769,190.08164755286,705.91835244714
"2010","let know",-29.2365297597582,297,16,281,45.7269290216015,251.273070978398
"2000","heaven",-29.2508205538808,432,69,363,116.245016875784,315.754983124216
"2010","find",-29.254645438179,1686,183,1503,259.581152627677,1426.41884737232
"2000","bass",-29.3145503143941,174,18,156,46.8209095749684,127.179090425032
"1970","pop",-29.3207111975662,394,21,373,53.9180693861806,340.081930613819
"2010","makin",-29.3309152294424,318,18,300,48.9601462251491,269.039853774851
"2010","stand",-29.3862952478427,804,72,732,123.786030078679,680.213969921321
"2010","walk",-29.3994047844272,994,95,899,153.038947634586,840.961052365415
"2000","kind",-29.4594608365603,554,95,459,149.073470715704,404.926529284296
"1980","shake",-29.4729974842648,1207,136,1071,203.060523265799,1003.9394767342
"2000","romance",-29.5238305468265,114,8,106,30.6757683422207,83.3242316577793
"1960","feel",-29.5471642848335,3697,147,3550,220.796941733455,3476.20305826655
"2000","shine",-29.5921827615278,395,61,334,106.288846448923,288.711153551077
"1990","head",-29.6343535524409,1158,173,985,245.663557886398,912.336442113602
"1990","love love",-29.6644481304353,1001,145,856,212.356840625461,788.643159374539
"1980","thing",-29.6983345177326,1697,205,1492,285.496029811152,1411.50397018885
"1970","ladies",-29.7638769722225,303,13,290,41.4649112284587,261.535088771541
"2000","plays",-29.7933021579376,101,6,95,27.1776544084587,73.8223455915413
"2000","woke",-29.7933021579376,101,6,95,27.1776544084587,73.8223455915413
"2000","look eyes",-29.8269519782495,152,14,138,40.9010244562943,111.098975543706
"1960","whoa",-29.8398056476089,687,12,675,41.0298888209044,645.970111179096
"1960","slow",-29.8748829194409,567,8,559,33.8630960137595,533.13690398624
"2010","power",-29.8789303076647,246,11,235,37.8748300987003,208.1251699013
"2010","little bit",-29.919473654068,419,28,391,64.5103813469732,354.489618653027
"2000","midnight",-29.9208651993973,134,11,123,36.0574820864699,97.9425179135301
"2010","love just",-30.0215395301263,290,15,275,44.6491899537523,245.350810046248
"1970","yeah yeah yeah yeah",-30.0947098851949,549,35,514,75.1294926218608,473.870507378139
"2000","youre gonna",-30.1768868145255,421,66,355,113.285074316447,307.714925683553
"1990","pretty",-30.2084669906588,487,57,430,103.314466917682,383.685533082318
"2010","near",-30.2800717794189,213,8,205,32.7940602074112,180.205939792589
"2010","can",-30.3107020399156,8122,1075,7047,1250.48524415302,6871.51475584698
"2000","alive",-30.402254935158,417,65,352,112.208731567597,304.791268432403
"1980","sittin",-30.4880890428348,172,6,166,28.9365451546954,143.063454845305
"2000","magic",-30.4934690115384,279,37,242,75.074906732277,203.925093267723
"2000","sunshine",-30.6710700345459,183,19,164,49.2426807598806,133.757319240119
"2000","stone",-30.6969261804243,154,14,140,41.4391958307192,112.560804169281
"1990","red",-30.8137788729931,452,51,401,95.8894025601483,356.110597439852
"2000","love youre",-30.8419522576918,110,7,103,29.5994255933708,80.4005744066291
"2010","waiting",-30.8873210694394,686,57,629,105.618428649221,580.381571350779
"2010","arms",-31.3164121887091,556,42,514,85.6032745320217,470.396725467978
"2000","upon",-31.3218098539476,207,23,184,55.7007372529797,151.29926274702
"1990","shorty",-31.3230135378495,202,14,188,42.8532285777654,159.146771422235
"1980","gettin",-31.3674215635222,440,34,406,74.0237201631743,365.976279836826
"1970","getting",-31.4354885651548,609,40,569,83.3403661324466,525.659633867553
"2010","dem",-31.4400961287674,241,10,231,37.105016478808,203.894983521192
"1980","see",-31.4437826221582,5264,737,4527,885.592870315794,4378.40712968421
"1990","fresh",-31.5824062032907,195,13,182,41.3682157062587,153.631784293741
"2000","die",-31.6187220678483,516,85,431,138.848214601631,377.151785398369
"2000","wind",-31.6312245870936,348,50,298,93.6418191499369,254.358180850063
"2000","come true",-31.9116444639523,132,10,122,35.519310712045,96.480689287955
"2010","goodbye",-31.9633044264945,410,26,384,63.1247168311671,346.875283168833
"2010","fool",-32.0586581555333,381,23,358,58.6597978357918,322.340202164208
"2000","good",-32.0875336512943,2885,644,2241,776.312207607954,2108.68779239205
"1970","just",-32.1050510167836,9577,1124,8453,1310.59226018135,8266.40773981865
"2010","dance",-32.1511125456791,1542,161,1381,237.41052037478,1304.58947962522
"2000","away",-32.2292746390659,2580,569,2011,694.241073008153,1885.75892699185
"1980","drink",-32.2437803689935,292,17,275,49.1248324719247,242.875167528075
"1980","broke",-32.3586502536639,233,11,222,39.1989245409537,193.801075459046
"2010","far",-32.3952180645865,616,48,568,94.8410379707291,521.158962029271
"1990","fire",-32.4345665368954,674,86,588,142.985525056504,531.014474943496
"2000","love can",-32.6238191339295,182,18,164,48.9735950726681,133.026404927332
"1990","hoo",-32.649035723638,157,8,149,33.3067172609365,123.693282739064
"1980","da da da da",-32.7119827320783,191,7,184,32.1330239799234,158.866976020077
"2000","fall love",-32.7317187325319,254,31,223,68.3477645519654,185.652235448035
"1990","dirty",-32.7326368227859,244,19,225,51.7633058068057,192.236694193194
"1980","top",-32.7937838022831,421,31,390,70.8272413379463,350.172758662054
"1970","go go",-32.7975232672917,266,9,257,36.401539230264,229.598460769736
"1990","fame",-32.9702847068911,140,6,134,29.7002574301344,110.299742569866
"1980","hate",-32.99065423317,369,25,344,62.0789835004803,306.92101649952
"1990","caught",-33.0891040857578,330,31,299,70.0077496567454,259.992250343255
"2010","wants",-33.1250826588856,557,41,516,85.7572372560002,471.242762744
"1970","already",-33.3782106258213,241,7,234,32.9803419341866,208.019658065813
"2010","hot",-33.4504387567837,949,86,863,146.110625055555,802.889374944445
"1970","boy",-33.6510861448683,1613,145,1468,220.735649542917,1392.26435045708
"1990","right now",-33.6872592670554,502,57,445,106.496637356625,395.503362643375
"2000","live without",-33.7923595727369,202,21,181,54.3553088169174,147.644691183083
"2010","lord",-33.8297594337179,359,20,339,55.2726179082658,303.727382091734
"2010","mind",-33.8786767573632,1930,209,1721,297.148057278421,1632.85194272158
"2000","ooh",-33.9102168868866,2077,444,1633,558.890972340284,1518.10902765972
"2000","sky",-33.9123340257932,562,93,469,151.226156213404,410.773843786596
"1970","cause im",-33.9541270524388,475,26,449,65.0027486254715,409.997251374529
"2010","tryin",-34.0852484117332,516,36,480,79.4447655728835,436.555234427117
"1970","lets",-34.1126814042245,1662,150,1512,227.441196243229,1434.55880375677
"1980","can get",-34.176184836937,356,23,333,59.8919190411137,296.108080958886
"2000","summer",-34.2684361894334,331,45,286,89.067362467325,241.932637532675
"1980","lookin",-34.2795024760859,471,36,435,79.2390277201252,391.760972279875
"1990","yea",-34.6218331474284,272,22,250,57.7033572928326,214.296642707167
"2010","mine",-34.7623237629492,1033,95,938,159.043493869745,873.956506130255
"1970","mad",-35.0060052655253,262,8,254,35.8541476628917,226.145852337108
"2000","close",-35.1068686155742,764,136,628,205.581465030321,558.418534969679
"2000","remember",-35.1230550445043,894,165,729,240.562604367941,653.437395632059
"2000","much",-35.1380406540362,1552,317,1235,417.620986553741,1134.37901344626
"2000","yellow",-35.1954219555941,158,13,145,42.515538579569,115.484461420431
"2010","help",-35.2364583583918,765,63,702,117.781483843519,647.218516156481
"1980","act",-35.254795483299,304,17,287,51.1436612036477,252.856338796352
"1970","alright",-35.2721579708685,705,47,658,96.477763749384,608.522236250616
"1990","high",-35.3873981256988,790,103,687,167.59430978433,622.40569021567
"2010","son",-35.6234702981287,208,6,202,32.0242465875189,175.975753412481
"2000","enough",-35.6712180529789,798,143,655,214.730378395545,583.269621604455
"2000","cant live",-35.9297777881552,113,6,107,30.4066826550082,82.5933173449918
"1970","red",-35.9498120964722,452,23,429,61.8552471130803,390.14475288692
"1980","work",-36.2008175007792,844,81,763,141.99095413118,702.00904586882
"2010","get get",-36.2321075672395,546,38,508,84.0636472922371,461.936352707763
"2000","let go let",-36.3614943522351,121,7,114,32.5593681527079,88.4406318472921
"1990","clean",-36.4976075579224,176,9,167,37.3374664835976,138.662533516402
"1990","diamonds",-36.5168869968026,193,11,182,40.9439263143996,152.0560736856
"2010","know just",-36.5658228797356,237,8,229,36.4891655828941,200.510834417106
"2010","share",-36.5658228797356,237,8,229,36.4891655828941,200.510834417106
"1990","rock",-36.5780106772171,1320,194,1126,280.030998626982,1039.96900137302
"1990","hot",-36.5933511783204,949,129,820,201.325316437126,747.674683562874
"1960","right",-36.8200325431769,3946,151,3795,235.668036808281,3710.33196319172
"2000","yeah yeah",-36.8643578632338,1719,354,1365,462.558296318223,1256.44170368178
"1980","funk",-37.1605982888291,206,7,199,34.6565598945771,171.343440105423
"2010","way",-37.3564661964853,4483,547,3936,690.21489159542,3792.78510840458
"2000","days",-37.3689019970261,682,116,566,183.516438678899,498.483561321101
"2010","angel",-37.4287811915971,288,12,276,44.3412645057954,243.658735494205
"1980","already",-37.5276116426298,241,10,231,40.5448103621023,200.455189637898
"1990","fuck",-37.5367713342032,631,75,556,133.863303131534,497.136696868466
"2010","seems",-37.680701470863,477,30,447,73.4402193377237,403.559780662276
"1980","money",-37.7330781388741,1142,119,1023,192.125200968966,949.874799031034
"2000","one love",-38.0087305531351,117,6,111,31.4830254038581,85.5169745961419
"2000","ever",-38.0858470319139,2130,450,1680,573.152513762545,1556.84748623746
"2010","friend",-38.2196531845226,649,48,601,99.9218078620181,549.078192137982
"2000","long",-38.3671126229408,1918,399,1519,516.106348073503,1401.8936519265
"2000","easy",-38.6414666214697,503,77,426,135.350100667869,367.649899332131
"1970","tonight",-38.7178776516526,1587,137,1450,217.177604354996,1369.822395645
"1970","wish",-38.7616087265656,839,58,781,114.815381256359,724.184618743641
"1970","watch",-38.9480967968026,697,44,653,95.3829806146393,601.617019385361
"2000","every day",-39.1104808374155,209,20,189,56.2389086274046,152.761091372595
"1980","throw",-39.1787339567607,441,30,411,74.1919558908179,366.808044109182
"2010","man",-39.3805529070479,2466,272,2194,379.672077330873,2086.32792266913
"1990","got got",-39.5053306097307,166,7,159,35.2160195243022,130.783980475698
"2000","need love",-39.5622933479298,180,15,165,48.4354236982432,131.564576301757
"2010","always",-39.8177969144822,1781,183,1598,274.207611405631,1506.79238859437
"2000","oh oh",-40.0503213928977,3050,669,2381,820.71134599801,2229.28865400199
"1980","check",-40.1201658414737,261,11,250,43.9095249149738,217.090475085026
"1970","front",-40.2223683249205,339,12,327,46.3914353348102,292.60856466519
"2000","lay",-40.4208053173601,465,68,397,125.124844553795,339.875155446205
"1970","yall",-40.4680464981088,621,36,585,84.9825408345638,536.017459165436
"1970","yea",-40.7847238846341,272,7,265,37.2226265813226,234.777373418677
"2000","fool",-40.8152043633398,381,51,330,102.521646827948,278.478353172052
"1970","dont wanna",-40.8479796040244,771,50,721,105.509724611029,665.490275388971
"1990","bum",-40.8725105296778,160,6,154,33.9431513487251,126.056848651275
"1980","ready",-40.9231729042292,571,44,527,96.062600484483,474.937399515517
"2000","dance dance",-41.043125607596,177,14,163,47.6281666366058,129.371833363394
"2000","love love",-41.0481446604055,1001,183,818,269.354772899675,731.645227100325
"2010","make love",-41.1234833843359,254,8,246,39.1065318905279,214.893468109472
"1960","give",-41.2673486980186,3148,109,3039,188.008864640767,2959.99113535923
"2000","time",-41.3354822237285,5176,1191,3985,1392.7875170117,3783.2124829883
"1990","now",-41.3530321873294,6525,1176,5349,1384.24414094019,5140.75585905981
"2000","weve got",-41.486870649488,131,7,124,35.2502250248326,95.7497749751674
"1980","man",-41.546149448972,2466,300,2166,414.869304369063,2051.13069563094
"1970","boom",-41.7738843015545,305,9,296,41.7386070121449,263.261392987855
"1980","da da",-41.9127104262493,550,41,509,92.5296502039679,457.470349796032
"2000","satisfied",-42.2100283637919,125,6,119,33.6357109015578,91.3642890984422
"1960","money",-42.2823703171665,1142,23,1119,68.203978214662,1073.79602178534
"1980","like way",-42.3642864265491,211,6,205,35.4977385327949,175.502261467205
"1990","lil",-42.4057743445419,226,13,213,47.9447012800741,178.055298719926
"1980","lean",-42.6741493204373,270,11,259,45.423646463766,224.576353536234
"1970","dont",-42.7781637887407,11587,1349,10238,1585.65652278598,10001.343477214
"2000","living",-42.8351354290326,517,77,440,139.117300288843,377.882699711157
"1980","cause im",-42.8404527680191,475,32,443,79.9119706306995,395.088029369301
"1990","burn",-42.8550344886047,335,27,308,71.0684731363931,263.931526863607
"1960","crazy",-42.8858485857744,861,13,848,51.4217383912645,809.578261608735
"2000","funk",-42.9892955593534,206,18,188,55.4316515657672,150.568348434233
"1980","daddy",-43.0174703158675,344,18,326,57.8730903093908,286.126909690609
"1970","everything",-43.0251305774206,1269,99,1170,173.659974748891,1095.34002525111
"2000","feel",-43.2563582006527,3697,821,2876,994.809785624473,2702.19021437553
"2010","loves",-43.309887866136,514,31,483,79.1368401249265,434.863159875073
"2000","well",-43.4416376380975,2420,511,1909,651.187363054159,1768.81263694584
"2000","brother",-43.4826320678718,201,17,184,54.0862231297049,146.913776870295
"2000","strong",-43.5561423722832,470,67,403,126.470272989857,343.529727010143
"1990","ooh",-43.6626788723815,2077,322,1755,440.624533445637,1636.37546655436
"2000","gonna",-43.7647034014993,4550,1030,3520,1224.3398768167,3325.6601231833
"1970","kick",-44.1061846330246,329,10,319,45.0229564163792,283.977043583621
"1960","know",-44.2408115865653,11166,507,10659,666.87007070483,10499.1299292952
"2000","love just",-44.3626018882893,290,32,258,78.0348492916141,211.965150708386
"1990","chick",-44.8699861936682,189,8,181,40.0953475306815,148.904652469319
"1980","even",-44.8725464576946,1219,123,1096,205.079351997521,1013.92064800248
"1980","baby baby baby",-45.0157980240742,267,10,257,44.9189392808353,222.081060719165
"1960","cause",-45.1960106893999,4691,178,4513,280.161875485972,4410.83812451403
"2000","find",-45.2530594733258,1686,335,1351,453.678468640211,1232.32153135979
"1960","make",-46.2735473459606,5520,217,5303,329.672469128664,5190.32753087134
"2000","lover",-46.777349661021,500,71,429,134.542843606231,365.457156393769
"2010","child",-46.87284297459,288,9,279,44.3412645057954,243.658735494205
"2000","stars",-46.8825141289295,313,35,278,84.2238200975007,228.776179902499
"2010","sad",-47.1010236463358,326,12,314,50.1918480169768,275.808151983023
"1970","aint",-47.2318750403792,3592,356,3236,491.557627500408,3100.44237249959
"1970","heart",-47.5401626380904,2871,272,2599,392.890297481534,2478.10970251847
"2000","yeah",-47.69735801872,6260,1446,4814,1684.47640195001,4575.52359804999
"1990","dance",-47.9201167004034,1542,221,1321,327.127121123338,1214.87287887666
"2010","heaven",-48.0494442706645,432,21,411,66.5118967586931,365.488103241307
"1960","hot",-48.2112297656821,949,14,935,56.6773864498374,892.322613550163
"2000","hearts",-48.2442874629203,322,36,286,86.6455912824129,235.354408717587
"1990","ridin",-48.4017707786365,198,8,190,42.0046497940473,155.995350205953
"1970","step",-48.5997800447533,552,26,526,75.5400362973901,476.45996370261
"1970","drop",-48.7817698091316,417,15,402,57.0655708985718,359.934429101428
"2000","dancing",-48.9859803321125,362,43,319,97.4090187709113,264.590981229089
"1970","break",-49.093622535513,977,65,912,133.700390330707,843.299609669293
"1980","three",-49.0999285837186,367,18,349,61.7425120451931,305.257487954807
"1970","now im",-49.1940880720739,555,26,529,75.9505799729194,479.049420027081
"2010","step",-49.2584164465545,552,32,520,84.9874236361079,467.012576363892
"1960","hit",-49.4392608947662,765,8,757,45.6883041455486,719.311695854452
"2000","cruel",-50.2220307432209,140,6,134,37.6719962097447,102.328003790255
"2010","people",-50.7196181816723,972,76,896,149.65176770706,822.34823229294
"1980","la la la la",-51.3696693128679,1002,90,912,168.572199098865,833.427800901135
"1960","want",-51.4623042517088,6214,245,5969,371.120420863319,5842.87957913668
"2000","someone",-51.5756844741624,862,143,719,231.951862377142,630.048137622858
"1960","rock",-52.5475556109392,1320,25,1295,78.8347208785936,1241.16527912141
"2000","know love",-53.3351852452254,318,33,285,85.569248533563,232.430751466437
"1980","god",-53.3744476374227,501,30,471,84.2860995494325,416.713900450568
"1990","get get get",-53.5250975482588,265,14,251,56.2183444213259,208.781655578674
"2000","come",-53.8492810065735,4867,1087,3780,1309.64003966305,3557.35996033695
"2000","free",-54.1006040450052,710,109,601,191.050837920848,518.949162079152
"2000","day",-54.1396550202003,2215,447,1768,596.024797175604,1618.9752028244
"1990","put hands",-54.3200344446809,193,6,187,40.9439263143996,152.0560736856
"2010","da da da",-54.6443576206757,303,8,295,46.6507053654723,256.349294634528
"2000","eyes",-54.766161068519,1714,330,1384,461.21286788216,1252.78713211784
"1970","jump",-55.0739156472076,404,12,392,55.2865483046116,348.713451695388
"1960","get",-55.1769998059027,8265,342,7923,493.612854592103,7771.3871454079
"1970","girls",-55.1867953250386,942,58,884,128.910714116198,813.089285883802
"1970","even",-55.2160705326586,1219,85,1134,166.817580156736,1052.18241984326
"2000","dig",-55.2979406974673,207,14,193,55.7007372529797,151.29926274702
"2000","woman",-55.4151953384275,796,126,670,214.19220702112,581.80779297888
"1970","just wanna",-55.4707636352021,377,10,367,51.5916552248479,325.408344775152
"1980","sexy",-55.4972893595574,401,19,382,67.4625267850747,333.537473214925
"1990","bout",-55.4973078360402,884,103,781,187.535911201706,696.464088798294
"1980","lord",-55.5830345436434,359,15,344,60.3966262240445,298.603373775956
"2000","train",-55.6944381780379,221,16,205,59.4679368739542,161.532063126046
"2000","ill",-55.7704147879879,4216,924,3292,1134.46525728774,3081.53474271226
"2000","love oh",-55.9441602758743,228,17,211,61.3515366844414,166.648463315559
"2000","darlin",-56.1022145541722,181,10,171,48.7045093854557,132.295490614544
"1990","aint",-56.8972128655528,3592,583,3009,762.023747778878,2829.97625222112
"1980","hey hey hey",-57.5241670282953,297,9,288,49.9660111101426,247.033988889857
"1970","make",-57.5276241473269,5520,569,4951,755.400362973901,4764.5996370261
"2010","youve got",-57.7290794562098,391,14,377,60.1994250755764,330.800574924424
"2010","away",-57.7720929341237,2580,265,2315,397.223827864417,2182.77617213558
"1960","dont wanna",-57.8110865595317,771,6,765,46.0466437859058,724.953356214094
"2000","morning",-58.3096296269679,509,66,443,136.964614791143,372.035385208857
"1980","wanna see",-58.5216917990382,262,6,256,44.0777606426174,217.922239357383
"2010","day",-58.8645383930103,2215,218,1997,341.027433612281,1873.97256638772
"1990","hey hey hey",-59.020594128315,297,16,281,63.0069746910709,233.993025308929
"2000","darling",-59.0329629513294,260,21,239,69.9622786752402,190.03772132476
"1980","tryin",-59.4856457749015,516,29,487,86.8096354640862,429.190364535914
"2000","funky",-59.6131146480511,195,11,184,52.4717090064301,142.52829099357
"1990","tonight",-59.8327627485906,1587,217,1370,336.673632440167,1250.32636755983
"2010","time",-60.0207008728012,5176,603,4573,796.91105931249,4379.08894068751
"1960","oh oh oh oh",-60.1334567062239,1291,21,1270,77.1027459502003,1213.8972540498
"1970","party",-60.3786890408709,694,33,661,94.97243693911,599.02756306089
"1990","girl",-60.4209081889867,4804,805,3999,1019.14311924547,3784.85688075453
"2010","together",-60.4952602265905,954,68,886,146.880438675447,807.119561324553
"2000","never",-60.5593271741502,4753,1046,3707,1278.96427132083,3474.03572867917
"1960","tonight",-60.9598150844963,1587,31,1556,94.7808348744909,1492.21916512551
"2000","weve",-61.3069822390495,427,49,378,114.899588439721,312.100411560279
"2000","let love",-62.358482886283,248,18,230,66.7332504286907,181.266749571309
"2010","must",-62.865883693004,696,40,656,107.158055889006,588.841944110994
"1980","black",-62.9096863682041,428,19,409,72.0048914314514,355.995108568549
"1980","mama",-63.0910207802897,460,22,438,77.3884347160458,382.611565283954
"2010","lovin",-63.0959074988317,625,33,592,96.2267024865352,528.773297513465
"1990","song",-63.5555045273996,816,87,729,173.110071878498,642.889928121502
"1960","ooh",-63.8671166914773,2077,48,2029,124.045238836999,1952.954761163
"1980","wanna",-63.8716773821348,4767,603,4164,801.979713676936,3965.02028632306
"1980","like like",-64.0127111950144,318,9,309,53.4989613906578,264.501038609342
"1980","floor",-64.0867616414972,648,41,607,109.016751513038,538.983248486962
"2010","hes",-64.2511876610705,841,54,787,129.482650865882,711.517349134118
"1980","la la la",-66.4818634324121,1245,110,1135,209.453480916255,1035.54651908375
"1990","got",-67.2344718084373,8289,1460,6829,1758.46738455989,6530.53261544011
"1970","oh oh oh oh",-67.9398033674641,1291,84,1207,176.670628369439,1114.32937163056
"2000","true",-68.1941998653176,1022,164,858,275.005572331136,746.994427668864
"1990","ooh ooh ooh",-68.5584072504107,227,6,221,48.1568459760037,178.843154023996
"1970","oh oh",-68.6394679667299,3050,269,2781,417.386070121449,2632.61392987855
"1980","la la",-68.8073362505118,1558,148,1410,262.111263668694,1295.88873633131
"1970","cause",-69.1703724692819,4691,455,4236,641.953460635972,4049.04653936403
"1980","low",-69.212752208837,660,40,620,111.035580244761,548.964419755239
"1970","oh oh oh",-69.3057125003198,1867,141,1726,255.495014071064,1611.50498592894
"1980","beautiful",-69.6107046627547,515,25,490,86.6413997364426,428.358600263557
"2010","true",-69.844446063274,1022,70,952,157.349903905982,864.650096094018
"1970","ima",-69.9008485491132,371,6,365,50.7705678737893,320.229432126211
"1990","bitch",-70.1171453219894,590,50,540,125.165370598424,464.834629401576
"1980","front",-70.5822212620082,339,9,330,57.0319116711729,281.968088328827
"1980","boogie",-70.6412725337413,313,7,306,52.6577827524399,260.34221724756
"1980","shake shake",-71.3371804372199,402,14,388,67.6307625127183,334.369237487282
"2000","lovin",-71.6729391869575,625,81,544,168.178554507789,456.821445492211
"2000","born",-71.7106275203528,300,23,277,80.7257061637387,219.274293836261
"2000","baby",-72.0134109357309,9098,2095,7003,2448.14158225898,6649.85841774102
"2010","dat",-72.2608624903774,350,7,343,53.8869533924597,296.11304660754
"1970","real",-73.0799274649912,1354,87,1267,185.292045555555,1168.70795444445
"2000","ive got",-73.9628225061526,579,71,508,155.800612896016,423.199387103984
"2010","lonely",-74.3235907253227,748,40,708,115.164117535885,632.835882464115
"1980","put",-74.4902946760737,1646,155,1491,276.916007701329,1369.08399229867
"2000","nights",-75.0290593579047,387,36,351,104.136160951223,282.863839048777
"1990","ooh ooh",-75.5883077272107,426,26,400,90.3736404659805,335.62635953402
"2010","rain",-76.2490269084108,767,41,726,118.089409291476,648.910590708524
"1980","hit",-76.545082059062,765,48,717,128.700331647337,636.299668352663
"2000","dream",-77.1168911451819,789,110,679,212.308607210633,576.691392789367
"2000","wild",-77.3854322376036,479,51,428,128.892044174769,350.107955825231
"2000","ive",-77.6062634001276,2652,519,2133,713.61524248745,1938.38475751255
"2000","come come",-77.6608923059881,369,32,337,99.2926185813986,269.707381418601
"1980","girl",-78.2555535390407,4804,588,4216,808.204435599748,3995.79556440025
"2000","power",-78.4522627409076,246,13,233,66.1950790542657,179.804920945734
"1970","damn",-78.4695837770727,486,11,475,66.5080754357456,419.491924564254
"1980","baby baby",-79.3509464265165,786,49,737,132.233281927852,653.766718072148
"2000","give love",-80.2036440330245,219,9,210,58.9297654995292,160.070234500471
"1990","hey",-80.4049702251783,2216,306,1910,470.112646179842,1745.88735382016
"2010","wit",-80.5744743477181,765,39,726,117.781483843519,647.218516156481
"2000","hold",-80.6406488363561,1726,306,1420,464.44189612871,1261.55810387129
"1980","hey hey",-80.6408753235167,597,29,568,100.436729403216,496.563270596784
"1990","whoa",-82.1162153699677,687,58,629,145.743406103588,541.256593896412
"1990","gimme",-82.4518928132979,386,19,367,81.8878526287992,304.112147371201
"2010","cry",-82.6688347912356,899,51,848,138.412488856632,760.587511143368
"1980","fly",-83.1362199476479,764,45,719,128.532095919694,635.467904080306
"1990","hey hey",-83.5901142110893,597,45,552,126.65038346993,470.34961653007
"1970","want",-83.8171996998966,6214,613,5601,850.372799913011,5363.62720008699
"1960","oh oh oh",-85.279062218838,1867,31,1836,111.503351424496,1755.4966485755
"2010","sweet",-86.6751517841336,1136,73,1063,174.901654439526,961.098345560474
"1980","drop",-87.106552046849,417,11,406,70.154298427372,346.845701572628
"2010","much",-87.7963058285455,1552,117,1435,238.950147614564,1313.04985238544
"1960","body",-88.099498854119,1089,7,1082,65.0386447248397,1023.96135527516
"2000","youve got",-90.4522854468078,391,31,360,105.212503700073,285.787496299927
"2000","little",-91.0070041072552,2553,481,2072,686.975759453416,1866.02424054658
"2000","rhythm",-93.8339873311883,252,10,242,67.8095931775405,184.190406822459
"2000","bright",-94.7213478983443,277,13,264,74.5367353578521,202.463264642148
"1990","home",-95.2795883746409,1475,170,1305,312.913426496059,1162.08657350394
"1980","hey",-95.918598015233,2216,212,2004,372.810372458169,1843.18962754183
"1970","hit",-97.0235390050554,765,25,740,104.68863725997,660.31136274003
"2010","da da",-97.3834508765836,550,15,535,84.679498188151,465.320501811849
"2000","honey",-98.4968928534053,421,33,388,113.285074316447,307.714925683553
"2000","love will",-99.3093090174912,262,10,252,70.5004500496651,191.499549950335
"1980","cause",-99.8147398033921,4691,545,4146,789.193798376024,3901.80620162398
"1980","damn",-100.799325817488,486,13,473,81.7625636347789,404.237436365221
"1990","imma",-100.858804120741,302,6,296,64.0676981707186,237.932301829281
"2010","shes",-101.685835998101,1432,96,1336,220.474620737149,1211.52537926285
"1970","know",-102.670692806359,11166,1173,9993,1528.04356032003,9637.95643967997
"1990","pop",-103.687899624976,394,14,380,83.5850101962355,310.414989803765
"2010","woman",-103.927081571044,796,33,763,122.554328286851,673.445671713149
"1980","aint",-105.107057929631,3592,387,3205,604.302733695732,2987.69726630427
"2000","sweet",-106.777736794642,1136,161,975,305.681340673357,830.318659326643
"2010","will",-109.116414811225,3611,343,3268,555.959396286206,3055.04060371379
"1990","la la la la",-112.615486079452,1002,88,914,212.568985321391,789.431014678609
"1970","gon",-113.663208544331,705,16,689,96.477763749384,608.522236250616
"1980","bout",-116.520447917099,884,44,840,148.720383236923,735.279616763077
"1990","la la la",-119.109790331949,1245,120,1125,264.120146432267,980.879853567733
"1970","girl",-124.270709436457,4804,408,4396,657.417272414242,4146.58272758576
"1970","body",-130.823823035233,1089,38,1051,149.027354217134,939.972645782866
"1960","oh oh",-133.178646150255,3050,53,2997,182.155983848265,2867.84401615173
"1970","na na na na",-133.439055700732,831,19,812,113.720598121614,717.279401878386
"1990","la la",-143.869791192004,1558,153,1405,330.52143625821,1227.47856374179
"1990","club",-144.949461508709,612,26,586,129.832553908873,482.167446091127
"2000","will",-148.229086239217,3611,660,2951,971.668416524201,2639.3315834758
"1980","back",-148.943948357341,3938,394,3544,662.51229546041,3275.48770453959
"1980","get",-150.445663503096,8265,991,7274,1390.46828897417,6874.53171102583
"1960","wanna",-169.839957426726,4767,99,4668,284.70084426383,4482.29915573617
"2000","night",-171.207698034553,3598,635,2963,968.170302590439,2629.82969740956
"1970","na na na",-176.210967115143,1049,22,1027,143.55343854341,905.44656145659
"1980","club",-177.205932877342,612,6,606,102.96026531787,509.03973468213
"2010","love",-187.997582694892,15283,1764,13519,2353.01231056275,12929.9876894373
"1970","wanna",-189.158550615555,4767,351,4416,652.353900416048,4114.64609958395
"2000","youve",-189.469117908568,1117,115,1002,300.56871261632,816.43128738368
"1970","like",-196.874418910941,10949,1019,9930,1498.34756779008,9450.65243220992
"1960","like",-202.28597944807,10949,333,10616,653.910120378577,10295.0898796214
"2000","heart",-205.907459185726,2871,450,2421,772.545007986979,2098.45499201302
"1970","na na",-236.157675116203,1366,27,1339,186.934220257672,1179.06577974233
"1980","like",-268.933125259521,10949,1232,9717,1842.01298196953,9106.98701803047
"1990","oh oh",-346.640515327057,3050,266,2784,647.041322585071,2402.95867741493
"1990","oh oh oh",-408.459516025306,1867,89,1778,396.074147300436,1470.92585269956
"1990","oh oh oh oh",-429.343841187273,1291,26,1265,273.878802445025,1017.12119755497
"2000","love",-772.635197867932,15283,2656,12627,4112.43655766806,11170.5634423319
